0x37CA2318, 38092251542548696, 224642466, 224642615, 149, 960x600 
0x37CA2318, 38092251545406280, 224642747, 224642782, 35, 960x600 
0x37CA2318, 38092251550725816, 224643271, 224643277, 6, 960x600 
0x37CA2318, 38092251553386840, 224643537, 224643543, 6, 960x600 
0x37CA2318, 38092251556040056, 224643796, 224643801, 5, 960x600 
0x37CA2318, 38092251558707128, 224644072, 224644078, 6, 960x600 
0x37CA2318, 38092251561364112, 224644333, 224644339, 6, 960x600 
0x37CA2318, 38092251563833576, 224644581, 224644587, 6, 960x600 
0x37CA2318, 38092251566690576, 224644866, 224644872, 6, 960x600 
0x37CA2318, 38092251569350608, 224645132, 224645138, 6, 960x600 
0x37CA2318, 38092251572012976, 224645401, 224645407, 6, 960x600 
0x37CA2318, 38092251574678720, 224645667, 224645673, 6, 960x600 
0x37CA2318, 38092251577331592, 224645931, 224645937, 6, 960x600 
0x37CA2318, 38092251579994112, 224646201, 224646208, 7, 960x600 
0x37CA2318, 38092251582657984, 224646462, 224646467, 5, 960x600 
0x37CA2318, 38092251585118328, 224646707, 224646712, 5, 960x600 
0x37CA2318, 38092251587985848, 224646992, 224646996, 4, 960x600 
0x37CA2318, 38092251590645928, 224647261, 224647266, 5, 960x600 
0x37CA2318, 38092251593308240, 224647531, 224647537, 6, 960x600 
0x37CA2318, 38092251595963664, 224647793, 224647798, 5, 960x600 
0x37CA2318, 38092251598643000, 224648062, 224648068, 6, 960x600 
0x37CA2318, 38092251601300936, 224648322, 224648327, 5, 960x600 
0x37CA2318, 38092251603757256, 224648566, 224648571, 5, 960x600 
0x37CA2318, 38092251606417224, 224648831, 224648836, 5, 960x600 
0x37CA2318, 38092251609086936, 224649097, 224649101, 4, 960x600 
0x37CA2318, 38092251611747728, 224649372, 224649376, 4, 960x600 
0x37CA2318, 38092251614418256, 224649637, 224649642, 5, 960x600 
0x37CA2318, 38092251617079608, 224649902, 224649906, 4, 960x600 
0x37CA2318, 38092251619744968, 224650173, 224650178, 5, 960x600 
0x37CA2318, 38092251622402344, 224650432, 224650436, 4, 960x600 
0x37CA2318, 38092251623057824, 224650497, 224650501, 4, 960x600 
0x37CA2318, 38092251623718112, 224650562, 224650566, 4, 960x600 
0x37CA2318, 38092251624378272, 224650626, 224650630, 4, 960x600 
0x37CA2318, 38092251625047752, 224650706, 224650723, 17, 960x600 
0x37CA2318, 38092251625703232, 224650796, 224650802, 6, 960x600 
0x37CA2318, 38092251626448160, 224650842, 224650846, 4, 960x600 
0x37CA2318, 38092251627029024, 224650896, 224650913, 17, 960x600 
0x37CA2318, 38092251627686528, 224650957, 224650962, 5, 960x600 
0x37CA2318, 38092251628346544, 224651027, 224651032, 5, 960x600 
0x37CA2318, 38092251629003720, 224651092, 224651096, 4, 960x600 
0x37CA2318, 38092251629663720, 224651156, 224651160, 4, 960x600 
0x37CA2318, 38092251630323912, 224651223, 224651228, 5, 960x600 
0x37CA2318, 38092251630983992, 224651292, 224651296, 4, 960x600 
0x37CA2318, 38092251631644016, 224651356, 224651360, 4, 960x600 
0x37CA2318, 38092251632304192, 224651428, 224651433, 5, 960x600 
0x37CA2318, 38092251632964976, 224651486, 224651490, 4, 960x600 
0x37CA2318, 38092251633625056, 224651552, 224651556, 4, 960x600 
0x37CA2318, 38092251634287256, 224651627, 224651632, 5, 960x600 
0x37CA2318, 38092251634950224, 224651691, 224651696, 5, 960x600 
0x37CA2318, 38092251635610736, 224651757, 224651762, 5, 960x600 
0x37CA2318, 38092251636276160, 224651818, 224651822, 4, 960x600 
0x37CA2318, 38092251636936696, 224651882, 224651886, 4, 960x600 
0x37CA2318, 38092251637596440, 224651951, 224651955, 4, 960x600 
0x37CA2318, 38092251638256512, 224652016, 224652020, 4, 960x600 
0x37CA2318, 38092251638916496, 224652081, 224652085, 4, 960x600 
0x37CA2318, 38092251639576456, 224652146, 224652150, 4, 960x600 
0x37CA2318, 38092251640240872, 224652221, 224652226, 5, 960x600 
0x37CA2318, 38092251640900720, 224652286, 224652291, 5, 960x600 
0x37CA2318, 38092251641561256, 224652352, 224652357, 5, 960x600 
0x37CA2318, 38092251642250984, 224652417, 224652421, 4, 960x600 
0x37CA2318, 38092251643087696, 224652507, 224652512, 5, 960x600 
0x37CA2318, 38092251643737032, 224652562, 224652566, 4, 960x600 
0x37CA2318, 38092251644398616, 224652641, 224652646, 5, 960x600 
0x37CA2318, 38092251645053120, 224652702, 224652706, 4, 960x600 
0x37CA2318, 38092251645730256, 224652767, 224652772, 5, 960x600 
0x37CA2318, 38092251646382104, 224652831, 224652836, 5, 960x600 
0x37CA2318, 38092251647043328, 224652902, 224652907, 5, 960x600 
0x37CA2318, 38092251647703304, 224652967, 224652971, 4, 960x600 
0x37CA2318, 38092251648364912, 224653032, 224653037, 5, 960x600 
0x37CA2318, 38092251649027296, 224653097, 224653102, 5, 960x600 
0x37CA2318, 38092251649696552, 224653162, 224653167, 5, 960x600 
0x37CA2318, 38092251650355344, 224653227, 224653232, 5, 960x600 
0x37CA2318, 38092251651007568, 224653292, 224653297, 5, 960x600 
0x37CA2318, 38092251651676728, 224653361, 224653366, 5, 960x600 
0x37CA2318, 38092251652327040, 224653431, 224653437, 6, 960x600 
0x37CA2318, 38092251652989288, 224653497, 224653503, 6, 960x600 
0x37CA2318, 38092251653647376, 224653556, 224653561, 5, 960x600 
0x37CA2318, 38092251654308336, 224653622, 224653627, 5, 960x600 
0x37CA2318, 38092251654961352, 224653687, 224653692, 5, 960x600 
0x37CA2318, 38092251655633040, 224653761, 224653767, 6, 960x600 
0x37CA2318, 38092251656283248, 224653822, 224653827, 5, 960x600 
0x37CA2318, 38092251656954920, 224653898, 224653903, 5, 960x600 
0x37CA2318, 38092251657605568, 224653961, 224653967, 6, 960x600 
0x37CA2318, 38092251658281288, 224654026, 224654033, 7, 960x600 
0x37CA2318, 38092251658929552, 224654091, 224654097, 6, 960x600 
0x37CA2318, 38092251659602496, 224654157, 224654163, 6, 960x600 
0x37CA2318, 38092251660256200, 224654226, 224654232, 6, 960x600 
0x37CA2318, 38092251660917432, 224654291, 224654297, 6, 960x600 
0x37CA2318, 38092251661579288, 224654357, 224654363, 6, 960x600 
0x37CA2318, 38092251662043320, 224654406, 224654412, 6, 960x600 
0x37CA2318, 38092251662701456, 224654462, 224654467, 5, 960x600 
0x37CA2318, 38092251663363000, 224654537, 224654543, 6, 960x600 
0x37CA2318, 38092251664023272, 224654597, 224654602, 5, 960x600 
0x37CA2318, 38092251664685128, 224654661, 224654666, 5, 960x600 
0x37CA2318, 38092251665348896, 224654736, 224654742, 6, 960x600 
0x37CA2318, 38092251666004416, 224654802, 224654807, 5, 960x600 
0x37CA2318, 38092251666863704, 224654877, 224654881, 4, 960x600 
0x37CA2318, 38092251667526200, 224654947, 224654952, 5, 960x600 
0x37CA2318, 38092251668184560, 224655012, 224655017, 5, 960x600 
0x37CA2318, 38092251668648832, 224655057, 224655062, 5, 960x600 
0x37CA2318, 38092251669496352, 224655142, 224655147, 5, 960x600 
0x37CA2318, 38092251670160288, 224655206, 224655211, 5, 960x600 
0x37CA2318, 38092251670835448, 224655276, 224655281, 5, 960x600 
0x37CA2318, 38092251671486456, 224655347, 224655352, 5, 960x600 
0x37CA2318, 38092251672153688, 224655407, 224655412, 5, 960x600 
0x37CA2318, 38092251672816128, 224655472, 224655477, 5, 960x600 
0x37CA2318, 38092251673467616, 224655547, 224655553, 6, 960x600 
0x37CA2318, 38092251674133224, 224655612, 224655617, 5, 960x600 
0x37CA2318, 38092251674792344, 224655671, 224655676, 5, 960x600 
0x37CA2318, 38092251675445400, 224655737, 224655742, 5, 960x600 
0x37CA2318, 38092251675987088, 224655792, 224655796, 4, 960x600 
0x37CA2318, 38092251676774496, 224655872, 224655876, 4, 960x600 
0x37CA2318, 38092251677431888, 224655936, 224655941, 5, 960x600 
0x37CA2318, 38092251678110888, 224656001, 224656005, 4, 960x600 
0x37CA2318, 38092251678760592, 224656066, 224656070, 4, 960x600 
0x37CA2318, 38092251679422784, 224656136, 224656141, 5, 960x600 
0x37CA2318, 38092251680074784, 224656198, 224656203, 5, 960x600 
0x37CA2318, 38092251680747840, 224656266, 224656271, 5, 960x600 
0x37CA2318, 38092251681413792, 224656332, 224656337, 5, 960x600 
0x37CA2318, 38092251682070464, 224656402, 224656407, 5, 960x600 
0x37CA2318, 38092251682731192, 224656471, 224656477, 6, 960x600 
0x37CA2318, 38092251683391936, 224656537, 224656542, 5, 960x600 
0x37CA2318, 38092251684052328, 224656606, 224656612, 6, 960x600 
0x37CA2318, 38092251684721624, 224656666, 224656670, 4, 960x600 
0x37CA2318, 38092251685381648, 224656752, 224656756, 4, 960x600 
0x37CA2318, 38092251686040696, 224656797, 224656802, 5, 960x600 
0x37CA2318, 38092251686691904, 224656862, 224656867, 5, 960x600 
0x37CA2318, 38092251687352952, 224656926, 224656931, 5, 960x600 
0x37CA2318, 38092251688013432, 224656992, 224656996, 4, 960x600 
0x37CA2318, 38092251688664264, 224657058, 224657063, 5, 960x600 
0x37CA2318, 38092251689343416, 224657128, 224657132, 4, 960x600 
0x37CA2318, 38092251689993816, 224657192, 224657195, 3, 960x600 
0x37CA2318, 38092251690663728, 224657257, 224657261, 4, 960x600 
0x37CA2318, 38092251691315624, 224657321, 224657325, 4, 960x600 
0x37CA2318, 38092251691966416, 224657393, 224657415, 22, 960x600 
0x37CA2318, 38092251692475432, 224657441, 224657446, 5, 960x600 
0x37CA2318, 38092251693287752, 224657521, 224657526, 5, 960x600 
0x37CA2318, 38092251693966872, 224657591, 224657596, 5, 960x600 
0x37CA2318, 38092251694627840, 224657656, 224657661, 5, 960x600 
0x37CA2318, 38092251695286264, 224657721, 224657725, 4, 960x600 
0x37CA2318, 38092251695947440, 224657786, 224657790, 4, 960x600 
0x37CA2318, 38092251696599576, 224657857, 224657862, 5, 960x600 
0x37CA2318, 38092251697260816, 224657922, 224657927, 5, 960x600 
0x37CA2318, 38092251697930192, 224657986, 224657990, 4, 960x600 
0x37CA2318, 38092251698589728, 224658051, 224658056, 5, 960x600 
0x37CA2318, 38092251699253536, 224658123, 224658127, 4, 960x600 
0x37CA2318, 38092251699909976, 224658182, 224658187, 5, 960x600 
0x37CA2318, 38092251700576208, 224658247, 224658251, 4, 960x600 
0x37CA2318, 38092251701236080, 224658312, 224658316, 4, 960x600 
0x37CA2318, 38092251701886600, 224658377, 224658382, 5, 960x600 
0x37CA2318, 38092251703229952, 224658511, 224658515, 4, 960x600 
0x37CA2318, 38092251703880888, 224658576, 224658580, 4, 960x600 
0x37CA2318, 38092251704549000, 224658646, 224658650, 4, 960x600 
0x37CA2318, 38092251705191592, 224658711, 224658717, 6, 960x600 
0x37CA2318, 38092251705862240, 224658777, 224658783, 6, 960x600 
0x37CA2318, 38092251706513632, 224658843, 224658847, 4, 960x600 
0x37CA2318, 38092251707183504, 224658908, 224658912, 4, 960x600 
0x37CA2318, 38092251707838352, 224658976, 224658980, 4, 960x600 
0x37CA2318, 38092251708509896, 224659042, 224659048, 6, 960x600 
0x37CA2318, 38092251709162944, 224659107, 224659112, 5, 960x600 
0x37CA2318, 38092251709823040, 224659177, 224659182, 5, 960x600 
0x37CA2318, 38092251710489600, 224659241, 224659246, 5, 960x600 
0x37CA2318, 38092251711166840, 224659311, 224659316, 5, 960x600 
0x37CA2318, 38092251711812832, 224659376, 224659382, 6, 960x600 
0x37CA2318, 38092251712354152, 224659427, 224659432, 5, 960x600 
0x37CA2318, 38092251713123496, 224659502, 224659506, 4, 960x600 
0x37CA2318, 38092251713790272, 224659582, 224659588, 6, 960x600 
0x37CA2318, 38092251714452960, 224659641, 224659646, 5, 960x600 
0x37CA2318, 38092251715109712, 224659712, 224659717, 5, 960x600 
0x37CA2318, 38092251715765360, 224659767, 224659772, 5, 960x600 
0x37CA2318, 38092251716436152, 224659837, 224659842, 5, 960x600 
0x37CA2318, 38092251717106192, 224659901, 224659906, 5, 960x600 
0x37CA2318, 38092251717756208, 224659966, 224659971, 5, 960x600 
0x37CA2318, 38092251718426064, 224660037, 224660041, 4, 960x600 
0x37CA2318, 38092251719085496, 224660102, 224660106, 4, 960x600 
0x37CA2318, 38092251719745352, 224660166, 224660171, 5, 960x600 
0x37CA2318, 38092251720406200, 224660259, 224660266, 7, 960x600 
0x37CA2318, 38092251721075568, 224660302, 224660307, 5, 960x600 
0x37CA2318, 38092251721734832, 224660366, 224660371, 5, 960x600 
0x37CA2318, 38092251722315720, 224660421, 224660425, 4, 960x600 
0x37CA2318, 38092251723045752, 224660496, 224660500, 4, 960x600 
0x37CA2318, 38092251723706616, 224660561, 224660566, 5, 960x600 
0x37CA2318, 38092251724366216, 224660631, 224660635, 4, 960x600 
0x37CA2318, 38092251725031008, 224660696, 224660700, 4, 960x600 
0x37CA2318, 38092251725700624, 224660762, 224660766, 4, 960x600 
0x37CA2318, 38092251726353152, 224660827, 224660832, 5, 960x600 
0x37CA2318, 38092251727022520, 224660895, 224660900, 5, 960x600 
0x37CA2318, 38092251727681664, 224660957, 224660961, 4, 960x600 
0x37CA2318, 38092251728344600, 224661027, 224661032, 5, 960x600 
0x37CA2318, 38092251728995256, 224661091, 224661095, 4, 960x600 
0x37CA2318, 38092251729664520, 224661166, 224661172, 6, 960x600 
0x37CA2318, 38092251730993696, 224661294, 224661676, 382, 1440x900 
0x37CA2318, 38092251731643776, 224661678, 224661691, 13, 1440x900 
0x37CA2318, 38092251734979360, 224661691, 224661700, 9, 1440x900 
0x37CA2318, 38092251735633272, 224661748, 224661755, 7, 1440x900 
0x37CA2318, 38092251736293168, 224661813, 224661821, 8, 1440x900 
0x37CA2318, 38092251736943392, 224661878, 224661886, 8, 1440x900 
0x37CA2318, 38092251737612960, 224661947, 224661955, 8, 1440x900 
0x37CA2318, 38092251738266064, 224662013, 224662022, 9, 1440x900 
0x37CA2318, 38092251738933872, 224662083, 224662092, 9, 1440x900 
0x37CA2318, 38092251739593664, 224662147, 224662154, 7, 1440x900 
0x37CA2318, 38092251740252512, 224662212, 224662219, 7, 1440x900 
0x37CA2318, 38092251740915416, 224662278, 224662285, 7, 1440x900 
0x37CA2318, 38092251741571896, 224662343, 224662351, 8, 1440x900 
0x37CA2318, 38092251742201888, 224662407, 224662415, 8, 1440x900 
0x37CA2318, 38092251742890576, 224662476, 224662484, 8, 1440x900 
0x37CA2318, 38092251743560856, 224662541, 224662550, 9, 1440x900 
0x37CA2318, 38092251744225024, 224662610, 224662619, 9, 1440x900 
0x37CA2318, 38092251744887376, 224662676, 224662683, 7, 1440x900 
0x37CA2318, 38092251745545544, 224662743, 224662750, 7, 1440x900 
0x37CA2318, 38092251746206688, 224662807, 224662813, 6, 1440x900 
0x37CA2318, 38092251746863752, 224662873, 224662881, 8, 1440x900 
0x37CA2318, 38092251747525200, 224662941, 224662949, 8, 1440x900 
0x37CA2318, 38092251748193840, 224663008, 224663016, 8, 1440x900 
0x37CA2318, 38092251748854136, 224663073, 224663080, 7, 1440x900 
0x37CA2318, 38092251749514888, 224663138, 224663145, 7, 1440x900 
0x37CA2318, 38092251750181504, 224663208, 224663215, 7, 1440x900 
0x37CA2318, 38092251750841008, 224663272, 224663279, 7, 1440x900 
0x37CA2318, 38092251751493456, 224663334, 224663342, 8, 1440x900 
0x37CA2318, 38092251752214032, 224663413, 224663421, 8, 1440x900 
0x37CA2318, 38092251752818144, 224663468, 224663477, 9, 1440x900 
0x37CA2318, 38092251753497200, 224663538, 224663546, 8, 1440x900 
0x37CA2318, 38092251754149432, 224663602, 224663610, 8, 1440x900 
0x37CA2318, 38092251754809424, 224663666, 224663673, 7, 1440x900 
0x37CA2318, 38092251755463712, 224663738, 224663746, 8, 1440x900 
0x37CA2318, 38092251756132392, 224663798, 224663805, 7, 1440x900 
0x37CA2318, 38092251756802768, 224663867, 224663875, 8, 1440x900 
0x37CA2318, 38092251757463104, 224663931, 224663940, 9, 1440x900 
0x37CA2318, 38092251758121624, 224663997, 224664004, 7, 1440x900 
0x37CA2318, 38092251758772520, 224664062, 224664069, 7, 1440x900 
0x37CA2318, 38092251759437592, 224664132, 224664140, 8, 1440x900 
0x37CA2318, 38092251760098552, 224664199, 224664208, 9, 1440x900 
0x37CA2318, 38092251760768920, 224664263, 224664270, 7, 1440x900 
0x37CA2318, 38092251761417400, 224664328, 224664335, 7, 1440x900 
0x37CA2318, 38092251762197280, 224664407, 224664414, 7, 1440x900 
0x37CA2318, 38092251762747856, 224664462, 224664469, 7, 1440x900 
0x37CA2318, 38092251763409376, 224664531, 224664538, 7, 1440x900 
0x37CA2318, 38092251764078536, 224664592, 224664600, 8, 1440x900 
0x37CA2318, 38092251764737904, 224664658, 224664666, 8, 1440x900 
0x37CA2318, 38092251765404760, 224664728, 224664736, 8, 1440x900 
0x37CA2318, 38092251766055264, 224664792, 224664799, 7, 1440x900 
0x37CA2318, 38092251766715776, 224664857, 224664866, 9, 1440x900 
0x37CA2318, 38092251767367272, 224664922, 224664931, 9, 1440x900 
0x37CA2318, 38092251768038320, 224664988, 224664995, 7, 1440x900 
0x37CA2318, 38092251768706368, 224665058, 224665065, 7, 1440x900 
0x37CA2318, 38092251769367528, 224665123, 224665132, 9, 1440x900 
0x37CA2318, 38092251770016384, 224665187, 224665194, 7, 1440x900 
0x37CA2318, 38092251770679608, 224665257, 224665266, 9, 1440x900 
0x37CA2318, 38092251771341704, 224665322, 224665331, 9, 1440x900 
0x37CA2318, 38092251772006800, 224665389, 224665416, 27, 1440x900 
0x37CA2318, 38092251772498584, 224665437, 224665444, 7, 1440x900 
0x37CA2318, 38092251773327760, 224665518, 224665526, 8, 1440x900 
0x37CA2318, 38092251773985424, 224665588, 224665596, 8, 1440x900 
0x37CA2318, 38092251774649720, 224665652, 224665661, 9, 1440x900 
0x37CA2318, 38092251775310752, 224665718, 224665726, 8, 1440x900 
0x37CA2318, 38092251775969216, 224665783, 224665792, 9, 1440x900 
0x37CA2318, 38092251776628040, 224665852, 224665860, 8, 1440x900 
0x37CA2318, 38092251777298064, 224665922, 224665931, 9, 1440x900 
0x37CA2318, 38092251777959696, 224665987, 224665995, 8, 1440x900 
0x37CA2318, 38092251778618528, 224666052, 224666060, 8, 1440x900 
0x37CA2318, 38092251779282992, 224666118, 224666126, 8, 1440x900 
0x37CA2318, 38092251779951632, 224666179, 224666187, 8, 1440x900 
0x37CA2318, 38092251780611200, 224666247, 224666254, 7, 1440x900 
0x37CA2318, 38092251781264320, 224666313, 224666320, 7, 1440x900 
0x37CA2318, 38092251781926064, 224666386, 224666394, 8, 1440x900 
0x37CA2318, 38092251782655976, 224666451, 224666459, 8, 1440x900 
0x37CA2318, 38092251783245544, 224666512, 224666519, 7, 1440x900 
0x37CA2318, 38092251783909664, 224666577, 224666585, 8, 1440x900 
0x37CA2318, 38092251784561048, 224666648, 224666655, 7, 1440x900 
0x37CA2318, 38092251785223720, 224666708, 224666718, 10, 1440x900 
0x37CA2318, 38092251785890560, 224666778, 224666786, 8, 1440x900 
0x37CA2318, 38092251786551384, 224666843, 224666852, 9, 1440x900 
0x37CA2318, 38092251787210800, 224666912, 224666921, 9, 1440x900 
0x37CA2318, 38092251787879568, 224666972, 224666981, 9, 1440x900 
0x37CA2318, 38092251788540560, 224667038, 224667046, 8, 1440x900 
0x37CA2318, 38092251789195952, 224667107, 224667114, 7, 1440x900 
0x37CA2318, 38092251789847848, 224667172, 224667179, 7, 1440x900 
0x37CA2318, 38092251790517768, 224667238, 224667247, 9, 1440x900 
0x37CA2318, 38092251791186976, 224667307, 224667315, 8, 1440x900 
0x37CA2318, 38092251791843448, 224667373, 224667381, 8, 1440x900 
0x37CA2318, 38092251792340376, 224667418, 224667426, 8, 1440x900 
0x37CA2318, 38092251793173336, 224667503, 224667511, 8, 1440x900 
0x37CA2318, 38092251793824904, 224667573, 224667581, 8, 1440x900 
0x37CA2318, 38092251794492064, 224667641, 224667650, 9, 1440x900 
0x37CA2318, 38092251795152272, 224667702, 224667709, 7, 1440x900 
0x37CA2318, 38092251795817504, 224667768, 224667776, 8, 1440x900 
0x37CA2318, 38092251796478344, 224667837, 224667846, 9, 1440x900 
0x37CA2318, 38092251797129656, 224667903, 224667911, 8, 1440x900 
0x37CA2318, 38092251797800800, 224667967, 224667975, 8, 1440x900 
0x37CA2318, 38092251798460424, 224668033, 224668041, 8, 1440x900 
0x37CA2318, 38092251799121272, 224668098, 224668105, 7, 1440x900 
0x37CA2318, 38092251799783904, 224668163, 224668171, 8, 1440x900 
0x37CA2318, 38092251800434960, 224668228, 224668236, 8, 1440x900 
0x37CA2318, 38092251801105592, 224668297, 224668304, 7, 1440x900 
0x37CA2318, 38092251801775112, 224668363, 224668371, 8, 1440x900 
0x37CA2318, 38092251802425424, 224668428, 224668436, 8, 1440x900 
0x37CA2318, 38092251803085752, 224668493, 224668501, 8, 1440x900 
0x37CA2318, 38092251803742320, 224668558, 224668566, 8, 1440x900 
0x37CA2318, 38092251804412712, 224668627, 224668634, 7, 1440x900 
0x37CA2318, 38092251805073288, 224668698, 224668706, 8, 1440x900 
0x37CA2318, 38092251805735856, 224668763, 224668771, 8, 1440x900 
0x37CA2318, 38092251806404384, 224668828, 224668835, 7, 1440x900 
0x37CA2318, 38092251807063928, 224668893, 224668901, 8, 1440x900 
0x37CA2318, 38092251807717264, 224668957, 224668964, 7, 1440x900 
0x37CA2318, 38092251808379048, 224669023, 224669031, 8, 1440x900 
0x37CA2318, 38092251809032056, 224669088, 224669096, 8, 1440x900 
0x37CA2318, 38092251809701840, 224669158, 224669165, 7, 1440x900 
0x37CA2318, 38092251810362840, 224669222, 224669229, 7, 1440x900 
0x37CA2318, 38092251811023456, 224669292, 224669300, 8, 1440x900 
0x37CA2318, 38092251811683256, 224669354, 224669362, 8, 1440x900 
0x37CA2318, 38092251812343960, 224669422, 224669430, 8, 1440x900 
0x37CA2318, 38092251812999040, 224669487, 224669495, 8, 1440x900 
0x37CA2318, 38092251813671408, 224669553, 224669561, 8, 1440x900 
0x37CA2318, 38092251814328264, 224669622, 224669629, 7, 1440x900 
0x37CA2318, 38092251814991368, 224669686, 224669694, 8, 1440x900 
0x37CA2318, 38092251815652360, 224669752, 224669759, 7, 1440x900 
0x37CA2318, 38092251816966496, 224669888, 224669896, 8, 1440x900 
0x37CA2318, 38092251817638744, 224669952, 224669960, 8, 1440x900 
0x37CA2318, 38092251818288016, 224670018, 224670027, 9, 1440x900 
0x37CA2318, 38092251818983584, 224670092, 224670101, 9, 1440x900 
0x37CA2318, 38092251819616360, 224670148, 224670156, 8, 1440x900 
0x37CA2318, 38092251820267648, 224670213, 224670220, 7, 1440x900 
0x37CA2318, 38092251820929824, 224670278, 224670286, 8, 1440x900 
0x37CA2318, 38092251821583152, 224670346, 224670354, 8, 1440x900 
0x37CA2318, 38092251822245984, 224670412, 224670420, 8, 1440x900 
0x37CA2318, 38092251822908400, 224670478, 224670487, 9, 1440x900 
0x37CA2318, 38092251823577744, 224670543, 224670551, 8, 1440x900 
0x37CA2318, 38092251824241792, 224670613, 224670622, 9, 1440x900 
0x37CA2318, 38092251824896936, 224670677, 224670686, 9, 1440x900 
0x37CA2318, 38092251825576936, 224670747, 224670755, 8, 1440x900 
0x37CA2318, 38092251826236240, 224670813, 224670822, 9, 1440x900 
0x37CA2318, 38092251826897056, 224670878, 224670886, 8, 1440x900 
0x37CA2318, 38092251827548408, 224670943, 224670952, 9, 1440x900 
0x37CA2318, 38092251828216768, 224671008, 224671017, 9, 1440x900 
0x37CA2318, 38092251828876784, 224671077, 224671090, 13, 1440x900 
0x37CA2318, 38092251829547344, 224671143, 224671151, 8, 1440x900 
0x37CA2318, 38092251830198216, 224671208, 224671217, 9, 1440x900 
0x37CA2318, 38092251830858936, 224671278, 224671286, 8, 1440x900 
0x37CA2318, 38092251831518056, 224671343, 224671351, 8, 1440x900 
0x37CA2318, 38092251832181520, 224671407, 224671415, 8, 1440x900 
0x37CA2318, 38092251832848032, 224671478, 224671486, 8, 1440x900 
0x37CA2318, 38092251833304072, 224671517, 224671524, 7, 1440x900 
0x37CA2318, 38092251833962040, 224671582, 224671589, 7, 1440x900 
0x37CA2318, 38092251834818072, 224671668, 224671675, 7, 1440x900 
0x37CA2318, 38092251835476776, 224671733, 224671741, 8, 1440x900 
0x37CA2318, 38092251836138912, 224671801, 224671809, 8, 1440x900 
0x37CA2318, 38092251836707600, 224671857, 224671865, 8, 1440x900 
0x37CA2318, 38092251837453240, 224671932, 224671940, 8, 1440x900 
0x37CA2318, 38092251837993368, 224671987, 224671995, 8, 1440x900 
0x37CA2318, 38092251838587000, 224672042, 224672050, 8, 1440x900 
0x37CA2318, 38092251839441296, 224672128, 224672136, 8, 1440x900 
0x37CA2318, 38092251840107928, 224672198, 224672207, 9, 1440x900 
0x37CA2318, 38092251840571232, 224672244, 224672251, 7, 1440x900 
0x37CA2318, 38092251841232584, 224672311, 224672318, 7, 1440x900 
0x37CA2318, 38092251841890248, 224672373, 224672381, 8, 1440x900 
0x37CA2318, 38092251842551888, 224672442, 224672450, 8, 1440x900 
0x37CA2318, 38092251843212400, 224672507, 224672515, 8, 1440x900 
0x37CA2318, 38092251843872096, 224672573, 224672581, 8, 1440x900 
0x37CA2318, 38092251844536960, 224672643, 224672650, 7, 1440x900 
0x37CA2318, 38092251845196216, 224672707, 224672714, 7, 1440x900 
0x37CA2318, 38092251845859312, 224672773, 224672781, 8, 1440x900 
0x37CA2318, 38092251846520472, 224672842, 224672849, 7, 1440x900 
0x37CA2318, 38092251847375832, 224672928, 224672936, 8, 1440x900 
0x37CA2318, 38092251848037472, 224672992, 224673000, 8, 1440x900 
0x37CA2318, 38092251848689520, 224673058, 224673067, 9, 1440x900 
0x37CA2318, 38092251849351384, 224673123, 224673130, 7, 1440x900 
0x37CA2318, 38092251850012464, 224673188, 224673195, 7, 1440x900 
0x37CA2318, 38092251850684264, 224673254, 224673262, 8, 1440x900 
0x37CA2318, 38092251851350640, 224673322, 224673329, 7, 1440x900 
0x37CA2318, 38092251852012552, 224673392, 224673400, 8, 1440x900 
0x37CA2318, 38092251852666576, 224673458, 224673466, 8, 1440x900 
0x37CA2318, 38092251853327456, 224673522, 224673530, 8, 1440x900 
0x37CA2318, 38092251853985576, 224673588, 224673596, 8, 1440x900 
0x37CA2318, 38092251854656848, 224673653, 224673662, 9, 1440x900 
0x37CA2318, 38092251855315720, 224673723, 224673731, 8, 1440x900 
0x37CA2318, 38092251855974792, 224673787, 224673794, 7, 1440x900 
0x37CA2318, 38092251856626936, 224673848, 224673856, 8, 1440x900 
0x37CA2318, 38092251857290464, 224673917, 224673926, 9, 1440x900 
0x37CA2318, 38092251857960768, 224673987, 224673995, 8, 1440x900 
0x37CA2318, 38092251858611680, 224674052, 224674060, 8, 1440x900 
0x37CA2318, 38092251859271376, 224674114, 224674123, 9, 1440x900 
0x37CA2318, 38092251859930864, 224674183, 224674191, 8, 1440x900 
0x37CA2318, 38092251860590608, 224674247, 224674255, 8, 1440x900 
0x37CA2318, 38092251861261000, 224674313, 224674322, 9, 1440x900 
0x37CA2318, 38092251861921520, 224674382, 224674390, 8, 1440x900 
0x37CA2318, 38092251862573248, 224674448, 224674456, 8, 1440x900 
0x37CA2318, 38092251863242256, 224674513, 224674521, 8, 1440x900 
0x37CA2318, 38092251863893432, 224674582, 224674590, 8, 1440x900 
0x37CA2318, 38092251864555536, 224674643, 224674651, 8, 1440x900 
0x37CA2318, 38092251865209024, 224674709, 224674718, 9, 1440x900 
0x37CA2318, 38092251865877696, 224674773, 224674781, 8, 1440x900 
0x37CA2318, 38092251866540728, 224674843, 224674852, 9, 1440x900 
0x37CA2318, 38092251867190864, 224674913, 224674921, 8, 1440x900 
0x37CA2318, 38092251867851920, 224674977, 224674985, 8, 1440x900 
0x37CA2318, 38092251868514640, 224675040, 224675048, 8, 1440x900 
0x37CA2318, 38092251869174936, 224675108, 224675117, 9, 1440x900 
0x37CA2318, 38092251869834568, 224675174, 224675182, 8, 1440x900 
0x37CA2318, 38092251870496280, 224675237, 224675246, 9, 1440x900 
0x37CA2318, 38092251871165808, 224675307, 224675315, 8, 1440x900 
0x37CA2318, 38092251871817216, 224675368, 224675375, 7, 1440x900 
0x37CA2318, 38092251872473408, 224675433, 224675442, 9, 1440x900 
0x37CA2318, 38092251873144160, 224675502, 224675510, 8, 1440x900 
0x37CA2318, 38092251873799808, 224675567, 224675576, 9, 1440x900 
0x37CA2318, 38092251874470928, 224675637, 224675645, 8, 1440x900 
0x37CA2318, 38092251875132192, 224675703, 224675711, 8, 1440x900 
0x37CA2318, 38092251875795216, 224675773, 224675782, 9, 1440x900 
0x37CA2318, 38092251876455368, 224675832, 224675841, 9, 1440x900 
0x37CA2318, 38092251877117408, 224675898, 224675907, 9, 1440x900 
0x37CA2318, 38092251877788216, 224675968, 224675976, 8, 1440x900 
0x37CA2318, 38092251878438352, 224676032, 224676041, 9, 1440x900 
0x37CA2318, 38092251879098912, 224676098, 224676106, 8, 1440x900 
0x37CA2318, 38092251879760008, 224676167, 224676175, 8, 1440x900 
0x37CA2318, 38092251880418144, 224676232, 224676240, 8, 1440x900 
0x37CA2318, 38092251881078696, 224676298, 224676306, 8, 1440x900 
0x37CA2318, 38092251881749584, 224676363, 224676372, 9, 1440x900 
0x37CA2318, 38092251882399680, 224676428, 224676436, 8, 1440x900 
0x37CA2318, 38092251883069408, 224676497, 224676505, 8, 1440x900 
0x37CA2318, 38092251883721600, 224676563, 224676571, 8, 1440x900 
0x37CA2318, 38092251884382112, 224676627, 224676635, 8, 1440x900 
0x37CA2318, 38092251885042240, 224676693, 224676701, 8, 1440x900 
0x37CA2318, 38092251885703144, 224676762, 224676770, 8, 1440x900 
0x37CA2318, 38092251886365496, 224676828, 224676836, 8, 1440x900 
0x37CA2318, 38092251887033656, 224676893, 224676900, 7, 1440x900 
0x37CA2318, 38092251887693888, 224676958, 224676965, 7, 1440x900 
0x37CA2318, 38092251888356048, 224677022, 224677030, 8, 1440x900 
0x37CA2318, 38092251889009808, 224677088, 224677097, 9, 1440x900 
0x37CA2318, 38092251889679128, 224677157, 224677166, 9, 1440x900 
0x37CA2318, 38092251890338632, 224677218, 224677226, 8, 1440x900 
0x37CA2318, 38092251891001784, 224677292, 224677300, 8, 1440x900 
0x37CA2318, 38092251891656944, 224677357, 224677365, 8, 1440x900 
0x37CA2318, 38092251892320536, 224677418, 224677428, 10, 1440x900 
0x37CA2318, 38092251893642288, 224677552, 224677560, 8, 1440x900 
0x37CA2318, 38092251894293696, 224677618, 224677626, 8, 1440x900 
0x37CA2318, 38092251894956624, 224677683, 224677692, 9, 1440x900 
0x37CA2318, 38092251895618912, 224677748, 224677757, 9, 1440x900 
0x37CA2318, 38092251896279688, 224677817, 224677826, 9, 1440x900 
0x37CA2318, 38092251896947312, 224677883, 224677891, 8, 1440x900 
0x37CA2318, 38092251897598256, 224677946, 224677953, 7, 1440x900 
0x37CA2318, 38092251898270032, 224678013, 224678020, 7, 1440x900 
0x37CA2318, 38092251898930680, 224678083, 224678091, 8, 1440x900 
0x37CA2318, 38092251899600856, 224678148, 224678156, 8, 1440x900 
0x37CA2318, 38092251900260904, 224678212, 224678220, 8, 1440x900 
0x37CA2318, 38092251900922000, 224678278, 224678286, 8, 1440x900 
0x37CA2318, 38092251901573760, 224678343, 224678351, 8, 1440x900 
0x37CA2318, 38092251902235904, 224678412, 224678420, 8, 1440x900 
0x37CA2318, 38092251902906064, 224678482, 224678490, 8, 1440x900 
0x37CA2318, 38092251903560464, 224678547, 224678555, 8, 1440x900 
0x37CA2318, 38092251904220384, 224678612, 224678620, 8, 1440x900 
0x37CA2318, 38092251904871208, 224678674, 224678682, 8, 1440x900 
0x37CA2318, 38092251905543008, 224678742, 224678751, 9, 1440x900 
0x37CA2318, 38092251906211496, 224678808, 224678817, 9, 1440x900 
0x37CA2318, 38092251906871120, 224678878, 224678886, 8, 1440x900 
0x37CA2318, 38092251907523016, 224678942, 224678952, 10, 1440x900 
0x37CA2318, 38092251908191624, 224679003, 224679011, 8, 1440x900 
0x37CA2318, 38092251908845512, 224679071, 224679079, 8, 1440x900 
0x37CA2318, 38092251909507320, 224679138, 224679147, 9, 1440x900 
0x37CA2318, 38092251909978200, 224679188, 224679196, 8, 1440x900 
0x37CA2318, 38092251910628192, 224679247, 224679255, 8, 1440x900 
0x37CA2318, 38092251911287920, 224679313, 224679322, 9, 1440x900 
0x37CA2318, 38092251911949488, 224679382, 224679390, 8, 1440x900 
0x37CA2318, 38092251912811208, 224679468, 224679475, 7, 1440x900 
0x37CA2318, 38092251913275872, 224679516, 224679529, 13, 1440x900 
0x37CA2318, 38092251913934976, 224679578, 224679587, 9, 1440x900 
0x37CA2318, 38092251914595280, 224679648, 224679655, 7, 1440x900 
0x37CA2318, 38092251915262936, 224679712, 224679720, 8, 1440x900 
0x37CA2318, 38092251916112920, 224679797, 224679805, 8, 1440x900 
0x37CA2318, 38092251916765112, 224679862, 224679870, 8, 1440x900 
0x37CA2318, 38092251917432784, 224679928, 224679937, 9, 1440x900 
0x37CA2318, 38092251918096000, 224679997, 224680005, 8, 1440x900 
0x37CA2318, 38092251918760656, 224680062, 224680071, 9, 1440x900 
0x37CA2318, 38092251919411016, 224680127, 224680134, 7, 1440x900 
0x37CA2318, 38092251920082848, 224680198, 224680206, 8, 1440x900 
0x37CA2318, 38092251920743600, 224680263, 224680270, 7, 1440x900 
0x37CA2318, 38092251921395144, 224680327, 224680335, 8, 1440x900 
0x37CA2318, 38092251922058544, 224680397, 224680405, 8, 1440x900 
0x37CA2318, 38092251922720496, 224680463, 224680471, 8, 1440x900 
0x37CA2318, 38092251923389456, 224680527, 224680535, 8, 1440x900 
0x37CA2318, 38092251924050528, 224680597, 224680605, 8, 1440x900 
0x37CA2318, 38092251924711376, 224680661, 224680669, 8, 1440x900 
0x37CA2318, 38092251925372448, 224680723, 224680732, 9, 1440x900 
0x37CA2318, 38092251926040992, 224680793, 224680802, 9, 1440x900 
0x37CA2318, 38092251926537424, 224680838, 224680847, 9, 1440x900 
0x37CA2318, 38092251927154488, 224680901, 224680909, 8, 1440x900 
0x37CA2318, 38092251927826992, 224680972, 224680980, 8, 1440x900 
0x37CA2318, 38092251928476832, 224681039, 224681048, 9, 1440x900 
0x37CA2318, 38092251929136776, 224681102, 224681110, 8, 1440x900 
0x37CA2318, 38092251929794976, 224681167, 224681175, 8, 1440x900 
0x37CA2318, 38092251930462848, 224681234, 224681242, 8, 1440x900 
0x37CA2318, 38092251931118864, 224681297, 224681305, 8, 1440x900 
0x37CA2318, 38092251931778056, 224681363, 224681371, 8, 1440x900 
0x37CA2318, 38092251932641184, 224681452, 224681460, 8, 1440x900 
0x37CA2318, 38092251933296912, 224681518, 224681525, 7, 1440x900 
0x37CA2318, 38092251933973368, 224681587, 224681595, 8, 1440x900 
0x37CA2318, 38092251934635944, 224681653, 224681662, 9, 1440x900 
0x37CA2318, 38092251935285720, 224681718, 224681726, 8, 1440x900 
0x37CA2318, 38092251935938096, 224681783, 224681792, 9, 1440x900 
0x37CA2318, 38092251936616128, 224681852, 224681860, 8, 1440x900 
0x37CA2318, 38092251937265952, 224681917, 224681925, 8, 1440x900 
0x37CA2318, 38092251937935848, 224681983, 224681992, 9, 1440x900 
0x37CA2318, 38092251938596048, 224682053, 224682061, 8, 1440x900 
0x37CA2318, 38092251939257056, 224682117, 224682125, 8, 1440x900 
0x37CA2318, 38092251939919224, 224682181, 224682190, 9, 1440x900 
0x37CA2318, 38092251940578752, 224682243, 224682252, 9, 1440x900 
0x37CA2318, 38092251941241064, 224682312, 224682320, 8, 1440x900 
0x37CA2318, 38092251941901760, 224682378, 224682386, 8, 1440x900 
0x37CA2318, 38092251942561264, 224682448, 224682456, 8, 1440x900 
0x37CA2318, 38092251943221776, 224682512, 224682520, 8, 1440x900 
0x37CA2318, 38092251943880440, 224682578, 224682586, 8, 1440x900 
0x37CA2318, 38092251944545168, 224682647, 224682655, 8, 1440x900 
0x37CA2318, 38092251945196376, 224682708, 224682717, 9, 1440x900 
0x37CA2318, 38092251945859208, 224682773, 224682782, 9, 1440x900 
0x37CA2318, 38092251946519688, 224682843, 224682852, 9, 1440x900 
0x37CA2318, 38092251947200080, 224682906, 224682914, 8, 1440x900 
0x37CA2318, 38092251947855520, 224682973, 224682980, 7, 1440x900 
0x37CA2318, 38092251948522824, 224683038, 224683046, 8, 1440x900 
0x37CA2318, 38092251949177088, 224683106, 224683115, 9, 1440x900 
0x37CA2318, 38092251949836728, 224683172, 224683180, 8, 1440x900 
0x37CA2318, 38092251950499584, 224683238, 224683247, 9, 1440x900 
0x37CA2318, 38092251951159976, 224683306, 224683314, 8, 1440x900 
0x37CA2318, 38092251951827712, 224683368, 224683376, 8, 1440x900 
0x37CA2318, 38092251952472888, 224683437, 224683445, 8, 1440x900 
0x37CA2318, 38092251953137320, 224683502, 224683511, 9, 1440x900 
0x37CA2318, 38092251953809880, 224683572, 224683580, 8, 1440x900 
0x37CA2318, 38092251954461952, 224683638, 224683646, 8, 1440x900 
0x37CA2318, 38092251955129576, 224683702, 224683710, 8, 1440x900 
0x37CA2318, 38092251955788624, 224683772, 224683780, 8, 1440x900 
0x37CA2318, 38092251956439312, 224683833, 224683842, 9, 1440x900 
0x37CA2318, 38092251957118120, 224683902, 224683910, 8, 1440x900 
0x37CA2318, 38092251957778224, 224683968, 224683977, 9, 1440x900 
0x37CA2318, 38092251958445688, 224684032, 224684041, 9, 1440x900 
0x37CA2318, 38092251959115576, 224684102, 224684110, 8, 1440x900 
0x37CA2318, 38092251959766664, 224684168, 224684176, 8, 1440x900 
0x37CA2318, 38092251960436280, 224684236, 224684243, 7, 1440x900 
0x37CA2318, 38092251961085976, 224684293, 224684301, 8, 1440x900 
0x37CA2318, 38092251961749360, 224684362, 224684370, 8, 1440x900 
0x37CA2318, 38092251962410288, 224684428, 224684437, 9, 1440x900 
0x37CA2318, 38092251963060784, 224684497, 224684505, 8, 1440x900 
0x37CA2318, 38092251963730952, 224684563, 224684571, 8, 1440x900 
0x37CA2318, 38092251964394240, 224684629, 224684637, 8, 1440x900 
0x37CA2318, 38092251965050272, 224684692, 224684701, 9, 1440x900 
0x37CA2318, 38092251965721336, 224684758, 224684767, 9, 1440x900 
0x37CA2318, 38092251966378024, 224684828, 224684836, 8, 1440x900 
0x37CA2318, 38092251967047448, 224684893, 224684901, 8, 1440x900 
0x37CA2318, 38092251967699688, 224684957, 224684966, 9, 1440x900 
0x37CA2318, 38092251968370488, 224685028, 224685036, 8, 1440x900 
0x37CA2318, 38092251969029376, 224685092, 224685100, 8, 1440x900 
0x37CA2318, 38092251969698464, 224685158, 224685167, 9, 1440x900 
0x37CA2318, 38092251970367752, 224685222, 224685233, 11, 1440x900 
0x37CA2318, 38092251971018112, 224685293, 224685302, 9, 1440x900 
0x37CA2318, 38092251971714264, 224685355, 224685364, 9, 1440x900 
0x37CA2318, 38092251972347248, 224685422, 224685429, 7, 1440x900 
0x37CA2318, 38092251973684208, 224685573, 224685613, 40, 1440x900 
0x37CA2318, 38092251974373080, 224685622, 224685637, 15, 1440x900 
0x37CA2318, 38092251975045352, 224685692, 224685699, 7, 1440x900 
0x37CA2318, 38092251975690856, 224685753, 224685761, 8, 1440x900 
0x37CA2318, 38092251976511112, 224685838, 224685845, 7, 1440x900 
0x37CA2318, 38092251977180160, 224685903, 224685910, 7, 1440x900 
0x37CA2318, 38092251977831920, 224685971, 224685981, 10, 1440x900 
0x37CA2318, 38092251978490464, 224686037, 224686044, 7, 1440x900 
0x37CA2318, 38092251978954296, 224686082, 224686090, 8, 1440x900 
0x37CA2318, 38092251979811048, 224686167, 224686175, 8, 1440x900 
0x37CA2318, 38092251980274384, 224686213, 224686221, 8, 1440x900 
0x37CA2318, 38092251980933672, 224686278, 224686286, 8, 1440x900 
0x37CA2318, 38092251981593112, 224686347, 224686354, 7, 1440x900 
0x37CA2318, 38092251982295840, 224686417, 224686424, 7, 1440x900 
0x37CA2318, 38092251982912736, 224686478, 224686484, 6, 1440x900 
0x37CA2318, 38092251983573576, 224686543, 224686550, 7, 1440x900 
0x37CA2318, 38092251984232728, 224686608, 224686616, 8, 1440x900 
0x37CA2318, 38092251984892896, 224686673, 224686681, 8, 1440x900 
0x37CA2318, 38092251985558280, 224686742, 224686749, 7, 1440x900 
0x37CA2318, 38092251986217792, 224686807, 224686814, 7, 1440x900 
0x37CA2318, 38092251986881936, 224686873, 224686881, 8, 1440x900 
0x37CA2318, 38092251987545264, 224686938, 224686945, 7, 1440x900 
0x37CA2318, 38092251988206632, 224687006, 224687013, 7, 1440x900 
0x37CA2318, 38092251988868792, 224687073, 224687080, 7, 1440x900 
0x37CA2318, 38092251989582048, 224687147, 224687156, 9, 1440x900 
0x37CA2318, 38092251990189800, 224687203, 224687212, 9, 1440x900 
0x37CA2318, 38092251990848888, 224687271, 224687278, 7, 1440x900 
0x37CA2318, 38092251991508656, 224687337, 224687345, 8, 1440x900 
0x37CA2318, 38092251992168992, 224687402, 224687410, 8, 1440x900 
0x37CA2318, 38092251992832400, 224687473, 224687481, 8, 1440x900 
0x37CA2318, 38092251993691632, 224687558, 224687566, 8, 1440x900 
0x37CA2318, 38092251994345056, 224687624, 224687632, 8, 1440x900 
0x37CA2318, 38092251995016168, 224687693, 224687701, 8, 1440x900 
0x37CA2318, 38092251995675856, 224687757, 224687765, 8, 1440x900 
0x37CA2318, 38092251996338112, 224687822, 224687830, 8, 1440x900 
0x37CA2318, 38092251996997944, 224687887, 224687896, 9, 1440x900 
0x37CA2318, 38092251997660040, 224687953, 224687962, 9, 1440x900 
0x37CA2318, 38092251998320824, 224688022, 224688030, 8, 1440x900 
0x37CA2318, 38092251998987384, 224688089, 224688098, 9, 1440x900 
0x37CA2318, 38092251999648480, 224688151, 224688159, 8, 1440x900 
0x37CA2318, 38092252000117712, 224688198, 224688205, 7, 1440x900 
0x37CA2318, 38092252000780184, 224688268, 224688276, 8, 1440x900 
0x37CA2318, 38092252001441584, 224688333, 224688342, 9, 1440x900 
0x37CA2318, 38092252002222608, 224688407, 224688415, 8, 1440x900 
0x37CA2318, 38092252002964352, 224688483, 224688490, 7, 1440x900 
0x37CA2318, 38092252003626024, 224688547, 224688555, 8, 1440x900 
0x37CA2318, 38092252004291208, 224688617, 224688625, 8, 1440x900 
0x37CA2318, 38092252004953616, 224688682, 224688691, 9, 1440x900 
0x37CA2318, 38092252005613960, 224688753, 224688761, 8, 1440x900 
0x37CA2318, 38092252006274240, 224688819, 224688827, 8, 1440x900 
0x37CA2318, 38092252006943264, 224688882, 224688889, 7, 1440x900 
0x37CA2318, 38092252007602552, 224688946, 224688953, 7, 1440x900 
0x37CA2318, 38092252008070744, 224688993, 224689000, 7, 1440x900 
0x37CA2318, 38092252008931784, 224689077, 224689085, 8, 1440x900 
0x37CA2318, 38092252009601360, 224689147, 224689155, 8, 1440x900 
0x37CA2318, 38092252010054040, 224689192, 224689199, 7, 1440x900 
0x37CA2318, 38092252010717656, 224689257, 224689265, 8, 1440x900 
0x37CA2318, 38092252011376720, 224689322, 224689330, 8, 1440x900 
0x37CA2318, 38092252012038360, 224689388, 224689396, 8, 1440x900 
0x37CA2318, 38092252012707376, 224689455, 224689463, 8, 1440x900 
0x37CA2318, 38092252013366480, 224689522, 224689529, 7, 1440x900 
0x37CA2318, 38092252014025160, 224689587, 224689595, 8, 1440x900 
0x37CA2318, 38092252014685336, 224689663, 224689670, 7, 1440x900 
0x37CA2318, 38092252015348896, 224689719, 224689728, 9, 1440x900 
0x37CA2318, 38092252016010712, 224689787, 224689795, 8, 1440x900 
0x37CA2318, 38092252016674840, 224689852, 224689860, 8, 1440x900 
0x37CA2318, 38092252017331960, 224689918, 224689926, 8, 1440x900 
0x37CA2318, 38092252017991408, 224689983, 224689991, 8, 1440x900 
0x37CA2318, 38092252018655528, 224690053, 224690061, 8, 1440x900 
0x37CA2318, 38092252019317512, 224690117, 224690124, 7, 1440x900 
0x37CA2318, 38092252019977464, 224690183, 224690191, 8, 1440x900 
0x37CA2318, 38092252020634104, 224690248, 224690256, 8, 1440x900 
0x37CA2318, 38092252021294032, 224690316, 224690323, 7, 1440x900 
0x37CA2318, 38092252021957176, 224690383, 224690391, 8, 1440x900 
0x37CA2318, 38092252022629376, 224690447, 224690455, 8, 1440x900 
0x37CA2318, 38092252023289840, 224690517, 224690525, 8, 1440x900 
0x37CA2318, 38092252023957008, 224690587, 224690595, 8, 1440x900 
0x37CA2318, 38092252024812720, 224690673, 224690681, 8, 1440x900 
0x37CA2318, 38092252025341944, 224690723, 224690732, 9, 1440x900 
0x37CA2318, 38092252025934616, 224690782, 224690789, 7, 1440x900 
0x37CA2318, 38092252026599968, 224690847, 224690855, 8, 1440x900 
0x37CA2318, 38092252027256544, 224690912, 224690919, 7, 1440x900 
0x37CA2318, 38092252028111192, 224690998, 224691006, 8, 1440x900 
0x37CA2318, 38092252028591168, 224691047, 224691055, 8, 1440x900 
0x37CA2318, 38092252029447936, 224691131, 224691139, 8, 1440x900 
0x37CA2318, 38092252030103744, 224691198, 224691204, 6, 1440x900 
0x37CA2318, 38092252030565856, 224691242, 224691250, 8, 1440x900 
0x37CA2318, 38092252031229808, 224691308, 224691315, 7, 1440x900 
0x37CA2318, 38092252032088936, 224691397, 224691405, 8, 1440x900 
0x37CA2318, 38092252032553896, 224691443, 224691451, 8, 1440x900 
0x37CA2318, 38092252033211728, 224691509, 224691516, 7, 1440x900 
0x37CA2318, 38092252033871024, 224691573, 224691580, 7, 1440x900 
0x37CA2318, 38092252034532792, 224691637, 224691645, 8, 1440x900 
0x37CA2318, 38092252035191928, 224691703, 224691711, 8, 1440x900 
0x37CA2318, 38092252035851912, 224691772, 224691779, 7, 1440x900 
0x37CA2318, 38092252036702112, 224691857, 224691864, 7, 1440x900 
0x37CA2318, 38092252037374024, 224691924, 224691932, 8, 1440x900 
0x37CA2318, 38092252038494616, 224692033, 224692041, 8, 1440x900 
0x37CA2318, 38092252039157592, 224692102, 224692109, 7, 1440x900 
0x37CA2318, 38092252039814736, 224692167, 224692174, 7, 1440x900 
0x37CA2318, 38092252040474512, 224692232, 224692240, 8, 1440x900 
0x37CA2318, 38092252041148464, 224692302, 224692309, 7, 1440x900 
0x37CA2318, 38092252041808904, 224692367, 224692375, 8, 1440x900 
0x37CA2318, 38092252042465264, 224692432, 224692440, 8, 1440x900 
0x37CA2318, 38092252043126888, 224692498, 224692507, 9, 1440x900 
0x37CA2318, 38092252043787008, 224692566, 224692574, 8, 1440x900 
0x37CA2318, 38092252044450592, 224692632, 224692640, 8, 1440x900 
0x37CA2318, 38092252045305696, 224692717, 224692724, 7, 1440x900 
0x37CA2318, 38092252045959056, 224692783, 224692791, 8, 1440x900 
0x37CA2318, 38092252046629248, 224692852, 224692860, 8, 1440x900 
0x37CA2318, 38092252047279496, 224692913, 224692922, 9, 1440x900 
0x37CA2318, 38092252047944400, 224692978, 224692986, 8, 1440x900 
0x37CA2318, 38092252048606600, 224693047, 224693055, 8, 1440x900 
0x37CA2318, 38092252049071896, 224693092, 224693099, 7, 1440x900 
0x37CA2318, 38092252049928128, 224693178, 224693186, 8, 1440x900 
0x37CA2318, 38092252050592744, 224693243, 224693251, 8, 1440x900 
0x37CA2318, 38092252051250672, 224693312, 224693319, 7, 1440x900 
0x37CA2318, 38092252051918448, 224693377, 224693384, 7, 1440x900 
0x37CA2318, 38092252052578736, 224693442, 224693450, 8, 1440x900 
0x37CA2318, 38092252053248152, 224693512, 224693519, 7, 1440x900 
0x37CA2318, 38092252053704440, 224693554, 224693562, 8, 1440x900 
0x37CA2318, 38092252054363392, 224693622, 224693629, 7, 1440x900 
0x37CA2318, 38092252055030080, 224693688, 224693697, 9, 1440x900 
0x37CA2318, 38092252055689336, 224693757, 224693766, 9, 1440x900 
0x37CA2318, 38092252056371904, 224693823, 224693832, 9, 1440x900 
0x37CA2318, 38092252057024600, 224693892, 224693900, 8, 1440x900 
0x37CA2318, 38092252057681680, 224693958, 224693966, 8, 1440x900 
0x37CA2318, 38092252058365264, 224694022, 224694030, 8, 1440x900 
0x37CA2318, 38092252059019656, 224694088, 224694098, 10, 1440x900 
0x37CA2318, 38092252059679456, 224694157, 224694165, 8, 1440x900 
0x37CA2318, 38092252060340768, 224694222, 224694230, 8, 1440x900 
0x37CA2318, 38092252061004864, 224694287, 224694294, 7, 1440x900 
0x37CA2318, 38092252061661232, 224694353, 224694361, 8, 1440x900 
0x37CA2318, 38092252062368952, 224694422, 224694431, 9, 1440x900 
0x37CA2318, 38092252062979120, 224694488, 224694496, 8, 1440x900 
0x37CA2318, 38092252063639496, 224694552, 224694560, 8, 1440x900 
0x37CA2318, 38092252064299736, 224694617, 224694625, 8, 1440x900 
0x37CA2318, 38092252064959640, 224694687, 224694694, 7, 1440x900 
0x37CA2318, 38092252065626256, 224694748, 224694757, 9, 1440x900 
0x37CA2318, 38092252066288448, 224694817, 224694825, 8, 1440x900 
0x37CA2318, 38092252066958320, 224694882, 224694890, 8, 1440x900 
0x37CA2318, 38092252067618440, 224694947, 224694955, 8, 1440x900 
0x37CA2318, 38092252068281656, 224695016, 224695024, 8, 1440x900 
0x37CA2318, 38092252068971936, 224695087, 224695095, 8, 1440x900 
0x37CA2318, 38092252069600640, 224695148, 224695156, 8, 1440x900 
0x37CA2318, 38092252070255520, 224695212, 224695220, 8, 1440x900 
0x37CA2318, 38092252070917024, 224695277, 224695285, 8, 1440x900 
0x37CA2318, 38092252071581024, 224695342, 224695351, 9, 1440x900 
0x37CA2318, 38092252072237216, 224695408, 224695416, 8, 1440x900 
0x37CA2318, 38092252072905944, 224695476, 224695483, 7, 1440x900 
0x37CA2318, 38092252073771944, 224695562, 224695571, 9, 1440x900 
0x37CA2318, 38092252074420824, 224695628, 224695636, 8, 1440x900 
0x37CA2318, 38092252075090288, 224695697, 224695704, 7, 1440x900 
0x37CA2318, 38092252075741416, 224695761, 224695768, 7, 1440x900 
0x37CA2318, 38092252076410712, 224695828, 224695835, 7, 1440x900 
0x37CA2318, 38092252077070992, 224695892, 224695900, 8, 1440x900 
0x37CA2318, 38092252077731088, 224695958, 224695966, 8, 1440x900 
0x37CA2318, 38092252078399456, 224696027, 224696034, 7, 1440x900 
0x37CA2318, 38092252079060088, 224696092, 224696099, 7, 1440x900 
0x37CA2318, 38092252079524832, 224696137, 224696145, 8, 1440x900 
0x37CA2318, 38092252080181216, 224696203, 224696211, 8, 1440x900 
0x37CA2318, 38092252080841136, 224696268, 224696276, 8, 1440x900 
0x37CA2318, 38092252081702472, 224696357, 224696365, 8, 1440x900 
0x37CA2318, 38092252082164344, 224696402, 224696410, 8, 1440x900 
0x37CA2318, 38092252082824224, 224696468, 224696475, 7, 1440x900 
0x37CA2318, 38092252083692048, 224696556, 224696563, 7, 1440x900 
0x37CA2318, 38092252084351592, 224696618, 224696628, 10, 1440x900 
0x37CA2318, 38092252085021360, 224696688, 224696696, 8, 1440x900 
0x37CA2318, 38092252085493136, 224696737, 224696745, 8, 1440x900 
0x37CA2318, 38092252086133840, 224696798, 224696806, 8, 1440x900 
0x37CA2318, 38092252086991000, 224696883, 224696891, 8, 1440x900 
0x37CA2318, 38092252087482472, 224696933, 224696942, 9, 1440x900 
0x37CA2318, 38092252088134184, 224696997, 224697005, 8, 1440x900 
0x37CA2318, 38092252088991304, 224697086, 224697094, 8, 1440x900 
0x37CA2318, 38092252089642216, 224697148, 224697157, 9, 1440x900 
0x37CA2318, 38092252090297488, 224697217, 224697225, 8, 1440x900 
0x37CA2318, 38092252090981288, 224697283, 224697292, 9, 1440x900 
0x37CA2318, 38092252091669112, 224697352, 224697366, 14, 1440x900 
0x37CA2318, 38092252092118536, 224697398, 224697407, 9, 1440x900 
0x37CA2318, 38092252092776840, 224697463, 224697471, 8, 1440x900 
0x37CA2318, 38092252093530848, 224697551, 224697566, 15, 1440x900 
0x37CA2318, 38092252094202160, 224697608, 224697618, 10, 1440x900 
0x37CA2318, 38092252094868152, 224697672, 224697682, 10, 1440x900 
0x37CA2318, 38092252095448520, 224697738, 224697748, 10, 1440x900 
0x37CA2318, 38092252096103848, 224697794, 224697804, 10, 1440x900 
0x37CA2318, 38092252096794024, 224697866, 224697893, 27, 1440x900 
0x37CA2318, 38092252097585752, 224697942, 224697953, 11, 1440x900 
0x37CA2318, 38092252098345112, 224698086, 224698136, 50, 1440x900 
0x37CA2318, 38092252099630672, 224698165, 224698176, 11, 1440x900 
0x37CA2318, 38092252100255840, 224698213, 224698222, 9, 1440x900 
0x37CA2318, 38092252100916144, 224698277, 224698285, 8, 1440x900 
0x37CA2318, 38092252101579032, 224698343, 224698351, 8, 1440x900 
0x37CA2318, 38092252102235688, 224698412, 224698419, 7, 1440x900 
0x37CA2318, 38092252102892400, 224698473, 224698487, 14, 1440x900 
0x37CA2318, 38092252103551728, 224698543, 224698550, 7, 1440x900 
0x37CA2318, 38092252104212504, 224698607, 224698614, 7, 1440x900 
0x37CA2318, 38092252104878320, 224698673, 224698680, 7, 1440x900 
0x37CA2318, 38092252105546648, 224698738, 224698745, 7, 1440x900 
0x37CA2318, 38092252106198856, 224698807, 224698814, 7, 1440x900 
0x37CA2318, 38092252106858200, 224698872, 224698879, 7, 1440x900 
0x37CA2318, 38092252107522272, 224698938, 224698947, 9, 1440x900 
0x37CA2318, 38092252108188808, 224699004, 224699012, 8, 1440x900 
0x37CA2318, 38092252108885872, 224699073, 224699081, 8, 1440x900 
0x37CA2318, 38092252109508824, 224699134, 224699142, 8, 1440x900 
0x37CA2318, 38092252110170392, 224699202, 224699209, 7, 1440x900 
0x37CA2318, 38092252110830344, 224699272, 224699279, 7, 1440x900 
0x37CA2318, 38092252111505840, 224699336, 224699343, 7, 1440x900 
0x37CA2318, 38092252112229056, 224699419, 224699427, 8, 1440x900 
0x37CA2318, 38092252113080472, 224699504, 224699518, 14, 1440x900 
0x37CA2318, 38092252113602528, 224699550, 224699558, 8, 1440x900 
0x37CA2318, 38092252114470672, 224699633, 224699640, 7, 1440x900 
0x37CA2318, 38092252114961328, 224699682, 224699692, 10, 1440x900 
0x37CA2318, 38092252115631464, 224699749, 224699758, 9, 1440x900 
0x37CA2318, 38092252116256464, 224699812, 224699819, 7, 1440x900 
0x37CA2318, 38092252116916160, 224699875, 224699883, 8, 1440x900 
0x37CA2318, 38092252117614504, 224699949, 224699957, 8, 1440x900 
0x37CA2318, 38092252118242400, 224700008, 224700016, 8, 1440x900 
0x37CA2318, 38092252119019840, 224700092, 224700106, 14, 1440x900 
0x37CA2318, 38092252119600888, 224700147, 224700157, 10, 1440x900 
0x37CA2318, 38092252120333288, 224700221, 224700240, 19, 1440x900 
0x37CA2318, 38092252121026640, 224700296, 224700311, 15, 1440x900 
0x37CA2318, 38092252121681216, 224700363, 224700375, 12, 1440x900 
0x37CA2318, 38092252122279952, 224700413, 224700435, 22, 1440x900 
0x37CA2318, 38092252128182152, 224701003, 224701012, 9, 1440x900 
0x37CA2318, 38092252129135784, 224701105, 224701121, 16, 1440x900 
0x37CA2318, 38092252131462936, 224701333, 224701342, 9, 1440x900 
0x37CA2318, 38092252132147000, 224701401, 224701408, 7, 1440x900 
0x37CA2318, 38092252132980048, 224701483, 224701491, 8, 1440x900 
0x37CA2318, 38092252133439088, 224701532, 224701540, 8, 1440x900 
0x37CA2318, 38092252134107648, 224701598, 224701605, 7, 1440x900 
0x37CA2318, 38092252134773216, 224701667, 224701675, 8, 1440x900 
0x37CA2318, 38092252135427944, 224701734, 224701742, 8, 1440x900 
0x37CA2318, 38092252136279456, 224701812, 224701821, 9, 1440x900 
0x37CA2318, 38092252136947168, 224701881, 224701888, 7, 1440x900 
0x37CA2318, 38092252137496912, 224701936, 224701944, 8, 1440x900 
0x37CA2318, 38092252138108688, 224701997, 224702004, 7, 1440x900 
0x37CA2318, 38092252138734064, 224702058, 224702067, 9, 1440x900 
0x37CA2318, 38092252139392632, 224702126, 224702133, 7, 1440x900 
0x37CA2318, 38092252140056040, 224702193, 224702202, 9, 1440x900 
0x37CA2318, 38092252140715768, 224702258, 224702267, 9, 1440x900 
0x37CA2318, 38092252141564456, 224702343, 224702352, 9, 1440x900 
0x37CA2318, 38092252142139984, 224702402, 224702411, 9, 1440x900 
0x37CA2318, 38092252142702256, 224702462, 224702471, 9, 1440x900 
0x37CA2318, 38092252143369392, 224702527, 224702536, 9, 1440x900 
0x37CA2318, 38092252144033176, 224702593, 224702600, 7, 1440x900 
0x37CA2318, 38092252144679808, 224702654, 224702662, 8, 1440x900 
0x37CA2318, 38092252145535976, 224702742, 224702750, 8, 1440x900 
0x37CA2318, 38092252146005736, 224702787, 224702795, 8, 1440x900 
0x37CA2318, 38092252146662376, 224702858, 224702866, 8, 1440x900 
0x37CA2318, 38092252147330600, 224702922, 224702930, 8, 1440x900 
0x37CA2318, 38092252148186768, 224703008, 224703016, 8, 1440x900 
0x37CA2318, 38092252148837808, 224703068, 224703076, 8, 1440x900 
0x37CA2318, 38092252149501320, 224703138, 224703146, 8, 1440x900 
0x37CA2318, 38092252150161928, 224703203, 224703212, 9, 1440x900 
0x37CA2318, 38092252150828288, 224703273, 224703281, 8, 1440x900 
0x37CA2318, 38092252151479104, 224703337, 224703345, 8, 1440x900 
0x37CA2318, 38092252152142464, 224703402, 224703410, 8, 1440x900 
0x37CA2318, 38092252152795512, 224703467, 224703476, 9, 1440x900 
0x37CA2318, 38092252153270336, 224703514, 224703524, 10, 1440x900 
0x37CA2318, 38092252153930896, 224703583, 224703592, 9, 1440x900 
0x37CA2318, 38092252154586528, 224703643, 224703652, 9, 1440x900 
0x37CA2318, 38092252155254736, 224703712, 224703720, 8, 1440x900 
0x37CA2318, 38092252155913296, 224703778, 224703786, 8, 1440x900 
0x37CA2318, 38092252156569976, 224703844, 224703852, 8, 1440x900 
0x37CA2318, 38092252157423864, 224703927, 224703936, 9, 1440x900 
0x37CA2318, 38092252158082632, 224703993, 224704001, 8, 1440x900 
0x37CA2318, 38092252158761040, 224704062, 224704071, 9, 1440x900 
0x37CA2318, 38092252159416128, 224704132, 224704140, 8, 1440x900 
0x37CA2318, 38092252160070600, 224704197, 224704206, 9, 1440x900 
0x37CA2318, 38092252160541640, 224704243, 224704251, 8, 1440x900 
0x37CA2318, 38092252161207032, 224704312, 224704320, 8, 1440x900 
0x37CA2318, 38092252161856944, 224704372, 224704380, 8, 1440x900 
0x37CA2318, 38092252162516648, 224704438, 224704445, 7, 1440x900 
0x37CA2318, 38092252163178040, 224704503, 224704511, 8, 1440x900 
0x37CA2318, 38092252163836776, 224704572, 224704580, 8, 1440x900 
0x37CA2318, 38092252164502200, 224704637, 224704645, 8, 1440x900 
0x37CA2318, 38092252165156728, 224704702, 224704710, 8, 1440x900 
0x37CA2318, 38092252165817600, 224704768, 224704775, 7, 1440x900 
0x37CA2318, 38092252166676368, 224704853, 224704861, 8, 1440x900 
0x37CA2318, 38092252167177872, 224704903, 224704911, 8, 1440x900 
0x37CA2318, 38092252168466416, 224705033, 224705040, 7, 1440x900 
0x37CA2318, 38092252169310400, 224705118, 224705125, 7, 1440x900 
0x37CA2318, 38092252169787544, 224705167, 224705175, 8, 1440x900 
0x37CA2318, 38092252170562416, 224705242, 224705249, 7, 1440x900 
0x37CA2318, 38092252171314576, 224705318, 224705327, 9, 1440x900 
0x37CA2318, 38092252171780320, 224705364, 224705372, 8, 1440x900 
0x37CA2318, 38092252172644832, 224705452, 224705460, 8, 1440x900 
0x37CA2318, 38092252173100408, 224705497, 224705504, 7, 1440x900 
0x37CA2318, 38092252173756544, 224705562, 224705569, 7, 1440x900 
0x37CA2318, 38092252174421408, 224705627, 224705636, 9, 1440x900 
0x37CA2318, 38092252175079832, 224705693, 224705701, 8, 1440x900 
0x37CA2318, 38092252175754240, 224705772, 224705779, 7, 1440x900 
0x37CA2318, 38092252176581560, 224705842, 224705851, 9, 1440x900 
0x37CA2318, 38092252177253160, 224705912, 224705919, 7, 1440x900 
0x37CA2318, 38092252177913960, 224705978, 224705985, 7, 1440x900 
0x37CA2318, 38092252178387832, 224706028, 224706034, 6, 1440x900 
0x37CA2318, 38092252179158856, 224706106, 224706117, 11, 1440x900 
0x37CA2318, 38092252179745056, 224706162, 224706178, 16, 1440x900 
0x37CA2318, 38092252180376320, 224706222, 224706232, 10, 1440x900 
0x37CA2318, 38092252181037000, 224706291, 224706298, 7, 1440x900 
0x37CA2318, 38092252181817224, 224706367, 224706377, 10, 1440x900 
0x37CA2318, 38092252182389968, 224706425, 224706433, 8, 1440x900 
0x37CA2318, 38092252183017928, 224706487, 224706494, 7, 1440x900 
0x37CA2318, 38092252183675992, 224706553, 224706560, 7, 1440x900 
0x37CA2318, 38092252184332704, 224706619, 224706627, 8, 1440x900 
0x37CA2318, 38092252184996544, 224706683, 224706691, 8, 1440x900 
0x37CA2318, 38092252185657936, 224706751, 224706759, 8, 1440x900 
0x37CA2318, 38092252186317960, 224706817, 224706825, 8, 1440x900 
0x37CA2318, 38092252186984056, 224706883, 224706891, 8, 1440x900 
0x37CA2318, 38092252187640616, 224706949, 224706957, 8, 1440x900 
0x37CA2318, 38092252188295944, 224707017, 224707024, 7, 1440x900 
0x37CA2318, 38092252188955784, 224707083, 224707091, 8, 1440x900 
0x37CA2318, 38092252189620768, 224707148, 224707156, 8, 1440x900 
0x37CA2318, 38092252190281976, 224707216, 224707224, 8, 1440x900 
0x37CA2318, 38092252190940752, 224707282, 224707290, 8, 1440x900 
0x37CA2318, 38092252191606976, 224707352, 224707360, 8, 1440x900 
0x37CA2318, 38092252192265080, 224707417, 224707425, 8, 1440x900 
0x37CA2318, 38092252192939072, 224707483, 224707491, 8, 1440x900 
0x37CA2318, 38092252193591408, 224707548, 224707556, 8, 1440x900 
0x37CA2318, 38092252194245840, 224707612, 224707620, 8, 1440x900 
0x37CA2318, 38092252194905848, 224707682, 224707690, 8, 1440x900 
0x37CA2318, 38092252195761472, 224707767, 224707775, 8, 1440x900 
0x37CA2318, 38092252196299696, 224707823, 224707831, 8, 1440x900 
0x37CA2318, 38092252196883616, 224707876, 224707884, 8, 1440x900 
0x37CA2318, 38092252197543560, 224707942, 224707950, 8, 1440x900 
0x37CA2318, 38092252198203640, 224708007, 224708015, 8, 1440x900 
0x37CA2318, 38092252198869248, 224708073, 224708081, 8, 1440x900 
0x37CA2318, 38092252199729936, 224708158, 224708166, 8, 1440x900 
0x37CA2318, 38092252200387816, 224708223, 224708231, 8, 1440x900 
0x37CA2318, 38092252200852728, 224708278, 224708286, 8, 1440x900 
0x37CA2318, 38092252201520104, 224708342, 224708350, 8, 1440x900 
0x37CA2318, 38092252202173040, 224708404, 224708414, 10, 1440x900 
0x37CA2318, 38092252202845776, 224708473, 224708482, 9, 1440x900 
0x37CA2318, 38092252203691920, 224708558, 224708566, 8, 1440x900 
0x37CA2318, 38092252204389464, 224708629, 224708638, 9, 1440x900 
0x37CA2318, 38092252204823616, 224708670, 224708677, 7, 1440x900 
0x37CA2318, 38092252205480128, 224708738, 224708746, 8, 1440x900 
0x37CA2318, 38092252206145704, 224708803, 224708812, 9, 1440x900 
0x37CA2318, 38092252207009560, 224708888, 224708904, 16, 1440x900 
0x37CA2318, 38092252207539080, 224708942, 224708949, 7, 1440x900 
0x37CA2318, 38092252208380024, 224709022, 224709032, 10, 1440x900 
0x37CA2318, 38092252209026768, 224709088, 224709096, 8, 1440x900 
0x37CA2318, 38092252209666440, 224709153, 224709160, 7, 1440x900 
0x37CA2318, 38092252210313696, 224709217, 224709224, 7, 1440x900 
0x37CA2318, 38092252210985072, 224709283, 224709291, 8, 1440x900 
0x37CA2318, 38092252211821040, 224709372, 224709383, 11, 1440x900 
0x37CA2318, 38092252212342224, 224709422, 224709430, 8, 1440x900 
0x37CA2318, 38092252213015648, 224709488, 224709495, 7, 1440x900 
0x37CA2318, 38092252213622760, 224709548, 224709556, 8, 1440x900 
0x37CA2318, 38092252214282616, 224709617, 224709623, 6, 1440x900 
0x37CA2318, 38092252214957512, 224709688, 224709697, 9, 1440x900 
0x37CA2318, 38092252215801424, 224709767, 224709774, 7, 1440x900 
0x37CA2318, 38092252216375768, 224709823, 224709832, 9, 1440x900 
0x37CA2318, 38092252216930792, 224709882, 224709890, 8, 1440x900 
0x37CA2318, 38092252217592656, 224709948, 224709956, 8, 1440x900 
0x37CA2318, 38092252218257120, 224710018, 224710026, 8, 1440x900 
0x37CA2318, 38092252218915688, 224710083, 224710091, 8, 1440x900 
0x37CA2318, 38092252219577184, 224710148, 224710156, 8, 1440x900 
0x37CA2318, 38092252220249376, 224710213, 224710221, 8, 1440x900 
0x37CA2318, 38092252220904608, 224710285, 224710294, 9, 1440x900 
0x37CA2318, 38092252221565056, 224710342, 224710351, 9, 1440x900 
0x37CA2318, 38092252222226528, 224710407, 224710416, 9, 1440x900 
0x37CA2318, 38092252222885648, 224710473, 224710482, 9, 1440x900 
0x37CA2318, 38092252223546352, 224710543, 224710549, 6, 1440x900 
0x37CA2318, 38092252224206256, 224710607, 224710616, 9, 1440x900 
0x37CA2318, 38092252224869336, 224710673, 224710681, 8, 1440x900 
0x37CA2318, 38092252225526816, 224710738, 224710746, 8, 1440x900 
0x37CA2318, 38092252226198080, 224710813, 224710821, 8, 1440x900 
0x37CA2318, 38092252226855176, 224710872, 224710879, 7, 1440x900 
0x37CA2318, 38092252227512616, 224710938, 224710945, 7, 1440x900 
0x37CA2318, 38092252228173760, 224711003, 224711011, 8, 1440x900 
0x37CA2318, 38092252228832408, 224711068, 224711076, 8, 1440x900 
0x37CA2318, 38092252229491792, 224711133, 224711142, 9, 1440x900 
0x37CA2318, 38092252230150856, 224711202, 224711209, 7, 1440x900 
0x37CA2318, 38092252230810816, 224711267, 224711274, 7, 1440x900 
0x37CA2318, 38092252231471320, 224711333, 224711340, 7, 1440x900 
0x37CA2318, 38092252232125760, 224711398, 224711405, 7, 1440x900 
0x37CA2318, 38092252232786472, 224711463, 224711471, 8, 1440x900 
0x37CA2318, 38092252233445968, 224711531, 224711538, 7, 1440x900 
0x37CA2318, 38092252234105960, 224711596, 224711604, 8, 1440x900 
0x37CA2318, 38092252234771072, 224711663, 224711670, 7, 1440x900 
0x37CA2318, 38092252235430608, 224711728, 224711736, 8, 1440x900 
0x37CA2318, 38092252236090680, 224711793, 224711801, 8, 1440x900 
0x37CA2318, 38092252236754448, 224711862, 224711869, 7, 1440x900 
0x37CA2318, 38092252237410624, 224711928, 224711934, 6, 1440x900 
0x37CA2318, 38092252238275680, 224712013, 224712021, 8, 1440x900 
0x37CA2318, 38092252238935232, 224712081, 224712088, 7, 1440x900 
0x37CA2318, 38092252239595200, 224712146, 224712154, 8, 1440x900 
0x37CA2318, 38092252240255768, 224712212, 224712219, 7, 1440x900 
0x37CA2318, 38092252240916944, 224712278, 224712285, 7, 1440x900 
0x37CA2318, 38092252241568904, 224712342, 224712349, 7, 1440x900 
0x37CA2318, 38092252242247808, 224712408, 224712416, 8, 1440x900 
0x37CA2318, 38092252242909000, 224712477, 224712484, 7, 1440x900 
0x37CA2318, 38092252243568976, 224712548, 224712556, 8, 1440x900 
0x37CA2318, 38092252244220392, 224712613, 224712621, 8, 1440x900 
0x37CA2318, 38092252244877760, 224712678, 224712686, 8, 1440x900 
0x37CA2318, 38092252245557120, 224712742, 224712748, 6, 1440x900 
0x37CA2318, 38092252246023480, 224712788, 224712795, 7, 1440x900 
0x37CA2318, 38092252246685560, 224712853, 224712861, 8, 1440x900 
0x37CA2318, 38092252247352416, 224712922, 224712929, 7, 1440x900 
0x37CA2318, 38092252248213376, 224713008, 224713016, 8, 1440x900 
0x37CA2318, 38092252248873728, 224713074, 224713081, 7, 1440x900 
0x37CA2318, 38092252249339728, 224713121, 224713128, 7, 1440x900 
0x37CA2318, 38092252249997832, 224713188, 224713195, 7, 1440x900 
0x37CA2318, 38092252250664768, 224713257, 224713264, 7, 1440x900 
0x37CA2318, 38092252251333712, 224713323, 224713330, 7, 1440x900 
0x37CA2318, 38092252251982800, 224713383, 224713390, 7, 1440x900 
0x37CA2318, 38092252252647976, 224713452, 224713459, 7, 1440x900 
0x37CA2318, 38092252253991048, 224713588, 224713597, 9, 1440x900 
0x37CA2318, 38092252254635904, 224713651, 224713659, 8, 1440x900 
0x37CA2318, 38092252255300016, 224713719, 224713728, 9, 1440x900 
0x37CA2318, 38092252255957496, 224713782, 224713789, 7, 1440x900 
0x37CA2318, 38092252256622448, 224713853, 224713861, 8, 1440x900 
0x37CA2318, 38092252257282208, 224713918, 224713926, 8, 1440x900 
0x37CA2318, 38092252257943248, 224713982, 224713991, 9, 1440x900 
0x37CA2318, 38092252258609856, 224714052, 224714079, 27, 1440x900 
0x37CA2318, 38092252259266864, 224714112, 224714120, 8, 1440x900 
0x37CA2318, 38092252259914040, 224714177, 224714184, 7, 1440x900 
0x37CA2318, 38092252260583400, 224714243, 224714251, 8, 1440x900 
0x37CA2318, 38092252261243928, 224714308, 224714317, 9, 1440x900 
0x37CA2318, 38092252261907760, 224714377, 224714384, 7, 1440x900 
0x37CA2318, 38092252262571200, 224714444, 224714453, 9, 1440x900 
0x37CA2318, 38092252263224056, 224714508, 224714515, 7, 1440x900 
0x37CA2318, 38092252263885520, 224714573, 224714582, 9, 1440x900 
0x37CA2318, 38092252264545232, 224714643, 224714650, 7, 1440x900 
0x37CA2318, 38092252265212536, 224714709, 224714717, 8, 1440x900 
0x37CA2318, 38092252265874000, 224714778, 224714786, 8, 1440x900 
0x37CA2318, 38092252266534944, 224714842, 224714851, 9, 1440x900 
0x37CA2318, 38092252267188680, 224714907, 224714915, 8, 1440x900 
0x37CA2318, 38092252267855016, 224714978, 224714986, 8, 1440x900 
0x37CA2318, 38092252268785752, 224715074, 224715082, 8, 1440x900 
0x37CA2318, 38092252269222936, 224715107, 224715115, 8, 1440x900 
0x37CA2318, 38092252269841152, 224715172, 224715179, 7, 1440x900 
0x37CA2318, 38092252270493184, 224715239, 224715246, 7, 1440x900 
0x37CA2318, 38092252271201000, 224715307, 224715316, 9, 1440x900 
0x37CA2318, 38092252272225656, 224715411, 224715422, 11, 1440x900 
0x37CA2318, 38092252272532624, 224715441, 224715452, 11, 1440x900 
0x37CA2318, 38092252273136536, 224715505, 224715516, 11, 1440x900 
0x37CA2318, 38092252273834872, 224715572, 224715582, 10, 1440x900 
0x37CA2318, 38092252274465896, 224715632, 224715641, 9, 1440x900 
0x37CA2318, 38092252275126592, 224715698, 224715707, 9, 1440x900 
0x37CA2318, 38092252275792840, 224715768, 224715777, 9, 1440x900 
0x37CA2318, 38092252276454944, 224715833, 224715842, 9, 1440x900 
0x37CA2318, 38092252277108016, 224715897, 224715905, 8, 1440x900 
0x37CA2318, 38092252277787200, 224715966, 224715974, 8, 1440x900 
0x37CA2318, 38092252278438728, 224716032, 224716039, 7, 1440x900 
0x37CA2318, 38092252279106272, 224716097, 224716105, 8, 1440x900 
0x37CA2318, 38092252279779600, 224716169, 224716177, 8, 1440x900 
0x37CA2318, 38092252280439800, 224716233, 224716243, 10, 1440x900 
0x37CA2318, 38092252281099040, 224716298, 224716305, 7, 1440x900 
0x37CA2318, 38092252281881600, 224716373, 224716381, 8, 1440x900 
0x37CA2318, 38092252282420408, 224716427, 224716435, 8, 1440x900 
0x37CA2318, 38092252283207000, 224716517, 224716540, 23, 1440x900 
0x37CA2318, 38092252283776736, 224716563, 224716589, 26, 1440x900 
0x37CA2318, 38092252284656808, 224716661, 224716686, 25, 1440x900 
0x37CA2318, 38092252285174168, 224716708, 224716732, 24, 1440x900 
0x37CA2318, 38092252285892928, 224716777, 224716784, 7, 1440x900 
0x37CA2318, 38092252286446624, 224716832, 224716848, 16, 1440x900 
0x37CA2318, 38092252287141608, 224716902, 224716909, 7, 1440x900 
0x37CA2318, 38092252287770032, 224716962, 224716970, 8, 1440x900 
0x37CA2318, 38092252288430072, 224717028, 224717036, 8, 1440x900 
0x37CA2318, 38092252289090800, 224717093, 224717100, 7, 1440x900 
0x37CA2318, 38092252289754128, 224717162, 224717169, 7, 1440x900 
0x37CA2318, 38092252290410224, 224717227, 224717234, 7, 1440x900 
0x37CA2318, 38092252291070160, 224717293, 224717300, 7, 1440x900 
0x37CA2318, 38092252291730096, 224717358, 224717365, 7, 1440x900 
0x37CA2318, 38092252292410928, 224717432, 224717440, 8, 1440x900 
0x37CA2318, 38092252293076160, 224717498, 224717506, 8, 1440x900 
0x37CA2318, 38092252293730576, 224717562, 224717570, 8, 1440x900 
0x37CA2318, 38092252294380608, 224717622, 224717630, 8, 1440x900 
0x37CA2318, 38092252295041160, 224717688, 224717696, 8, 1440x900 
0x37CA2318, 38092252295710736, 224717757, 224717764, 7, 1440x900 
0x37CA2318, 38092252296372368, 224717822, 224717830, 8, 1440x900 
0x37CA2318, 38092252297042744, 224717897, 224717907, 10, 1440x900 
0x37CA2318, 38092252297732336, 224717957, 224717965, 8, 1440x900 
0x37CA2318, 38092252298385896, 224718023, 224718031, 8, 1440x900 
0x37CA2318, 38092252299043640, 224718088, 224718096, 8, 1440x900 
0x37CA2318, 38092252299869472, 224718174, 224718185, 11, 1440x900 
0x37CA2318, 38092252300539416, 224718238, 224718247, 9, 1440x900 
0x37CA2318, 38092252301005712, 224718286, 224718294, 8, 1440x900 
0x37CA2318, 38092252301858200, 224718372, 224718382, 10, 1440x900 
0x37CA2318, 38092252302527216, 224718441, 224718448, 7, 1440x900 
0x37CA2318, 38092252303176736, 224718502, 224718511, 9, 1440x900 
0x37CA2318, 38092252303671152, 224718552, 224718560, 8, 1440x900 
0x37CA2318, 38092252304320232, 224718622, 224718630, 8, 1440x900 
0x37CA2318, 38092252304991528, 224718687, 224718695, 8, 1440x900 
0x37CA2318, 38092252305640152, 224718750, 224718758, 8, 1440x900 
0x37CA2318, 38092252306301408, 224718816, 224718825, 9, 1440x900 
0x37CA2318, 38092252306967128, 224718882, 224718891, 9, 1440x900 
0x37CA2318, 38092252307629952, 224718948, 224718957, 9, 1440x900 
0x37CA2318, 38092252308294416, 224719022, 224719031, 9, 1440x900 
0x37CA2318, 38092252308947152, 224719082, 224719090, 8, 1440x900 
0x37CA2318, 38092252309639216, 224719154, 224719164, 10, 1440x900 
0x37CA2318, 38092252310285016, 224719213, 224719225, 12, 1440x900 
0x37CA2318, 38092252310943792, 224719282, 224719292, 10, 1440x900 
0x37CA2318, 38092252311661664, 224719360, 224719371, 11, 1440x900 
0x37CA2318, 38092252312291192, 224719417, 224719425, 8, 1440x900 
0x37CA2318, 38092252312932200, 224719477, 224719485, 8, 1440x900 
0x37CA2318, 38092252313596136, 224719547, 224719556, 9, 1440x900 
0x37CA2318, 38092252314269240, 224719612, 224719620, 8, 1440x900 
0x37CA2318, 38092252315042456, 224719696, 224719706, 10, 1440x900 
0x37CA2318, 38092252315680408, 224719759, 224719774, 15, 1440x900 
0x37CA2318, 38092252316339936, 224719818, 224719829, 11, 1440x900 
0x37CA2318, 38092252317047440, 224719895, 224719918, 23, 1440x900 
0x37CA2318, 38092252317643528, 224719951, 224719958, 7, 1440x900 
0x37CA2318, 38092252318256160, 224720012, 224720019, 7, 1440x900 
0x37CA2318, 38092252318916952, 224720078, 224720085, 7, 1440x900 
0x37CA2318, 38092252319576944, 224720142, 224720149, 7, 1440x900 
0x37CA2318, 38092252320237056, 224720208, 224720216, 8, 1440x900 
0x37CA2318, 38092252320907008, 224720278, 224720285, 7, 1440x900 
0x37CA2318, 38092252321560816, 224720344, 224720351, 7, 1440x900 
0x37CA2318, 38092252322232120, 224720412, 224720420, 8, 1440x900 
0x37CA2318, 38092252323550808, 224720543, 224720551, 8, 1440x900 
0x37CA2318, 38092252324212104, 224720607, 224720616, 9, 1440x900 
0x37CA2318, 38092252324881888, 224720676, 224720684, 8, 1440x900 
0x37CA2318, 38092252325571912, 224720743, 224720751, 8, 1440x900 
0x37CA2318, 38092252326228344, 224720809, 224720817, 8, 1440x900 
0x37CA2318, 38092252326863360, 224720873, 224720880, 7, 1440x900 
0x37CA2318, 38092252327515648, 224720937, 224720945, 8, 1440x900 
0x37CA2318, 38092252328183472, 224721006, 224721014, 8, 1440x900 
0x37CA2318, 38092252328851008, 224721073, 224721080, 7, 1440x900 
0x37CA2318, 38092252329505280, 224721137, 224721145, 8, 1440x900 
0x37CA2318, 38092252330163352, 224721202, 224721210, 8, 1440x900 
0x37CA2318, 38092252330826624, 224721272, 224721280, 8, 1440x900 
0x37CA2318, 38092252331689928, 224721357, 224721364, 7, 1440x900 
0x37CA2318, 38092252332148832, 224721402, 224721409, 7, 1440x900 
0x37CA2318, 38092252332837608, 224721468, 224721477, 9, 1440x900 
0x37CA2318, 38092252333467176, 224721532, 224721540, 8, 1440x900 
0x37CA2318, 38092252334131440, 224721598, 224721606, 8, 1440x900 
0x37CA2318, 38092252335000928, 224721687, 224721696, 9, 1440x900 
0x37CA2318, 38092252335651728, 224721758, 224721767, 9, 1440x900 
0x37CA2318, 38092252336120320, 224721797, 224721805, 8, 1440x900 
0x37CA2318, 38092252336806296, 224721867, 224721875, 8, 1440x900 
0x37CA2318, 38092252337436648, 224721928, 224721936, 8, 1440x900 
0x37CA2318, 38092252338288560, 224722013, 224722021, 8, 1440x900 
0x37CA2318, 38092252338933544, 224722077, 224722085, 8, 1440x900 
0x37CA2318, 38092252339428168, 224722132, 224722140, 8, 1440x900 
0x37CA2318, 38092252340094736, 224722198, 224722206, 8, 1440x900 
0x37CA2318, 38092252340754064, 224722268, 224722277, 9, 1440x900 
0x37CA2318, 38092252341417512, 224722333, 224722341, 8, 1440x900 
0x37CA2318, 38092252342069888, 224722397, 224722406, 9, 1440x900 
0x37CA2318, 38092252342729848, 224722463, 224722471, 8, 1440x900 
0x37CA2318, 38092252343398656, 224722532, 224722541, 9, 1440x900 
0x37CA2318, 38092252344052216, 224722594, 224722602, 8, 1440x900 
0x37CA2318, 38092252344713184, 224722663, 224722671, 8, 1440x900 
0x37CA2318, 38092252345379160, 224722728, 224722736, 8, 1440x900 
0x37CA2318, 38092252346130824, 224722803, 224722811, 8, 1440x900 
0x37CA2318, 38092252346695176, 224722856, 224722864, 8, 1440x900 
0x37CA2318, 38092252347355808, 224722922, 224722930, 8, 1440x900 
0x37CA2318, 38092252348042720, 224722992, 224722999, 7, 1440x900 
0x37CA2318, 38092252348700200, 224723058, 224723066, 8, 1440x900 
0x37CA2318, 38092252349333344, 224723118, 224723126, 8, 1440x900 
0x37CA2318, 38092252350180112, 224723203, 224723211, 8, 1440x900 
0x37CA2318, 38092252350685056, 224723253, 224723263, 10, 1440x900 
0x37CA2318, 38092252351321408, 224723317, 224723325, 8, 1440x900 
0x37CA2318, 38092252352173344, 224723402, 224723410, 8, 1440x900 
0x37CA2318, 38092252352831440, 224723468, 224723476, 8, 1440x900 
0x37CA2318, 38092252353493568, 224723533, 224723542, 9, 1440x900 
0x37CA2318, 38092252354162296, 224723602, 224723610, 8, 1440x900 
0x37CA2318, 38092252354783240, 224723667, 224723675, 8, 1440x900 
0x37CA2318, 38092252355278512, 224723714, 224723723, 9, 1440x900 
0x37CA2318, 38092252355945920, 224723783, 224723791, 8, 1440x900 
0x37CA2318, 38092252356610864, 224723853, 224723862, 9, 1440x900 
0x37CA2318, 38092252357261248, 224723912, 224723920, 8, 1440x900 
0x37CA2318, 38092252357916000, 224723977, 224723985, 8, 1440x900 
0x37CA2318, 38092252358577760, 224724044, 224724052, 8, 1440x900 
0x37CA2318, 38092252359237952, 224724112, 224724119, 7, 1440x900 
0x37CA2318, 38092252359898848, 224724177, 224724184, 7, 1440x900 
0x37CA2318, 38092252360562376, 224724244, 224724252, 8, 1440x900 
0x37CA2318, 38092252361233312, 224724308, 224724317, 9, 1440x900 
0x37CA2318, 38092252361892656, 224724379, 224724385, 6, 1440x900 
0x37CA2318, 38092252362744136, 224724463, 224724471, 8, 1440x900 
0x37CA2318, 38092252363406536, 224724532, 224724540, 8, 1440x900 
0x37CA2318, 38092252363981624, 224724587, 224724596, 9, 1440x900 
0x37CA2318, 38092252364534512, 224724643, 224724652, 9, 1440x900 
0x37CA2318, 38092252365197128, 224724713, 224724722, 9, 1440x900 
0x37CA2318, 38092252365864912, 224724779, 224724788, 9, 1440x900 
0x37CA2318, 38092252366519928, 224724838, 224724846, 8, 1440x900 
0x37CA2318, 38092252367356920, 224724922, 224724931, 9, 1440x900 
0x37CA2318, 38092252368019160, 224724988, 224724995, 7, 1440x900 
0x37CA2318, 38092252368702144, 224725057, 224725065, 8, 1440x900 
0x37CA2318, 38092252369338984, 224725121, 224725128, 7, 1440x900 
0x37CA2318, 38092252370187816, 224725206, 224725213, 7, 1440x900 
0x37CA2318, 38092252370648848, 224725252, 224725259, 7, 1440x900 
0x37CA2318, 38092252371310304, 224725317, 224725324, 7, 1440x900 
0x37CA2318, 38092252372161840, 224725403, 224725412, 9, 1440x900 
0x37CA2318, 38092252372829344, 224725473, 224725481, 8, 1440x900 
0x37CA2318, 38092252373492904, 224725538, 224725547, 9, 1440x900 
0x37CA2318, 38092252373964992, 224725588, 224725597, 9, 1440x900 
0x37CA2318, 38092252374814720, 224725669, 224725677, 8, 1440x900 
0x37CA2318, 38092252375276944, 224725713, 224725721, 8, 1440x900 
0x37CA2318, 38092252375936368, 224725778, 224725785, 7, 1440x900 
0x37CA2318, 38092252376693312, 224725857, 224725864, 7, 1440x900 
0x37CA2318, 38092252377261664, 224725912, 224725919, 7, 1440x900 
0x37CA2318, 38092252377924720, 224725983, 224725991, 8, 1440x900 
0x37CA2318, 38092252378779024, 224726063, 224726071, 8, 1440x900 
0x37CA2318, 38092252379242656, 224726111, 224726119, 8, 1440x900 
0x37CA2318, 38092252379903584, 224726177, 224726185, 8, 1440x900 
0x37CA2318, 38092252380562656, 224726242, 224726250, 8, 1440x900 
0x37CA2318, 38092252381222296, 224726308, 224726315, 7, 1440x900 
0x37CA2318, 38092252382087640, 224726393, 224726402, 9, 1440x900 
0x37CA2318, 38092252382550416, 224726442, 224726449, 7, 1440x900 
0x37CA2318, 38092252383210384, 224726508, 224726514, 6, 1440x900 
0x37CA2318, 38092252383869560, 224726572, 224726580, 8, 1440x900 
0x37CA2318, 38092252384530056, 224726637, 224726645, 8, 1440x900 
0x37CA2318, 38092252385189408, 224726703, 224726710, 7, 1440x900 
0x37CA2318, 38092252385849616, 224726772, 224726779, 7, 1440x900 
0x37CA2318, 38092252386513056, 224726838, 224726847, 9, 1440x900 
0x37CA2318, 38092252387172512, 224726903, 224726911, 8, 1440x900 
0x37CA2318, 38092252387830888, 224726967, 224726975, 8, 1440x900 
0x37CA2318, 38092252388491136, 224727036, 224727044, 8, 1440x900 
0x37CA2318, 38092252389151256, 224727102, 224727110, 8, 1440x900 
0x37CA2318, 38092252389812128, 224727167, 224727175, 8, 1440x900 
0x37CA2318, 38092252390475224, 224727238, 224727246, 8, 1440x900 
0x37CA2318, 38092252391135448, 224727302, 224727310, 8, 1440x900 
0x37CA2318, 38092252391797696, 224727373, 224727381, 8, 1440x900 
0x37CA2318, 38092252392457688, 224727433, 224727442, 9, 1440x900 
0x37CA2318, 38092252393120128, 224727497, 224727505, 8, 1440x900 
0x37CA2318, 38092252393775064, 224727562, 224727571, 9, 1440x900 
0x37CA2318, 38092252394434152, 224727628, 224727636, 8, 1440x900 
0x37CA2318, 38092252395098392, 224727697, 224727707, 10, 1440x900 
0x37CA2318, 38092252395757600, 224727763, 224727773, 10, 1440x900 
0x37CA2318, 38092252396427416, 224727833, 224727842, 9, 1440x900 
0x37CA2318, 38092252397084992, 224727897, 224727905, 8, 1440x900 
0x37CA2318, 38092252397746784, 224727962, 224727970, 8, 1440x900 
0x37CA2318, 38092252398415120, 224728028, 224728036, 8, 1440x900 
0x37CA2318, 38092252399075040, 224728093, 224728102, 9, 1440x900 
0x37CA2318, 38092252399736712, 224728163, 224728171, 8, 1440x900 
0x37CA2318, 38092252400393600, 224728226, 224728234, 8, 1440x900 
0x37CA2318, 38092252401053728, 224728292, 224728300, 8, 1440x900 
0x37CA2318, 38092252401713712, 224728357, 224728364, 7, 1440x900 
0x37CA2318, 38092252402375056, 224728423, 224728431, 8, 1440x900 
0x37CA2318, 38092252403034056, 224728491, 224728498, 7, 1440x900 
0x37CA2318, 38092252403694312, 224728553, 224728561, 8, 1440x900 
0x37CA2318, 38092252404360464, 224728628, 224728637, 9, 1440x900 
0x37CA2318, 38092252405024400, 224728696, 224728706, 10, 1440x900 
0x37CA2318, 38092252406337224, 224728822, 224728830, 8, 1440x900 
0x37CA2318, 38092252406997056, 224728887, 224728896, 9, 1440x900 
0x37CA2318, 38092252407666400, 224728952, 224728961, 9, 1440x900 
0x37CA2318, 38092252408324016, 224729017, 224729025, 8, 1440x900 
0x37CA2318, 38092252408985536, 224729083, 224729092, 9, 1440x900 
0x37CA2318, 38092252409645760, 224729152, 224729160, 8, 1440x900 
0x37CA2318, 38092252410306720, 224729217, 224729225, 8, 1440x900 
0x37CA2318, 38092252410965392, 224729282, 224729290, 8, 1440x900 
0x37CA2318, 38092252411627344, 224729352, 224729360, 8, 1440x900 
0x37CA2318, 38092252412287760, 224729417, 224729426, 9, 1440x900 
0x37CA2318, 38092252412960936, 224729488, 224729497, 9, 1440x900 
0x37CA2318, 38092252413613312, 224729552, 224729560, 8, 1440x900 
0x37CA2318, 38092252414273984, 224729617, 224729625, 8, 1440x900 
0x37CA2318, 38092252414943328, 224729683, 224729692, 9, 1440x900 
0x37CA2318, 38092252415599848, 224729749, 224729758, 9, 1440x900 
0x37CA2318, 38092252416260152, 224729818, 224729827, 9, 1440x900 
0x37CA2318, 38092252417064912, 224729892, 224729902, 10, 1440x900 
0x37CA2318, 38092252417586152, 224729944, 224729952, 8, 1440x900 
0x37CA2318, 38092252418283720, 224730013, 224730023, 10, 1440x900 
0x37CA2318, 38092252418898816, 224730076, 224730084, 8, 1440x900 
0x37CA2318, 38092252419654784, 224730151, 224730159, 8, 1440x900 
0x37CA2318, 38092252420224296, 224730208, 224730215, 7, 1440x900 
0x37CA2318, 38092252420885984, 224730277, 224730285, 8, 1440x900 
0x37CA2318, 38092252421748760, 224730367, 224730376, 9, 1440x900 
0x37CA2318, 38092252422215600, 224730407, 224730417, 10, 1440x900 
0x37CA2318, 38092252422898440, 224730477, 224730484, 7, 1440x900 
0x37CA2318, 38092252423526824, 224730538, 224730546, 8, 1440x900 
0x37CA2318, 38092252424189664, 224730608, 224730618, 10, 1440x900 
0x37CA2318, 38092252424846400, 224730672, 224730680, 8, 1440x900 
0x37CA2318, 38092252425520904, 224730742, 224730750, 8, 1440x900 
0x37CA2318, 38092252426170336, 224730808, 224730816, 8, 1440x900 
0x37CA2318, 38092252427024968, 224730894, 224730902, 8, 1440x900 
0x37CA2318, 38092252427499712, 224730938, 224730947, 9, 1440x900 
0x37CA2318, 38092252428155392, 224731005, 224731013, 8, 1440x900 
0x37CA2318, 38092252428808872, 224731073, 224731082, 9, 1440x900 
0x37CA2318, 38092252429480576, 224731137, 224731148, 11, 1440x900 
0x37CA2318, 38092252430145528, 224731202, 224731212, 10, 1440x900 
0x37CA2318, 38092252430801456, 224731270, 224731278, 8, 1440x900 
0x37CA2318, 38092252431456504, 224731333, 224731340, 7, 1440x900 
0x37CA2318, 38092252432116608, 224731397, 224731405, 8, 1440x900 
0x37CA2318, 38092252432785576, 224731462, 224731471, 9, 1440x900 
0x37CA2318, 38092252433445272, 224731532, 224731539, 7, 1440x900 
0x37CA2318, 38092252434107048, 224731597, 224731605, 8, 1440x900 
0x37CA2318, 38092252434964752, 224731682, 224731690, 8, 1440x900 
0x37CA2318, 38092252435427072, 224731728, 224731736, 8, 1440x900 
0x37CA2318, 38092252436087280, 224731797, 224731805, 8, 1440x900 
0x37CA2318, 38092252436747376, 224731862, 224731870, 8, 1440x900 
0x37CA2318, 38092252437608432, 224731952, 224731960, 8, 1440x900 
0x37CA2318, 38092252438072992, 224731998, 224732006, 8, 1440x900 
0x37CA2318, 38092252438728560, 224732058, 224732067, 9, 1440x900 
0x37CA2318, 38092252439388664, 224732127, 224732135, 8, 1440x900 
0x37CA2318, 38092252440050464, 224732197, 224732205, 8, 1440x900 
0x37CA2318, 38092252440712984, 224732262, 224732270, 8, 1440x900 
0x37CA2318, 38092252441378880, 224732326, 224732335, 9, 1440x900 
0x37CA2318, 38092252442034896, 224732391, 224732399, 8, 1440x900 
0x37CA2318, 38092252442703896, 224732456, 224732465, 9, 1440x900 
0x37CA2318, 38092252443367400, 224732533, 224732542, 9, 1440x900 
0x37CA2318, 38092252444022424, 224732587, 224732595, 8, 1440x900 
0x37CA2318, 38092252444682344, 224732657, 224732666, 9, 1440x900 
0x37CA2318, 38092252445344776, 224732722, 224732730, 8, 1440x900 
0x37CA2318, 38092252446095664, 224732797, 224732805, 8, 1440x900 
0x37CA2318, 38092252446676320, 224732854, 224732869, 15, 1440x900 
0x37CA2318, 38092252447357360, 224732922, 224732931, 9, 1440x900 
0x37CA2318, 38092252447989056, 224732983, 224732991, 8, 1440x900 
0x37CA2318, 38092252448643184, 224733051, 224733059, 8, 1440x900 
0x37CA2318, 38092252449303208, 224733116, 224733124, 8, 1440x900 
0x37CA2318, 38092252449964032, 224733182, 224733190, 8, 1440x900 
0x37CA2318, 38092252450624544, 224733248, 224733256, 8, 1440x900 
0x37CA2318, 38092252451418544, 224733328, 224733336, 8, 1440x900 
0x37CA2318, 38092252451953728, 224733382, 224733397, 15, 1440x900 
0x37CA2318, 38092252452646464, 224733448, 224733457, 9, 1440x900 
0x37CA2318, 38092252453476240, 224733533, 224733541, 8, 1440x900 
0x37CA2318, 38092252454142720, 224733598, 224733607, 9, 1440x900 
0x37CA2318, 38092252454797224, 224733666, 224733674, 8, 1440x900 
0x37CA2318, 38092252455259504, 224733712, 224733719, 7, 1440x900 
0x37CA2318, 38092252455919488, 224733777, 224733786, 9, 1440x900 
0x37CA2318, 38092252456781632, 224733868, 224733877, 9, 1440x900 
0x37CA2318, 38092252457445688, 224733932, 224733940, 8, 1440x900 
0x37CA2318, 38092252457910696, 224733977, 224733986, 9, 1440x900 
0x37CA2318, 38092252458597712, 224734043, 224734052, 9, 1440x900 
0x37CA2318, 38092252459222208, 224734108, 224734115, 7, 1440x900 
0x37CA2318, 38092252459885160, 224734173, 224734182, 9, 1440x900 
0x37CA2318, 38092252460743648, 224734263, 224734272, 9, 1440x900 
0x37CA2318, 38092252461252208, 224734311, 224734319, 8, 1440x900 
0x37CA2318, 38092252461871880, 224734373, 224734381, 8, 1440x900 
0x37CA2318, 38092252462526392, 224734438, 224734446, 8, 1440x900 
0x37CA2318, 38092252463186320, 224734506, 224734514, 8, 1440x900 
0x37CA2318, 38092252463852032, 224734577, 224734585, 8, 1440x900 
0x37CA2318, 38092252464512072, 224734642, 224734650, 8, 1440x900 
0x37CA2318, 38092252465173392, 224734707, 224734715, 8, 1440x900 
0x37CA2318, 38092252465835160, 224734772, 224734781, 9, 1440x900 
0x37CA2318, 38092252466496544, 224734842, 224734851, 9, 1440x900 
0x37CA2318, 38092252467156776, 224734903, 224734912, 9, 1440x900 
0x37CA2318, 38092252467819088, 224734972, 224734980, 8, 1440x900 
0x37CA2318, 38092252468480248, 224735038, 224735047, 9, 1440x900 
0x37CA2318, 38092252469137264, 224735103, 224735111, 8, 1440x900 
0x37CA2318, 38092252469993576, 224735188, 224735197, 9, 1440x900 
0x37CA2318, 38092252470656176, 224735253, 224735262, 9, 1440x900 
0x37CA2318, 38092252471318656, 224735319, 224735328, 9, 1440x900 
0x37CA2318, 38092252471972864, 224735388, 224735396, 8, 1440x900 
0x37CA2318, 38092252472642144, 224735453, 224735462, 9, 1440x900 
0x37CA2318, 38092252473107552, 224735497, 224735507, 10, 1440x900 
0x37CA2318, 38092252473765032, 224735563, 224735572, 9, 1440x900 
0x37CA2318, 38092252474433440, 224735632, 224735641, 9, 1440x900 
0x37CA2318, 38092252475088224, 224735698, 224735707, 9, 1440x900 
0x37CA2318, 38092252475753488, 224735767, 224735775, 8, 1440x900 
0x37CA2318, 38092252477073464, 224735898, 224735907, 9, 1440x900 
0x37CA2318, 38092252477736480, 224735962, 224735971, 9, 1440x900 
0x37CA2318, 38092252478390552, 224736027, 224736035, 8, 1440x900 
0x37CA2318, 38092252479251320, 224736111, 224736119, 8, 1440x900 
0x37CA2318, 38092252479912576, 224736177, 224736186, 9, 1440x900 
0x37CA2318, 38092252480392952, 224736228, 224736237, 9, 1440x900 
0x37CA2318, 38092252481064320, 224736296, 224736306, 10, 1440x900 
0x37CA2318, 38092252481718000, 224736358, 224736365, 7, 1440x900 
0x37CA2318, 38092252482353768, 224736422, 224736430, 8, 1440x900 
0x37CA2318, 38092252483014512, 224736488, 224736495, 7, 1440x900 
0x37CA2318, 38092252483673936, 224736553, 224736561, 8, 1440x900 
0x37CA2318, 38092252484333296, 224736618, 224736626, 8, 1440x900 
0x37CA2318, 38092252484997560, 224736687, 224736695, 8, 1440x900 
0x37CA2318, 38092252485657680, 224736752, 224736759, 7, 1440x900 
0x37CA2318, 38092252486317608, 224736817, 224736825, 8, 1440x900 
0x37CA2318, 38092252486983216, 224736887, 224736895, 8, 1440x900 
0x37CA2318, 38092252487642304, 224736953, 224736962, 9, 1440x900 
0x37CA2318, 38092252488302672, 224737022, 224737030, 8, 1440x900 
0x37CA2318, 38092252488963128, 224737087, 224737096, 9, 1440x900 
0x37CA2318, 38092252489621360, 224737148, 224737157, 9, 1440x900 
0x37CA2318, 38092252490280416, 224737217, 224737226, 9, 1440x900 
0x37CA2318, 38092252490940224, 224737282, 224737289, 7, 1440x900 
0x37CA2318, 38092252491600080, 224737347, 224737355, 8, 1440x900 
0x37CA2318, 38092252492263088, 224737417, 224737426, 9, 1440x900 
0x37CA2318, 38092252492928224, 224737483, 224737491, 8, 1440x900 
0x37CA2318, 38092252493696216, 224737562, 224737571, 9, 1440x900 
0x37CA2318, 38092252494247112, 224737612, 224737620, 8, 1440x900 
0x37CA2318, 38092252494914704, 224737683, 224737691, 8, 1440x900 
0x37CA2318, 38092252495572840, 224737747, 224737756, 9, 1440x900 
0x37CA2318, 38092252496230304, 224737811, 224737819, 8, 1440x900 
0x37CA2318, 38092252496890432, 224737874, 224737883, 9, 1440x900 
0x37CA2318, 38092252497552864, 224737943, 224737952, 9, 1440x900 
0x37CA2318, 38092252498218024, 224738012, 224738021, 9, 1440x900 
0x37CA2318, 38092252498881216, 224738078, 224738087, 9, 1440x900 
0x37CA2318, 38092252499534928, 224738144, 224738152, 8, 1440x900 
0x37CA2318, 38092252500200280, 224738207, 224738218, 11, 1440x900 
0x37CA2318, 38092252500869040, 224738277, 224738285, 8, 1440x900 
0x37CA2318, 38092252501523112, 224738344, 224738353, 9, 1440x900 
0x37CA2318, 38092252502191320, 224738408, 224738415, 7, 1440x900 
0x37CA2318, 38092252502857224, 224738473, 224738481, 8, 1440x900 
0x37CA2318, 38092252503508416, 224738537, 224738545, 8, 1440x900 
0x37CA2318, 38092252504167520, 224738603, 224738611, 8, 1440x900 
0x37CA2318, 38092252504834088, 224738668, 224738677, 9, 1440x900 
0x37CA2318, 38092252505489920, 224738733, 224738741, 8, 1440x900 
0x37CA2318, 38092252506152640, 224738803, 224738811, 8, 1440x900 
0x37CA2318, 38092252506812808, 224738872, 224738880, 8, 1440x900 
0x37CA2318, 38092252507474928, 224738938, 224738947, 9, 1440x900 
0x37CA2318, 38092252508137600, 224739002, 224739011, 9, 1440x900 
0x37CA2318, 38092252508795808, 224739068, 224739077, 9, 1440x900 
0x37CA2318, 38092252509457192, 224739133, 224739142, 9, 1440x900 
0x37CA2318, 38092252510112784, 224739197, 224739205, 8, 1440x900 
0x37CA2318, 38092252510953304, 224739282, 224739289, 7, 1440x900 
0x37CA2318, 38092252511434880, 224739332, 224739340, 8, 1440x900 
0x37CA2318, 38092252512094112, 224739398, 224739406, 8, 1440x900 
0x37CA2318, 38092252512753992, 224739463, 224739471, 8, 1440x900 
0x37CA2318, 38092252513417736, 224739533, 224739542, 9, 1440x900 
0x37CA2318, 38092252514075880, 224739593, 224739602, 9, 1440x900 
0x37CA2318, 38092252514735400, 224739659, 224739668, 9, 1440x900 
0x37CA2318, 38092252515395320, 224739727, 224739735, 8, 1440x900 
0x37CA2318, 38092252516056544, 224739792, 224739801, 9, 1440x900 
0x37CA2318, 38092252516715952, 224739857, 224739866, 9, 1440x900 
0x37CA2318, 38092252517376400, 224739923, 224739932, 9, 1440x900 
0x37CA2318, 38092252518036520, 224739993, 224740001, 8, 1440x900 
0x37CA2318, 38092252518696592, 224740056, 224740064, 8, 1440x900 
0x37CA2318, 38092252519365328, 224740122, 224740131, 9, 1440x900 
0x37CA2318, 38092252520026360, 224740187, 224740196, 9, 1440x900 
0x37CA2318, 38092252520699528, 224740263, 224740271, 8, 1440x900 
0x37CA2318, 38092252521357048, 224740328, 224740337, 9, 1440x900 
0x37CA2318, 38092252522017640, 224740392, 224740401, 9, 1440x900 
0x37CA2318, 38092252522677144, 224740458, 224740467, 9, 1440x900 
0x37CA2318, 38092252523350424, 224740532, 224740542, 10, 1440x900 
0x37CA2318, 38092252523998360, 224740587, 224740594, 7, 1440x900 
0x37CA2318, 38092252524654784, 224740652, 224740660, 8, 1440x900 
0x37CA2318, 38092252525314928, 224740718, 224740726, 8, 1440x900 
0x37CA2318, 38092252525975056, 224740783, 224740793, 10, 1440x900 
0x37CA2318, 38092252526641856, 224740853, 224740861, 8, 1440x900 
0x37CA2318, 38092252527309408, 224740923, 224740932, 9, 1440x900 
0x37CA2318, 38092252527967840, 224740987, 224740995, 8, 1440x900 
0x37CA2318, 38092252528821208, 224741068, 224741078, 10, 1440x900 
0x37CA2318, 38092252529491216, 224741137, 224741145, 8, 1440x900 
0x37CA2318, 38092252530151280, 224741203, 224741213, 10, 1440x900 
0x37CA2318, 38092252530608736, 224741252, 224741261, 9, 1440x900 
0x37CA2318, 38092252531273552, 224741318, 224741327, 9, 1440x900 
0x37CA2318, 38092252531924040, 224741377, 224741385, 8, 1440x900 
0x37CA2318, 38092252532585440, 224741447, 224741455, 8, 1440x900 
0x37CA2318, 38092252533904152, 224741578, 224741585, 7, 1440x900 
0x37CA2318, 38092252534567432, 224741642, 224741651, 9, 1440x900 
0x37CA2318, 38092252535227192, 224741712, 224741720, 8, 1440x900 
0x37CA2318, 38092252535887648, 224741777, 224741786, 9, 1440x900 
0x37CA2318, 38092252536569744, 224741843, 224741851, 8, 1440x900 
0x37CA2318, 38092252537228624, 224741907, 224741916, 9, 1440x900 
0x37CA2318, 38092252537888840, 224741978, 224741985, 7, 1440x900 
0x37CA2318, 38092252538548808, 224742042, 224742050, 8, 1440x900 
0x37CA2318, 38092252539213104, 224742108, 224742118, 10, 1440x900 
0x37CA2318, 38092252539872960, 224742178, 224742187, 9, 1440x900 
0x37CA2318, 38092252540534624, 224742243, 224742252, 9, 1440x900 
0x37CA2318, 38092252541191240, 224742307, 224742315, 8, 1440x900 
0x37CA2318, 38092252541850272, 224742372, 224742379, 7, 1440x900 
0x37CA2318, 38092252542512800, 224742437, 224742444, 7, 1440x900 
0x37CA2318, 38092252543175312, 224742503, 224742510, 7, 1440x900 
0x37CA2318, 38092252543831472, 224742568, 224742576, 8, 1440x900 
0x37CA2318, 38092252544491712, 224742633, 224742642, 9, 1440x900 
0x37CA2318, 38092252545154416, 224742708, 224742716, 8, 1440x900 
0x37CA2318, 38092252545823136, 224742773, 224742781, 8, 1440x900 
0x37CA2318, 38092252546483336, 224742833, 224742842, 9, 1440x900 
0x37CA2318, 38092252547140856, 224742902, 224742910, 8, 1440x900 
0x37CA2318, 38092252547805248, 224742967, 224742976, 9, 1440x900 
0x37CA2318, 38092252548465272, 224743032, 224743041, 9, 1440x900 
0x37CA2318, 38092252549125840, 224743097, 224743106, 9, 1440x900 
0x37CA2318, 38092252549781408, 224743163, 224743171, 8, 1440x900 
0x37CA2318, 38092252550440952, 224743231, 224743239, 8, 1440x900 
0x37CA2318, 38092252551258720, 224743313, 224743322, 9, 1440x900 
0x37CA2318, 38092252551962112, 224743381, 224743389, 8, 1440x900 
0x37CA2318, 38092252552617944, 224743447, 224743455, 8, 1440x900 
0x37CA2318, 38092252553079680, 224743493, 224743501, 8, 1440x900 
0x37CA2318, 38092252553739536, 224743558, 224743566, 8, 1440x900 
0x37CA2318, 38092252554401432, 224743626, 224743634, 8, 1440x900 
0x37CA2318, 38092252555061456, 224743692, 224743700, 8, 1440x900 
0x37CA2318, 38092252555724552, 224743759, 224743769, 10, 1440x900 
0x37CA2318, 38092252556384200, 224743828, 224743836, 8, 1440x900 
0x37CA2318, 38092252557043864, 224743893, 224743902, 9, 1440x900 
0x37CA2318, 38092252557701056, 224743956, 224743964, 8, 1440x900 
0x37CA2318, 38092252558361128, 224744022, 224744031, 9, 1440x900 
0x37CA2318, 38092252559217536, 224744113, 224744122, 9, 1440x900 
0x37CA2318, 38092252559914504, 224744187, 224744197, 10, 1440x900 
0x37CA2318, 38092252560468560, 224744233, 224744243, 10, 1440x900 
0x37CA2318, 38092252561142208, 224744311, 224744334, 23, 1440x900 
0x37CA2318, 38092252563652888, 224744552, 224744559, 7, 1440x900 
0x37CA2318, 38092252564314008, 224744616, 224744625, 9, 1440x900 
0x37CA2318, 38092252566302624, 224744817, 224744832, 15, 1440x900 
0x37CA2318, 38092252566999080, 224744887, 224744894, 7, 1440x900 
0x37CA2318, 38092252567628792, 224744948, 224744956, 8, 1440x900 
0x37CA2318, 38092252568284032, 224745017, 224745024, 7, 1440x900 
0x37CA2318, 38092252568944584, 224745084, 224745094, 10, 1440x900 
0x37CA2318, 38092252569632448, 224745147, 224745159, 12, 1440x900 
0x37CA2318, 38092252570272520, 224745213, 224745223, 10, 1440x900 
0x37CA2318, 38092252570932704, 224745278, 224745286, 8, 1440x900 
0x37CA2318, 38092252571592200, 224745344, 224745352, 8, 1440x900 
0x37CA2318, 38092252572250664, 224745411, 224745418, 7, 1440x900 
0x37CA2318, 38092252572911120, 224745477, 224745484, 7, 1440x900 
0x37CA2318, 38092252573573288, 224745543, 224745550, 7, 1440x900 
0x37CA2318, 38092252574236144, 224745608, 224745616, 8, 1440x900 
0x37CA2318, 38092252574896008, 224745677, 224745685, 8, 1440x900 
0x37CA2318, 38092252575556128, 224745742, 224745749, 7, 1440x900 
0x37CA2318, 38092252576215912, 224745807, 224745814, 7, 1440x900 
0x37CA2318, 38092252576876032, 224745873, 224745881, 8, 1440x900 
0x37CA2318, 38092252577616552, 224745947, 224745954, 7, 1440x900 
0x37CA2318, 38092252578412272, 224746028, 224746035, 7, 1440x900 
0x37CA2318, 38092252578910864, 224746078, 224746087, 9, 1440x900 
0x37CA2318, 38092252579556728, 224746144, 224746157, 13, 1440x900 
0x37CA2318, 38092252580225128, 224746223, 224746233, 10, 1440x900 
0x37CA2318, 38092252580882104, 224746273, 224746281, 8, 1440x900 
0x37CA2318, 38092252581500720, 224746337, 224746344, 7, 1440x900 
0x37CA2318, 38092252582207880, 224746407, 224746414, 7, 1440x900 
0x37CA2318, 38092252583024064, 224746488, 224746495, 7, 1440x900 
0x37CA2318, 38092252583571648, 224746543, 224746550, 7, 1440x900 
0x37CA2318, 38092252584146464, 224746604, 224746613, 9, 1440x900 
0x37CA2318, 38092252585866400, 224746772, 224746783, 11, 1440x900 
0x37CA2318, 38092252585952792, 224746784, 224746792, 8, 1440x900 
0x37CA2318, 38092252586550456, 224746845, 224746853, 8, 1440x900 
0x37CA2318, 38092252587861432, 224746972, 224746979, 7, 1440x900 
0x37CA2318, 38092252588512864, 224747038, 224747045, 7, 1440x900 
0x37CA2318, 38092252629240816, 224751124, 224751134, 10, 1440x900 
0x37CA2318, 38092252629567248, 224751151, 224751164, 13, 1440x900 
0x37CA2318, 38092252629983392, 224751183, 224751194, 11, 1440x900 
0x37CA2318, 38092252630896624, 224751281, 224751291, 10, 1440x900 
0x37CA2318, 38092252631401504, 224751327, 224751347, 20, 1440x900 
0x37CA2318, 38092252632013360, 224751389, 224751397, 8, 1440x900 
0x37CA2318, 38092252632671640, 224751452, 224751460, 8, 1440x900 
0x37CA2318, 38092252633330856, 224751518, 224751525, 7, 1440x900 
0x37CA2318, 38092252633987416, 224751583, 224751591, 8, 1440x900 
0x37CA2318, 38092252634652176, 224751653, 224751661, 8, 1440x900 
0x37CA2318, 38092252635320792, 224751719, 224751727, 8, 1440x900 
0x37CA2318, 38092252635973528, 224751787, 224751795, 8, 1440x900 
0x37CA2318, 38092252636632672, 224751852, 224751862, 10, 1440x900 
0x37CA2318, 38092252637367120, 224751924, 224751932, 8, 1440x900 
0x37CA2318, 38092252637960160, 224751983, 224751990, 7, 1440x900 
0x37CA2318, 38092252638618688, 224752047, 224752055, 8, 1440x900 
0x37CA2318, 38092252639278632, 224752113, 224752121, 8, 1440x900 
0x37CA2318, 38092252639938688, 224752178, 224752186, 8, 1440x900 
0x37CA2318, 38092252640598720, 224752247, 224752254, 7, 1440x900 
0x37CA2318, 38092252641258728, 224752311, 224752319, 8, 1440x900 
0x37CA2318, 38092252641919800, 224752378, 224752385, 7, 1440x900 
0x37CA2318, 38092252642583272, 224752447, 224752454, 7, 1440x900 
0x37CA2318, 38092252643242880, 224752512, 224752520, 8, 1440x900 
0x37CA2318, 38092252643914696, 224752578, 224752585, 7, 1440x900 
0x37CA2318, 38092252644584664, 224752648, 224752656, 8, 1440x900 
0x37CA2318, 38092252645259768, 224752712, 224752719, 7, 1440x900 
0x37CA2318, 38092252646747360, 224752862, 224752869, 7, 1440x900 
0x37CA2318, 38092252647408448, 224752927, 224752933, 6, 1440x900 
0x37CA2318, 38092252648066736, 224752993, 224753000, 7, 1440x900 
0x37CA2318, 38092252648738992, 224753061, 224753068, 7, 1440x900 
0x37CA2318, 38092252649391832, 224753126, 224753134, 8, 1440x900 
0x37CA2318, 38092252650042792, 224753191, 224753198, 7, 1440x900 
0x37CA2318, 38092252650706712, 224753263, 224753271, 8, 1440x900 
0x37CA2318, 38092252651176600, 224753308, 224753316, 8, 1440x900 
0x37CA2318, 38092252651839920, 224753373, 224753382, 9, 1440x900 
0x37CA2318, 38092252652496880, 224753437, 224753444, 7, 1440x900 
0x37CA2318, 38092252653153080, 224753502, 224753509, 7, 1440x900 
0x37CA2318, 38092252653822216, 224753568, 224753575, 7, 1440x900 
0x37CA2318, 38092252654611600, 224753646, 224753653, 7, 1440x900 
0x37CA2318, 38092252655141440, 224753698, 224753705, 7, 1440x900 
0x37CA2318, 38092252655807560, 224753767, 224753775, 8, 1440x900 
0x37CA2318, 38092252656469248, 224753833, 224753840, 7, 1440x900 
0x37CA2318, 38092252657127688, 224753899, 224753906, 7, 1440x900 
0x37CA2318, 38092252657787744, 224753968, 224753976, 8, 1440x900 
0x37CA2318, 38092252658637200, 224754052, 224754060, 8, 1440x900 
0x37CA2318, 38092252659305696, 224754117, 224754124, 7, 1440x900 
0x37CA2318, 38092252659967624, 224754182, 224754189, 7, 1440x900 
0x37CA2318, 38092252660637336, 224754248, 224754256, 8, 1440x900 
0x37CA2318, 38092252661284856, 224754313, 224754321, 8, 1440x900 
0x37CA2318, 38092252661757992, 224754362, 224754370, 8, 1440x900 
0x37CA2318, 38092252662617248, 224754448, 224754455, 7, 1440x900 
0x37CA2318, 38092252663287272, 224754516, 224754524, 8, 1440x900 
0x37CA2318, 38092252663895024, 224754578, 224754585, 7, 1440x900 
0x37CA2318, 38092252664403304, 224754628, 224754636, 8, 1440x900 
0x37CA2318, 38092252665063432, 224754692, 224754700, 8, 1440x900 
0x37CA2318, 38092252665921224, 224754782, 224754791, 9, 1440x900 
0x37CA2318, 38092252666590032, 224754852, 224754860, 8, 1440x900 
0x37CA2318, 38092252667091912, 224754893, 224754901, 8, 1440x900 
0x37CA2318, 38092252667726920, 224754958, 224754965, 7, 1440x900 
0x37CA2318, 38092252668367248, 224755022, 224755029, 7, 1440x900 
0x37CA2318, 38092252669028568, 224755091, 224755099, 8, 1440x900 
0x37CA2318, 38092252669687768, 224755153, 224755161, 8, 1440x900 
0x37CA2318, 38092252670350616, 224755222, 224755228, 6, 1440x900 
0x37CA2318, 38092252671010288, 224755287, 224755294, 7, 1440x900 
0x37CA2318, 38092252671670664, 224755352, 224755359, 7, 1440x900 
0x37CA2318, 38092252672332536, 224755417, 224755424, 7, 1440x900 
0x37CA2318, 38092252672992376, 224755483, 224755491, 8, 1440x900 
0x37CA2318, 38092252673663392, 224755558, 224755566, 8, 1440x900 
0x37CA2318, 38092252674324256, 224755622, 224755630, 8, 1440x900 
0x37CA2318, 38092252675014560, 224755688, 224755695, 7, 1440x900 
0x37CA2318, 38092252675723464, 224755757, 224755765, 8, 1440x900 
0x37CA2318, 38092252676304464, 224755817, 224755824, 7, 1440x900 
0x37CA2318, 38092252676961728, 224755882, 224755889, 7, 1440x900 
0x37CA2318, 38092252677623872, 224755948, 224755956, 8, 1440x900 
0x37CA2318, 38092252678283872, 224756016, 224756024, 8, 1440x900 
0x37CA2318, 38092252678943520, 224756083, 224756090, 7, 1440x900 
0x37CA2318, 38092252679604032, 224756147, 224756156, 9, 1440x900 
0x37CA2318, 38092252680270336, 224756218, 224756226, 8, 1440x900 
0x37CA2318, 38092252680931352, 224756283, 224756291, 8, 1440x900 
0x37CA2318, 38092252681600152, 224756352, 224756360, 8, 1440x900 
0x37CA2318, 38092252682255256, 224756412, 224756419, 7, 1440x900 
0x37CA2318, 38092252682917864, 224756477, 224756484, 7, 1440x900 
0x37CA2318, 38092252683576200, 224756542, 224756550, 8, 1440x900 
0x37CA2318, 38092252684246520, 224756608, 224756616, 8, 1440x900 
0x37CA2318, 38092252684906280, 224756678, 224756684, 6, 1440x900 
0x37CA2318, 38092252685566808, 224756742, 224756750, 8, 1440x900 
0x37CA2318, 38092252686231568, 224756808, 224756816, 8, 1440x900 
0x37CA2318, 38092252686889544, 224756873, 224756881, 8, 1440x900 
0x37CA2318, 38092252687545872, 224756939, 224756947, 8, 1440x900 
0x37CA2318, 38092252688205840, 224757006, 224757013, 7, 1440x900 
0x37CA2318, 38092252688865888, 224757073, 224757080, 7, 1440x900 
0x37CA2318, 38092252689525880, 224757138, 224757145, 7, 1440x900 
0x37CA2318, 38092252690191416, 224757203, 224757211, 8, 1440x900 
0x37CA2318, 38092252690851456, 224757272, 224757279, 7, 1440x900 
0x37CA2318, 38092252691519664, 224757337, 224757346, 9, 1440x900 
0x37CA2318, 38092252692174496, 224757407, 224757414, 7, 1440x900 
0x37CA2318, 38092252692835008, 224757467, 224757475, 8, 1440x900 
0x37CA2318, 38092252693701712, 224757557, 224757564, 7, 1440x900 
0x37CA2318, 38092252694158808, 224757601, 224757608, 7, 1440x900 
0x37CA2318, 38092252695016400, 224757688, 224757694, 6, 1440x900 
0x37CA2318, 38092252695477160, 224757733, 224757740, 7, 1440x900 
0x37CA2318, 38092252696139784, 224757802, 224757811, 9, 1440x900 
0x37CA2318, 38092252696800032, 224757868, 224757876, 8, 1440x900 
0x37CA2318, 38092252697460432, 224757937, 224757945, 8, 1440x900 
0x37CA2318, 38092252698120368, 224758003, 224758011, 8, 1440x900 
0x37CA2318, 38092252698787784, 224758068, 224758076, 8, 1440x900 
0x37CA2318, 38092252699442912, 224758132, 224758141, 9, 1440x900 
0x37CA2318, 38092252700103016, 224758202, 224758210, 8, 1440x900 
0x37CA2318, 38092252700763152, 224758268, 224758276, 8, 1440x900 
0x37CA2318, 38092252701422872, 224758333, 224758341, 8, 1440x900 
0x37CA2318, 38092252702088920, 224758398, 224758406, 8, 1440x900 
0x37CA2318, 38092252703409312, 224758534, 224758542, 8, 1440x900 
0x37CA2318, 38092252704060888, 224758592, 224758599, 7, 1440x900 
0x37CA2318, 38092252704727376, 224758658, 224758666, 8, 1440x900 
0x37CA2318, 38092252705409048, 224758727, 224758735, 8, 1440x900 
0x37CA2318, 38092252706045872, 224758791, 224758798, 7, 1440x900 
0x37CA2318, 38092252706705768, 224758856, 224758864, 8, 1440x900 
0x37CA2318, 38092252707377464, 224758927, 224758935, 8, 1440x900 
0x37CA2318, 38092252708040352, 224758992, 224758999, 7, 1440x900 
0x37CA2318, 38092252708889064, 224759077, 224759084, 7, 1440x900 
0x37CA2318, 38092252709352976, 224759122, 224759129, 7, 1440x900 
0x37CA2318, 38092252710016992, 224759193, 224759201, 8, 1440x900 
0x37CA2318, 38092252710675664, 224759259, 224759267, 8, 1440x900 
0x37CA2318, 38092252711484944, 224759333, 224759345, 12, 1440x900 
0x37CA2318, 38092252712313000, 224759422, 224759439, 17, 1440x900 
0x37CA2318, 38092252728564960, 224761044, 224761052, 8, 1440x900 
0x37CA2318, 38092252729422128, 224761134, 224761146, 12, 1440x900 
0x37CA2318, 38092252731866008, 224761372, 224761380, 8, 1440x900 
0x37CA2318, 38092252732538544, 224761442, 224761451, 9, 1440x900 
0x37CA2318, 38092252733201312, 224761509, 224761517, 8, 1440x900 
0x37CA2318, 38092252733861248, 224761571, 224761580, 9, 1440x900 
0x37CA2318, 38092252734520576, 224761638, 224761646, 8, 1440x900 
0x37CA2318, 38092252735479688, 224761739, 224761750, 11, 1440x900 
0x37CA2318, 38092252735851480, 224761772, 224761779, 7, 1440x900 
0x37CA2318, 38092252736507640, 224761838, 224761845, 7, 1440x900 
0x37CA2318, 38092252737165336, 224761903, 224761910, 7, 1440x900 
0x37CA2318, 38092252737826200, 224761967, 224761975, 8, 1440x900 
0x37CA2318, 38092252738492992, 224762038, 224762044, 6, 1440x900 
0x37CA2318, 38092252739153112, 224762102, 224762109, 7, 1440x900 
0x37CA2318, 38092252739817344, 224762173, 224762180, 7, 1440x900 
0x37CA2318, 38092252740472880, 224762232, 224762240, 8, 1440x900 
0x37CA2318, 38092252741139888, 224762302, 224762309, 7, 1440x900 
0x37CA2318, 38092252741803544, 224762367, 224762374, 7, 1440x900 
0x37CA2318, 38092252742460840, 224762432, 224762439, 7, 1440x900 
0x37CA2318, 38092252743120000, 224762498, 224762505, 7, 1440x900 
0x37CA2318, 38092252743779968, 224762564, 224762571, 7, 1440x900 
0x37CA2318, 38092252744442224, 224762632, 224762641, 9, 1440x900 
0x37CA2318, 38092252745108272, 224762698, 224762705, 7, 1440x900 
0x37CA2318, 38092252745775328, 224762762, 224762770, 8, 1440x900 
0x37CA2318, 38092252746430472, 224762828, 224762836, 8, 1440x900 
0x37CA2318, 38092252747095072, 224762893, 224762901, 8, 1440x900 
0x37CA2318, 38092252747956312, 224762983, 224762990, 7, 1440x900 
0x37CA2318, 38092252748625816, 224763047, 224763055, 8, 1440x900 
0x37CA2318, 38092252749285688, 224763113, 224763121, 8, 1440x900 
0x37CA2318, 38092252749946000, 224763181, 224763188, 7, 1440x900 
0x37CA2318, 38092252750615896, 224763247, 224763255, 8, 1440x900 
0x37CA2318, 38092252751265240, 224763313, 224763322, 9, 1440x900 
0x37CA2318, 38092252751944368, 224763382, 224763389, 7, 1440x900 
0x37CA2318, 38092252752604168, 224763447, 224763454, 7, 1440x900 
0x37CA2318, 38092252753069360, 224763493, 224763500, 7, 1440x900 
0x37CA2318, 38092252753924976, 224763578, 224763586, 8, 1440x900 
0x37CA2318, 38092252754594808, 224763647, 224763654, 7, 1440x900 
0x37CA2318, 38092252755245528, 224763712, 224763719, 7, 1440x900 
0x37CA2318, 38092252755905136, 224763777, 224763784, 7, 1440x900 
0x37CA2318, 38092252756564584, 224763843, 224763850, 7, 1440x900 
0x37CA2318, 38092252757234160, 224763909, 224763916, 7, 1440x900 
0x37CA2318, 38092252757887432, 224763973, 224763981, 8, 1440x900 
0x37CA2318, 38092252758547392, 224764041, 224764048, 7, 1440x900 
0x37CA2318, 38092252759014264, 224764087, 224764096, 9, 1440x900 
0x37CA2318, 38092252759680888, 224764153, 224764161, 8, 1440x900 
0x37CA2318, 38092252760540352, 224764245, 224764263, 18, 1440x900 
0x37CA2318, 38092252761331872, 224764321, 224764330, 9, 1440x900 
0x37CA2318, 38092252761751552, 224764391, 224764401, 10, 1440x900 
0x37CA2318, 38092252762368712, 224764431, 224764448, 17, 1440x900 
0x37CA2318, 38092252763045856, 224764489, 224764499, 10, 1440x900 
0x37CA2318, 38092252763737216, 224764566, 224764580, 14, 1440x900 
0x37CA2318, 38092252764368552, 224764626, 224764636, 10, 1440x900 
0x37CA2318, 38092252765029816, 224764689, 224764699, 10, 1440x900 
0x37CA2318, 38092252765782392, 224764766, 224764774, 8, 1440x900 
0x37CA2318, 38092252766350680, 224764823, 224764832, 9, 1440x900 
0x37CA2318, 38092252767014768, 224764887, 224764894, 7, 1440x900 
0x37CA2318, 38092252767671592, 224764952, 224764960, 8, 1440x900 
0x37CA2318, 38092252768332112, 224765020, 224765029, 9, 1440x900 
0x37CA2318, 38092252768991552, 224765087, 224765094, 7, 1440x900 
0x37CA2318, 38092252769652712, 224765151, 224765160, 9, 1440x900 
0x37CA2318, 38092252770972120, 224765283, 224765291, 8, 1440x900 
0x37CA2318, 38092252771632248, 224765351, 224765359, 8, 1440x900 
0x37CA2318, 38092252772292344, 224765417, 224765424, 7, 1440x900 
0x37CA2318, 38092252773148768, 224765502, 224765510, 8, 1440x900 
0x37CA2318, 38092252773806712, 224765567, 224765574, 7, 1440x900 
0x37CA2318, 38092252774467592, 224765633, 224765641, 8, 1440x900 
0x37CA2318, 38092252775128016, 224765698, 224765706, 8, 1440x900 
0x37CA2318, 38092252775665208, 224765758, 224765769, 11, 1440x900 
0x37CA2318, 38092252776292080, 224765823, 224765842, 19, 1440x900 
0x37CA2318, 38092252776975344, 224765887, 224765911, 24, 1440x900 
0x37CA2318, 38092252777608592, 224765949, 224765967, 18, 1440x900 
0x37CA2318, 38092252778272824, 224766016, 224766045, 29, 1440x900 
0x37CA2318, 38092252778938288, 224766078, 224766109, 31, 1440x900 
0x37CA2318, 38092252779594456, 224766150, 224766163, 13, 1440x900 
0x37CA2318, 38092252780255560, 224766215, 224766225, 10, 1440x900 
0x37CA2318, 38092252780913528, 224766280, 224766290, 10, 1440x900 
0x37CA2318, 38092252781580608, 224766344, 224766362, 18, 1440x900 
0x37CA2318, 38092252782234552, 224766412, 224766420, 8, 1440x900 
0x37CA2318, 38092252783033112, 224766492, 224766499, 7, 1440x900 
0x37CA2318, 38092252783716064, 224766559, 224766570, 11, 1440x900 
0x37CA2318, 38092252784224752, 224766608, 224766619, 11, 1440x900 
0x37CA2318, 38092252785021312, 224766688, 224766701, 13, 1440x900 
0x37CA2318, 38092252785556784, 224766744, 224766755, 11, 1440x900 
0x37CA2318, 38092252786208000, 224766807, 224766815, 8, 1440x900 
0x37CA2318, 38092252786845056, 224766868, 224766876, 8, 1440x900 
0x37CA2318, 38092252787506096, 224766937, 224766945, 8, 1440x900 
0x37CA2318, 38092252788170248, 224767002, 224767010, 8, 1440x900 
0x37CA2318, 38092252788830448, 224767068, 224767076, 8, 1440x900 
0x37CA2318, 38092252789490136, 224767133, 224767142, 9, 1440x900 
0x37CA2318, 38092252790148928, 224767202, 224767210, 8, 1440x900 
0x37CA2318, 38092252790827192, 224767268, 224767276, 8, 1440x900 
0x37CA2318, 38092252791472592, 224767333, 224767340, 7, 1440x900 
0x37CA2318, 38092252792333344, 224767418, 224767426, 8, 1440x900 
0x37CA2318, 38092252792991856, 224767483, 224767491, 8, 1440x900 
0x37CA2318, 38092252793649864, 224767548, 224767556, 8, 1440x900 
0x37CA2318, 38092252794324936, 224767623, 224767631, 8, 1440x900 
0x37CA2318, 38092252794984424, 224767687, 224767695, 8, 1440x900 
0x37CA2318, 38092252795440208, 224767734, 224767742, 8, 1440x900 
0x37CA2318, 38092252796101680, 224767798, 224767807, 9, 1440x900 
0x37CA2318, 38092252796761560, 224767868, 224767876, 8, 1440x900 
0x37CA2318, 38092252797419248, 224767929, 224767937, 8, 1440x900 
0x37CA2318, 38092252798084608, 224767998, 224768005, 7, 1440x900 
0x37CA2318, 38092252798745688, 224768062, 224768069, 7, 1440x900 
0x37CA2318, 38092252799397456, 224768127, 224768134, 7, 1440x900 
0x37CA2318, 38092252800061264, 224768192, 224768200, 8, 1440x900 
0x37CA2318, 38092252800722208, 224768258, 224768266, 8, 1440x900 
0x37CA2318, 38092252801377456, 224768323, 224768331, 8, 1440x900 
0x37CA2318, 38092252802092368, 224768396, 224768403, 7, 1440x900 
0x37CA2318, 38092252802698464, 224768456, 224768464, 8, 1440x900 
0x37CA2318, 38092252803362312, 224768523, 224768532, 9, 1440x900 
0x37CA2318, 38092252804022152, 224768593, 224768601, 8, 1440x900 
0x37CA2318, 38092252804688728, 224768659, 224768667, 8, 1440x900 
0x37CA2318, 38092252805552400, 224768743, 224768751, 8, 1440x900 
0x37CA2318, 38092252806222736, 224768813, 224768821, 8, 1440x900 
0x37CA2318, 38092252806874584, 224768877, 224768885, 8, 1440x900 
0x37CA2318, 38092252807352728, 224768927, 224768935, 8, 1440x900 
0x37CA2318, 38092252808001928, 224768988, 224768995, 7, 1440x900 
0x37CA2318, 38092252808657952, 224769052, 224769060, 8, 1440x900 
0x37CA2318, 38092252809316384, 224769117, 224769124, 7, 1440x900 
0x37CA2318, 38092252810175336, 224769203, 224769212, 9, 1440x900 
0x37CA2318, 38092252810834368, 224769272, 224769280, 8, 1440x900 
0x37CA2318, 38092252811503280, 224769338, 224769347, 9, 1440x900 
0x37CA2318, 38092252812153920, 224769403, 224769411, 8, 1440x900 
0x37CA2318, 38092252812818104, 224769472, 224769481, 9, 1440x900 
0x37CA2318, 38092252813477216, 224769533, 224769541, 8, 1440x900 
0x37CA2318, 38092252814060840, 224769593, 224769600, 7, 1440x900 
0x37CA2318, 38092252814656952, 224769652, 224769659, 7, 1440x900 
0x37CA2318, 38092252815264168, 224769712, 224769720, 8, 1440x900 
0x37CA2318, 38092252816126712, 224769797, 224769805, 8, 1440x900 
0x37CA2318, 38092252816788680, 224769863, 224769871, 8, 1440x900 
0x37CA2318, 38092252817317872, 224769917, 224769924, 7, 1440x900 
0x37CA2318, 38092252817967104, 224769983, 224769990, 7, 1440x900 
0x37CA2318, 38092252818562488, 224770043, 224770050, 7, 1440x900 
0x37CA2318, 38092252819233064, 224770108, 224770115, 7, 1440x900 
0x37CA2318, 38092252819886280, 224770177, 224770185, 8, 1440x900 
0x37CA2318, 38092252820546472, 224770243, 224770251, 8, 1440x900 
0x37CA2318, 38092252821213096, 224770312, 224770320, 8, 1440x900 
0x37CA2318, 38092252821895488, 224770378, 224770387, 9, 1440x900 
0x37CA2318, 38092252822527416, 224770437, 224770445, 8, 1440x900 
0x37CA2318, 38092252823193928, 224770507, 224770515, 8, 1440x900 
0x37CA2318, 38092252823854064, 224770572, 224770580, 8, 1440x900 
0x37CA2318, 38092252824515248, 224770636, 224770645, 9, 1440x900 
0x37CA2318, 38092252825194200, 224770708, 224770716, 8, 1440x900 
0x37CA2318, 38092252825878112, 224770777, 224770786, 9, 1440x900 
0x37CA2318, 38092252826540648, 224770850, 224770859, 9, 1440x900 
0x37CA2318, 38092252827230072, 224770907, 224770915, 8, 1440x900 
0x37CA2318, 38092252827859568, 224770972, 224770979, 7, 1440x900 
0x37CA2318, 38092252828520200, 224771037, 224771045, 8, 1440x900 
0x37CA2318, 38092252829322448, 224771122, 224771132, 10, 1440x900 
0x37CA2318, 38092252830263584, 224771219, 224771227, 8, 1440x900 
0x37CA2318, 38092252830640088, 224771253, 224771260, 7, 1440x900 
0x37CA2318, 38092252831286024, 224771317, 224771324, 7, 1440x900 
0x37CA2318, 38092252831994560, 224771386, 224771393, 7, 1440x900 
0x37CA2318, 38092252832602368, 224771447, 224771454, 7, 1440x900 
0x37CA2318, 38092252833269232, 224771512, 224771520, 8, 1440x900 
0x37CA2318, 38092252833935232, 224771582, 224771589, 7, 1440x900 
0x37CA2318, 38092252834590176, 224771646, 224771653, 7, 1440x900 
0x37CA2318, 38092252835250344, 224771712, 224771719, 7, 1440x900 
0x37CA2318, 38092252835911976, 224771777, 224771784, 7, 1440x900 
0x37CA2318, 38092252836571816, 224771842, 224771851, 9, 1440x900 
0x37CA2318, 38092252837243760, 224771908, 224771916, 8, 1440x900 
0x37CA2318, 38092252837901792, 224771976, 224771984, 8, 1440x900 
0x37CA2318, 38092252838562000, 224772042, 224772049, 7, 1440x900 
0x37CA2318, 38092252839221856, 224772108, 224772115, 7, 1440x900 
0x37CA2318, 38092252839882064, 224772173, 224772180, 7, 1440x900 
0x37CA2318, 38092252840544096, 224772241, 224772249, 8, 1440x900 
0x37CA2318, 38092252841204648, 224772307, 224772314, 7, 1440x900 
0x37CA2318, 38092252841864664, 224772372, 224772380, 8, 1440x900 
0x37CA2318, 38092252842654856, 224772451, 224772483, 32, 1440x900 
0x37CA2318, 38092252843309768, 224772516, 224772540, 24, 1440x900 
0x37CA2318, 38092252843980992, 224772584, 224772617, 33, 1440x900 
0x37CA2318, 38092252844650440, 224772659, 224772670, 11, 1440x900 
0x37CA2318, 38092252845261944, 224772713, 224772729, 16, 1440x900 
0x37CA2318, 38092252845935096, 224772777, 224772789, 12, 1440x900 
0x37CA2318, 38092252846567688, 224772843, 224772857, 14, 1440x900 
0x37CA2318, 38092252847234944, 224772908, 224772918, 10, 1440x900 
0x37CA2318, 38092252847857952, 224772973, 224772983, 10, 1440x900 
0x37CA2318, 38092252848501640, 224773038, 224773047, 9, 1440x900 
0x37CA2318, 38092252849163504, 224773102, 224773110, 8, 1440x900 
0x37CA2318, 38092252849997528, 224773187, 224773195, 8, 1440x900 
0x37CA2318, 38092252850540440, 224773238, 224773246, 8, 1440x900 
0x37CA2318, 38092252851787888, 224773367, 224773375, 8, 1440x900 
0x37CA2318, 38092252852459888, 224773432, 224773441, 9, 1440x900 
0x37CA2318, 38092252853109368, 224773498, 224773507, 9, 1440x900 
0x37CA2318, 38092252853770368, 224773569, 224773577, 8, 1440x900 
0x37CA2318, 38092252854430664, 224773632, 224773641, 9, 1440x900 
0x37CA2318, 38092252855092984, 224773698, 224773707, 9, 1440x900 
0x37CA2318, 38092252855757824, 224773762, 224773772, 10, 1440x900 
0x37CA2318, 38092252856413064, 224773827, 224773835, 8, 1440x900 
0x37CA2318, 38092252857077976, 224773893, 224773901, 8, 1440x900 
0x37CA2318, 38092252857735848, 224773962, 224773970, 8, 1440x900 
0x37CA2318, 38092252858397312, 224774027, 224774035, 8, 1440x900 
0x37CA2318, 38092252859055328, 224774092, 224774100, 8, 1440x900 
0x37CA2318, 38092252859713664, 224774158, 224774165, 7, 1440x900 
0x37CA2318, 38092252860376048, 224774223, 224774231, 8, 1440x900 
0x37CA2318, 38092252861034032, 224774291, 224774299, 8, 1440x900 
0x37CA2318, 38092252861863768, 224774373, 224774381, 8, 1440x900 
0x37CA2318, 38092252862370992, 224774422, 224774431, 9, 1440x900 
0x37CA2318, 38092252863037880, 224774493, 224774502, 9, 1440x900 
0x37CA2318, 38092252863717520, 224774558, 224774566, 8, 1440x900 
0x37CA2318, 38092252864380680, 224774628, 224774635, 7, 1440x900 
0x37CA2318, 38092252865032544, 224774688, 224774696, 8, 1440x900 
0x37CA2318, 38092252865691096, 224774756, 224774763, 7, 1440x900 
0x37CA2318, 38092252866351432, 224774822, 224774829, 7, 1440x900 
0x37CA2318, 38092252867012560, 224774887, 224774894, 7, 1440x900 
0x37CA2318, 38092252867708816, 224774957, 224774964, 7, 1440x900 
0x37CA2318, 38092252868339704, 224775018, 224775027, 9, 1440x900 
0x37CA2318, 38092252868998784, 224775087, 224775095, 8, 1440x900 
0x37CA2318, 38092252869661520, 224775153, 224775160, 7, 1440x900 
0x37CA2318, 38092252870318800, 224775218, 224775226, 8, 1440x900 
0x37CA2318, 38092252870979088, 224775283, 224775292, 9, 1440x900 
0x37CA2318, 38092252871638608, 224775348, 224775357, 9, 1440x900 
0x37CA2318, 38092252872332592, 224775422, 224775429, 7, 1440x900 
0x37CA2318, 38092252872967336, 224775483, 224775491, 8, 1440x900 
0x37CA2318, 38092252873627416, 224775548, 224775557, 9, 1440x900 
0x37CA2318, 38092252874325720, 224775623, 224775633, 10, 1440x900 
0x37CA2318, 38092252875006728, 224775688, 224775696, 8, 1440x900 
0x37CA2318, 38092252875620040, 224775748, 224775757, 9, 1440x900 
0x37CA2318, 38092252876303120, 224775819, 224775832, 13, 1440x900 
0x37CA2318, 38092252876965488, 224775883, 224775892, 9, 1440x900 
0x37CA2318, 38092252877634456, 224775948, 224775963, 15, 1440x900 
0x37CA2318, 38092252878288544, 224776017, 224776029, 12, 1440x900 
0x37CA2318, 38092252878954160, 224776082, 224776091, 9, 1440x900 
0x37CA2318, 38092252879600600, 224776147, 224776155, 8, 1440x900 
0x37CA2318, 38092252880248776, 224776211, 224776219, 8, 1440x900 
0x37CA2318, 38092252880914952, 224776278, 224776286, 8, 1440x900 
0x37CA2318, 38092252881572424, 224776347, 224776355, 8, 1440x900 
0x37CA2318, 38092252882232992, 224776412, 224776420, 8, 1440x900 
0x37CA2318, 38092252882886808, 224776477, 224776484, 7, 1440x900 
0x37CA2318, 38092252883557272, 224776543, 224776550, 7, 1440x900 
0x37CA2318, 38092252884220056, 224776608, 224776616, 8, 1440x900 
0x37CA2318, 38092252884880208, 224776674, 224776681, 7, 1440x900 
0x37CA2318, 38092252885532336, 224776738, 224776746, 8, 1440x900 
0x37CA2318, 38092252886200376, 224776808, 224776816, 8, 1440x900 
0x37CA2318, 38092252886855128, 224776872, 224776880, 8, 1440x900 
0x37CA2318, 38092252887515304, 224776938, 224776946, 8, 1440x900 
0x37CA2318, 38092252888181008, 224777006, 224777015, 9, 1440x900 
0x37CA2318, 38092252888837464, 224777068, 224777078, 10, 1440x900 
0x37CA2318, 38092252889500696, 224777137, 224777145, 8, 1440x900 
0x37CA2318, 38092252890153840, 224777203, 224777210, 7, 1440x900 
0x37CA2318, 38092252890814528, 224777267, 224777276, 9, 1440x900 
0x37CA2318, 38092252891471992, 224777333, 224777341, 8, 1440x900 
0x37CA2318, 38092252892140432, 224777398, 224777408, 10, 1440x900 
0x37CA2318, 38092252892791512, 224777467, 224777474, 7, 1440x900 
0x37CA2318, 38092252893459968, 224777533, 224777541, 8, 1440x900 
0x37CA2318, 38092252894118192, 224777597, 224777605, 8, 1440x900 
0x37CA2318, 38092252894777576, 224777662, 224777670, 8, 1440x900 
0x37CA2318, 38092252895443696, 224777733, 224777742, 9, 1440x900 
0x37CA2318, 38092252896100736, 224777797, 224777805, 8, 1440x900 
0x37CA2318, 38092252896763744, 224777863, 224777870, 7, 1440x900 
0x37CA2318, 38092252897425080, 224777928, 224777936, 8, 1440x900 
0x37CA2318, 38092252898093944, 224777996, 224778004, 8, 1440x900 
0x37CA2318, 38092252898754584, 224778062, 224778069, 7, 1440x900 
0x37CA2318, 38092252899423840, 224778132, 224778140, 8, 1440x900 
0x37CA2318, 38092252900078720, 224778196, 224778203, 7, 1440x900 
0x37CA2318, 38092252900742256, 224778263, 224778271, 8, 1440x900 
0x37CA2318, 38092252901402056, 224778327, 224778336, 9, 1440x900 
0x37CA2318, 38092252902061608, 224778392, 224778400, 8, 1440x900 
0x37CA2318, 38092252902719232, 224778461, 224778468, 7, 1440x900 
0x37CA2318, 38092252903388376, 224778526, 224778534, 8, 1440x900 
0x37CA2318, 38092252904050288, 224778592, 224778600, 8, 1440x900 
0x37CA2318, 38092252904706680, 224778657, 224778665, 8, 1440x900 
0x37CA2318, 38092252905368064, 224778724, 224778731, 7, 1440x900 
0x37CA2318, 38092252906024448, 224778787, 224778795, 8, 1440x900 
0x37CA2318, 38092252906680752, 224778852, 224778860, 8, 1440x900 
0x37CA2318, 38092252907345008, 224778918, 224778927, 9, 1440x900 
0x37CA2318, 38092252908028632, 224778988, 224778995, 7, 1440x900 
0x37CA2318, 38092252908857680, 224779073, 224779080, 7, 1440x900 
0x37CA2318, 38092252909440320, 224779128, 224779136, 8, 1440x900 
0x37CA2318, 38092252910149536, 224779202, 224779212, 10, 1440x900 
0x37CA2318, 38092252910788256, 224779265, 224779275, 10, 1440x900 
0x37CA2318, 38092252911469584, 224779330, 224779340, 10, 1440x900 
0x37CA2318, 38092252912275816, 224779417, 224779424, 7, 1440x900 
0x37CA2318, 38092252912782336, 224779462, 224779470, 8, 1440x900 
0x37CA2318, 38092252913444264, 224779532, 224779539, 7, 1440x900 
0x37CA2318, 38092252914107920, 224779597, 224779604, 7, 1440x900 
0x37CA2318, 38092252914772608, 224779663, 224779672, 9, 1440x900 
0x37CA2318, 38092252915424424, 224779733, 224779741, 8, 1440x900 
0x37CA2318, 38092252916087520, 224779798, 224779805, 7, 1440x900 
0x37CA2318, 38092252916754104, 224779868, 224779876, 8, 1440x900 
0x37CA2318, 38092252917439152, 224779932, 224779940, 8, 1440x900 
0x37CA2318, 38092252918099368, 224779997, 224780004, 7, 1440x900 
0x37CA2318, 38092252918741504, 224780062, 224780069, 7, 1440x900 
0x37CA2318, 38092252919401008, 224780126, 224780133, 7, 1440x900 
0x37CA2318, 38092252920052528, 224780192, 224780199, 7, 1440x900 
0x37CA2318, 38092252920921144, 224780283, 224780291, 8, 1440x900 
0x37CA2318, 38092252921582240, 224780344, 224780351, 7, 1440x900 
0x37CA2318, 38092252922055264, 224780390, 224780400, 10, 1440x900 
0x37CA2318, 38092252922741824, 224780458, 224780469, 11, 1440x900 
0x37CA2318, 38092252923571360, 224780542, 224780553, 11, 1440x900 
0x37CA2318, 38092252924221456, 224780608, 224780615, 7, 1440x900 
0x37CA2318, 38092252924684176, 224780652, 224780660, 8, 1440x900 
0x37CA2318, 38092252925360272, 224780723, 224780729, 6, 1440x900 
0x37CA2318, 38092252926047184, 224780792, 224780799, 7, 1440x900 
0x37CA2318, 38092252926673416, 224780853, 224780861, 8, 1440x900 
0x37CA2318, 38092252927331120, 224780918, 224780926, 8, 1440x900 
0x37CA2318, 38092252928188768, 224781006, 224781013, 7, 1440x900 
0x37CA2318, 38092252928805040, 224781067, 224781075, 8, 1440x900 
0x37CA2318, 38092252929341024, 224781122, 224781132, 10, 1440x900 
0x37CA2318, 38092252929980392, 224781182, 224781190, 8, 1440x900 
0x37CA2318, 38092252930631248, 224781248, 224781275, 27, 1440x900 
0x37CA2318, 38092252931355872, 224781344, 224781355, 11, 1440x900 
0x37CA2318, 38092252932054872, 224781397, 224781404, 7, 1440x900 
0x37CA2318, 38092252932617232, 224781460, 224781467, 7, 1440x900 
0x37CA2318, 38092252933290080, 224781519, 224781531, 12, 1440x900 
0x37CA2318, 38092252934049104, 224781594, 224781603, 9, 1440x900 
0x37CA2318, 38092252934610752, 224781647, 224781654, 7, 1440x900 
0x37CA2318, 38092252935300552, 224781716, 224781723, 7, 1440x900 
0x37CA2318, 38092252935922992, 224781777, 224781785, 8, 1440x900 
0x37CA2318, 38092252936785576, 224781867, 224781875, 8, 1440x900 
0x37CA2318, 38092252937446248, 224781932, 224781940, 8, 1440x900 
0x37CA2318, 38092252938097960, 224781996, 224782004, 8, 1440x900 
0x37CA2318, 38092252938761128, 224782068, 224782076, 8, 1440x900 
0x37CA2318, 38092252939427760, 224782133, 224782141, 8, 1440x900 
0x37CA2318, 38092252940096992, 224782197, 224782204, 7, 1440x900 
0x37CA2318, 38092252940756408, 224782262, 224782269, 7, 1440x900 
0x37CA2318, 38092252941415304, 224782327, 224782334, 7, 1440x900 
0x37CA2318, 38092252942069904, 224782393, 224782400, 7, 1440x900 
0x37CA2318, 38092252942730536, 224782462, 224782469, 7, 1440x900 
0x37CA2318, 38092252943391496, 224782527, 224782534, 7, 1440x900 
0x37CA2318, 38092252944515680, 224782637, 224782645, 8, 1440x900 
0x37CA2318, 38092252945175776, 224782703, 224782713, 10, 1440x900 
0x37CA2318, 38092252945835624, 224782773, 224782781, 8, 1440x900 
0x37CA2318, 38092252946499872, 224782838, 224782847, 9, 1440x900 
0x37CA2318, 38092252947157688, 224782902, 224782909, 7, 1440x900 
0x37CA2318, 38092252947890224, 224782977, 224782985, 8, 1440x900 
0x37CA2318, 38092252948520576, 224783048, 224783061, 13, 1440x900 
0x37CA2318, 38092252949242552, 224783112, 224783121, 9, 1440x900 
0x37CA2318, 38092252949897888, 224783178, 224783185, 7, 1440x900 
0x37CA2318, 38092252950559360, 224783244, 224783253, 9, 1440x900 
0x37CA2318, 38092252951163768, 224783309, 224783320, 11, 1440x900 
0x37CA2318, 38092252951819600, 224783367, 224783376, 9, 1440x900 
0x37CA2318, 38092252952483824, 224783438, 224783453, 15, 1440x900 
0x37CA2318, 38092252953214736, 224783507, 224783517, 10, 1440x900 
0x37CA2318, 38092252953874432, 224783572, 224783583, 11, 1440x900 
0x37CA2318, 38092252954468256, 224783634, 224783649, 15, 1440x900 
0x37CA2318, 38092252955131736, 224783698, 224783715, 17, 1440x900 
0x37CA2318, 38092252955792928, 224783764, 224783780, 16, 1440x900 
0x37CA2318, 38092252956455264, 224783831, 224783846, 15, 1440x900 
0x37CA2318, 38092252957115296, 224783895, 224783913, 18, 1440x900 
0x37CA2318, 38092252957789464, 224783963, 224783970, 7, 1440x900 
0x37CA2318, 38092252958413120, 224784027, 224784034, 7, 1440x900 
0x37CA2318, 38092252959070680, 224784092, 224784100, 8, 1440x900 
0x37CA2318, 38092252959742152, 224784161, 224784169, 8, 1440x900 
0x37CA2318, 38092252960406848, 224784227, 224784235, 8, 1440x900 
0x37CA2318, 38092252961069928, 224784292, 224784300, 8, 1440x900 
0x37CA2318, 38092252961730000, 224784358, 224784366, 8, 1440x900 
0x37CA2318, 38092252962393328, 224784423, 224784431, 8, 1440x900 
0x37CA2318, 38092252963054392, 224784493, 224784501, 8, 1440x900 
0x37CA2318, 38092252963715216, 224784557, 224784566, 9, 1440x900 
0x37CA2318, 38092252964372192, 224784623, 224784630, 7, 1440x900 
0x37CA2318, 38092252965032640, 224784687, 224784695, 8, 1440x900 
0x37CA2318, 38092252965692584, 224784753, 224784761, 8, 1440x900 
0x37CA2318, 38092252966355384, 224784822, 224784829, 7, 1440x900 
0x37CA2318, 38092252967012584, 224784887, 224784894, 7, 1440x900 
0x37CA2318, 38092252967672736, 224784952, 224784960, 8, 1440x900 
0x37CA2318, 38092252968332600, 224785018, 224785026, 8, 1440x900 
0x37CA2318, 38092252968992840, 224785086, 224785094, 8, 1440x900 
0x37CA2318, 38092252969653216, 224785152, 224785159, 7, 1440x900 
0x37CA2318, 38092252970313632, 224785217, 224785225, 8, 1440x900 
0x37CA2318, 38092252970973184, 224785282, 224785290, 8, 1440x900 
0x37CA2318, 38092252971634800, 224785348, 224785356, 8, 1440x900 
0x37CA2318, 38092252972295624, 224785416, 224785423, 7, 1440x900 
0x37CA2318, 38092252972953936, 224785482, 224785490, 8, 1440x900 
0x37CA2318, 38092252973617504, 224785548, 224785556, 8, 1440x900 
0x37CA2318, 38092252974278880, 224785613, 224785622, 9, 1440x900 
0x37CA2318, 38092252974937312, 224785678, 224785687, 9, 1440x900 
0x37CA2318, 38092252975597264, 224785748, 224785756, 8, 1440x900 
0x37CA2318, 38092252976261456, 224785812, 224785820, 8, 1440x900 
0x37CA2318, 38092252976921640, 224785878, 224785886, 8, 1440x900 
0x37CA2318, 38092252977579200, 224785943, 224785951, 8, 1440x900 
0x37CA2318, 38092252978239984, 224786007, 224786015, 8, 1440x900 
0x37CA2318, 38092252978899336, 224786077, 224786086, 9, 1440x900 
0x37CA2318, 38092252979560448, 224786142, 224786151, 9, 1440x900 
0x37CA2318, 38092252980223896, 224786207, 224786216, 9, 1440x900 
0x37CA2318, 38092252980883296, 224786273, 224786281, 8, 1440x900 
0x37CA2318, 38092252981542976, 224786339, 224786348, 9, 1440x900 
0x37CA2318, 38092252982203880, 224786407, 224786414, 7, 1440x900 
0x37CA2318, 38092252982862536, 224786472, 224786479, 7, 1440x900 
0x37CA2318, 38092252983521616, 224786537, 224786545, 8, 1440x900 
0x37CA2318, 38092252984186664, 224786606, 224786613, 7, 1440x900 
0x37CA2318, 38092252984843872, 224786672, 224786679, 7, 1440x900 
0x37CA2318, 38092252985502920, 224786738, 224786745, 7, 1440x900 
0x37CA2318, 38092252986163440, 224786802, 224786810, 8, 1440x900 
0x37CA2318, 38092252986827608, 224786867, 224786875, 8, 1440x900 
0x37CA2318, 38092252987485848, 224786933, 224786941, 8, 1440x900 
0x37CA2318, 38092252988144480, 224787003, 224787010, 7, 1440x900 
0x37CA2318, 38092252988809512, 224787068, 224787077, 9, 1440x900 
0x37CA2318, 38092252989480768, 224787138, 224787145, 7, 1440x900 
0x37CA2318, 38092252990137928, 224787203, 224787211, 8, 1440x900 
0x37CA2318, 38092252990802432, 224787268, 224787277, 9, 1440x900 
0x37CA2318, 38092252991461496, 224787338, 224787346, 8, 1440x900 
0x37CA2318, 38092252992312872, 224787417, 224787425, 8, 1440x900 
0x37CA2318, 38092252992856000, 224787471, 224787480, 9, 1440x900 
0x37CA2318, 38092252993449136, 224787533, 224787541, 8, 1440x900 
0x37CA2318, 38092252994287504, 224787613, 224787621, 8, 1440x900 
0x37CA2318, 38092252994754720, 224787662, 224787670, 8, 1440x900 
0x37CA2318, 38092252995414576, 224787728, 224787735, 7, 1440x900 
0x37CA2318, 38092252996074704, 224787798, 224787806, 8, 1440x900 
0x37CA2318, 38092252996745872, 224787864, 224787873, 9, 1440x900 
0x37CA2318, 38092252997597880, 224787947, 224787955, 8, 1440x900 
0x37CA2318, 38092252998259880, 224788018, 224788026, 8, 1440x900 
0x37CA2318, 38092252998929672, 224788083, 224788091, 8, 1440x900 
0x37CA2318, 38092252999388080, 224788128, 224788136, 8, 1440x900 
0x37CA2318, 38092253000045832, 224788193, 224788200, 7, 1440x900 
0x37CA2318, 38092253000710920, 224788257, 224788264, 7, 1440x900 
0x37CA2318, 38092253001365968, 224788322, 224788330, 8, 1440x900 
0x37CA2318, 38092253002026032, 224788388, 224788397, 9, 1440x900 
0x37CA2318, 38092253002686256, 224788458, 224788465, 7, 1440x900 
0x37CA2318, 38092253003348272, 224788523, 224788531, 8, 1440x900 
0x37CA2318, 38092253004007992, 224788588, 224788597, 9, 1440x900 
0x37CA2318, 38092253004669264, 224788658, 224788666, 8, 1440x900 
0x37CA2318, 38092253005530056, 224788743, 224788751, 8, 1440x900 
0x37CA2318, 38092253006181584, 224788807, 224788815, 8, 1440x900 
0x37CA2318, 38092253006850920, 224788872, 224788881, 9, 1440x900 
0x37CA2318, 38092253007503456, 224788942, 224788950, 8, 1440x900 
0x37CA2318, 38092253008165080, 224789009, 224789017, 8, 1440x900 
0x37CA2318, 38092253008696112, 224789058, 224789067, 9, 1440x900 
0x37CA2318, 38092253009290488, 224789118, 224789127, 9, 1440x900 
0x37CA2318, 38092253009949864, 224789187, 224789195, 8, 1440x900 
0x37CA2318, 38092253010612576, 224789246, 224789255, 9, 1440x900 
0x37CA2318, 38092253011301456, 224789319, 224789325, 6, 1440x900 
0x37CA2318, 38092253011940968, 224789378, 224789386, 8, 1440x900 
0x37CA2318, 38092253012594240, 224789443, 224789451, 8, 1440x900 
0x37CA2318, 38092253013254680, 224789512, 224789519, 7, 1440x900 
0x37CA2318, 38092253013914344, 224789577, 224789584, 7, 1440x900 
0x37CA2318, 38092253014576856, 224789643, 224789651, 8, 1440x900 
0x37CA2318, 38092253015894848, 224789776, 224789784, 8, 1440x900 
0x37CA2318, 38092253016555136, 224789842, 224789850, 8, 1440x900 
0x37CA2318, 38092253017215208, 224789907, 224789914, 7, 1440x900 
0x37CA2318, 38092253017875144, 224789973, 224789981, 8, 1440x900 
0x37CA2318, 38092253018535088, 224790041, 224790049, 8, 1440x900 
0x37CA2318, 38092253019195384, 224790107, 224790115, 8, 1440x900 
0x37CA2318, 38092253019862704, 224790172, 224790180, 8, 1440x900 
0x37CA2318, 38092253020522456, 224790238, 224790246, 8, 1440x900 
0x37CA2318, 38092253021183848, 224790303, 224790312, 9, 1440x900 
0x37CA2318, 38092253021843808, 224790368, 224790376, 8, 1440x900 
0x37CA2318, 38092253022505392, 224790438, 224790445, 7, 1440x900 
0x37CA2318, 38092253023165536, 224790503, 224790510, 7, 1440x900 
0x37CA2318, 38092253023825456, 224790568, 224790576, 8, 1440x900 
0x37CA2318, 38092253024489176, 224790639, 224790648, 9, 1440x900 
0x37CA2318, 38092253025155248, 224790708, 224790716, 8, 1440x900 
0x37CA2318, 38092253025816816, 224790767, 224790776, 9, 1440x900 
0x37CA2318, 38092253026471944, 224790832, 224790841, 9, 1440x900 
0x37CA2318, 38092253027131128, 224790898, 224790907, 9, 1440x900 
0x37CA2318, 38092253027790880, 224790963, 224790971, 8, 1440x900 
0x37CA2318, 38092253028451640, 224791032, 224791039, 7, 1440x900 
0x37CA2318, 38092253029112408, 224791097, 224791105, 8, 1440x900 
0x37CA2318, 38092253029768584, 224791162, 224791170, 8, 1440x900 
0x37CA2318, 38092253030428984, 224791229, 224791237, 8, 1440x900 
0x37CA2318, 38092253031089552, 224791293, 224791301, 8, 1440x900 
0x37CA2318, 38092253031756344, 224791364, 224791373, 9, 1440x900 
0x37CA2318, 38092253032447416, 224791432, 224791450, 18, 1440x900 
0x37CA2318, 38092253033101184, 224791497, 224791505, 8, 1440x900 
0x37CA2318, 38092253033730848, 224791558, 224791565, 7, 1440x900 
0x37CA2318, 38092253034391176, 224791627, 224791635, 8, 1440x900 
0x37CA2318, 38092253035051456, 224791692, 224791699, 7, 1440x900 
0x37CA2318, 38092253035711672, 224791757, 224791764, 7, 1440x900 
0x37CA2318, 38092253036372560, 224791826, 224791833, 7, 1440x900 
0x37CA2318, 38092253037035280, 224791888, 224791896, 8, 1440x900 
0x37CA2318, 38092253037695800, 224791957, 224791964, 7, 1440x900 
0x37CA2318, 38092253038356144, 224792022, 224792029, 7, 1440x900 
0x37CA2318, 38092253039017056, 224792087, 224792095, 8, 1440x900 
0x37CA2318, 38092253039676128, 224792152, 224792160, 8, 1440x900 
0x37CA2318, 38092253040336144, 224792218, 224792226, 8, 1440x900 
0x37CA2318, 38092253041188664, 224792308, 224792315, 7, 1440x900 
0x37CA2318, 38092253041773880, 224792368, 224792375, 7, 1440x900 
0x37CA2318, 38092253042359368, 224792423, 224792430, 7, 1440x900 
0x37CA2318, 38092253042986432, 224792487, 224792495, 8, 1440x900 
0x37CA2318, 38092253043646920, 224792553, 224792560, 7, 1440x900 
0x37CA2318, 38092253044305008, 224792617, 224792625, 8, 1440x900 
0x37CA2318, 38092253044991232, 224792688, 224792696, 8, 1440x900 
0x37CA2318, 38092253045626952, 224792747, 224792756, 9, 1440x900 
0x37CA2318, 38092253046294536, 224792817, 224792825, 8, 1440x900 
0x37CA2318, 38092253046952080, 224792882, 224792889, 7, 1440x900 
0x37CA2318, 38092253047616888, 224792947, 224792955, 8, 1440x900 
0x37CA2318, 38092253048273712, 224793013, 224793021, 8, 1440x900 
0x37CA2318, 38092253048935040, 224793078, 224793086, 8, 1440x900 
0x37CA2318, 38092253049594128, 224793144, 224793152, 8, 1440x900 
0x37CA2318, 38092253050272648, 224793213, 224793222, 9, 1440x900 
0x37CA2318, 38092253050919992, 224793278, 224793285, 7, 1440x900 
0x37CA2318, 38092253051578712, 224793343, 224793350, 7, 1440x900 
0x37CA2318, 38092253052276624, 224793412, 224793420, 8, 1440x900 
0x37CA2318, 38092253052925608, 224793478, 224793486, 8, 1440x900 
0x37CA2318, 38092253053578720, 224793542, 224793550, 8, 1440x900 
0x37CA2318, 38092253054230384, 224793608, 224793617, 9, 1440x900 
0x37CA2318, 38092253054894024, 224793678, 224793686, 8, 1440x900 
0x37CA2318, 38092253055555560, 224793741, 224793748, 7, 1440x900 
0x37CA2318, 38092253056224104, 224793812, 224793819, 7, 1440x900 
0x37CA2318, 38092253056881768, 224793878, 224793886, 8, 1440x900 
0x37CA2318, 38092253057600664, 224793944, 224793953, 9, 1440x900 
0x37CA2318, 38092253058195544, 224794007, 224794014, 7, 1440x900 
0x37CA2318, 38092253058863056, 224794072, 224794081, 9, 1440x900 
0x37CA2318, 38092253059523488, 224794137, 224794146, 9, 1440x900 
0x37CA2318, 38092253060183872, 224794203, 224794211, 8, 1440x900 
0x37CA2318, 38092253060844040, 224794272, 224794280, 8, 1440x900 
0x37CA2318, 38092253061507040, 224794338, 224794346, 8, 1440x900 
0x37CA2318, 38092253062201448, 224794406, 224794414, 8, 1440x900 
0x37CA2318, 38092253062866008, 224794473, 224794481, 8, 1440x900 
0x37CA2318, 38092253063486352, 224794533, 224794542, 9, 1440x900 
0x37CA2318, 38092253064143824, 224794602, 224794610, 8, 1440x900 
0x37CA2318, 38092253064803872, 224794667, 224794674, 7, 1440x900 
0x37CA2318, 38092253065474256, 224794733, 224794740, 7, 1440x900 
0x37CA2318, 38092253066142288, 224794802, 224794810, 8, 1440x900 
0x37CA2318, 38092253066792880, 224794866, 224794874, 8, 1440x900 
0x37CA2318, 38092253067461360, 224794932, 224794940, 8, 1440x900 
0x37CA2318, 38092253068120832, 224794997, 224795005, 8, 1440x900 
0x37CA2318, 38092253068796648, 224795066, 224795074, 8, 1440x900 
0x37CA2318, 38092253069442424, 224795127, 224795136, 9, 1440x900 
0x37CA2318, 38092253070100592, 224795197, 224795204, 7, 1440x900 
0x37CA2318, 38092253070757248, 224795262, 224795270, 8, 1440x900 
0x37CA2318, 38092253071431440, 224795333, 224795341, 8, 1440x900 
0x37CA2318, 38092253072084160, 224795392, 224795400, 8, 1440x900 
0x37CA2318, 38092253072777744, 224795462, 224795470, 8, 1440x900 
0x37CA2318, 38092253073402728, 224795527, 224795534, 7, 1440x900 
0x37CA2318, 38092253074062528, 224795592, 224795600, 8, 1440x900 
0x37CA2318, 38092253074725680, 224795661, 224795669, 8, 1440x900 
0x37CA2318, 38092253075416896, 224795728, 224795736, 8, 1440x900 
0x37CA2318, 38092253076125504, 224795797, 224795806, 9, 1440x900 
0x37CA2318, 38092253076736216, 224795858, 224795868, 10, 1440x900 
0x37CA2318, 38092253077436864, 224795933, 224795940, 7, 1440x900 
0x37CA2318, 38092253078052736, 224795992, 224796001, 9, 1440x900 
0x37CA2318, 38092253078718400, 224796058, 224796077, 19, 1440x900 
0x37CA2318, 38092253079383240, 224796127, 224796148, 21, 1440x900 
0x37CA2318, 38092253080097496, 224796195, 224796214, 19, 1440x900 
0x37CA2318, 38092253080771288, 224796264, 224796283, 19, 1440x900 
0x37CA2318, 38092253081438944, 224796330, 224796348, 18, 1440x900 
0x37CA2318, 38092253082127040, 224796397, 224796406, 9, 1440x900 
0x37CA2318, 38092253082742800, 224796458, 224796466, 8, 1440x900 
0x37CA2318, 38092253083449304, 224796533, 224796541, 8, 1440x900 
0x37CA2318, 38092253083987256, 224796587, 224796594, 7, 1440x900 
0x37CA2318, 38092253084752128, 224796662, 224796669, 7, 1440x900 
0x37CA2318, 38092253085443192, 224796733, 224796740, 7, 1440x900 
0x37CA2318, 38092253086015800, 224796794, 224796803, 9, 1440x900 
0x37CA2318, 38092253086670952, 224796858, 224796869, 11, 1440x900 
0x37CA2318, 38092253087316272, 224796926, 224796936, 10, 1440x900 
0x37CA2318, 38092253088100376, 224796993, 224797003, 10, 1440x900 
0x37CA2318, 38092253088641840, 224797053, 224797071, 18, 1440x900 
0x37CA2318, 38092253089338472, 224797124, 224797134, 10, 1440x900 
0x37CA2318, 38092253089970752, 224797183, 224797190, 7, 1440x900 
0x37CA2318, 38092253090602280, 224797247, 224797254, 7, 1440x900 
0x37CA2318, 38092253091462560, 224797333, 224797341, 8, 1440x900 
0x37CA2318, 38092253092122400, 224797397, 224797405, 8, 1440x900 
0x37CA2318, 38092253092785792, 224797468, 224797476, 8, 1440x900 
0x37CA2318, 38092253093244336, 224797513, 224797520, 7, 1440x900 
0x37CA2318, 38092253094107168, 224797603, 224797611, 8, 1440x900 
0x37CA2318, 38092253094760576, 224797667, 224797675, 8, 1440x900 
0x37CA2318, 38092253095418240, 224797732, 224797740, 8, 1440x900 
0x37CA2318, 38092253096081232, 224797797, 224797804, 7, 1440x900 
0x37CA2318, 38092253096746160, 224797863, 224797872, 9, 1440x900 
0x37CA2318, 38092253097406928, 224797929, 224797938, 9, 1440x900 
0x37CA2318, 38092253098067184, 224797993, 224798000, 7, 1440x900 
0x37CA2318, 38092253098826032, 224798071, 224798089, 18, 1440x900 
0x37CA2318, 38092253099882680, 224798177, 224798200, 23, 1440x900 
0x37CA2318, 38092253100648072, 224798259, 224798271, 12, 1440x900 
0x37CA2318, 38092253101228048, 224798307, 224798318, 11, 1440x900 
0x37CA2318, 38092253101870688, 224798373, 224798383, 10, 1440x900 
0x37CA2318, 38092253102530584, 224798442, 224798452, 10, 1440x900 
0x37CA2318, 38092253103210800, 224798511, 224798523, 12, 1440x900 
0x37CA2318, 38092253103960984, 224798582, 224798590, 8, 1440x900 
0x37CA2318, 38092253104618704, 224798648, 224798662, 14, 1440x900 
0x37CA2318, 38092253105180048, 224798707, 224798715, 8, 1440x900 
0x37CA2318, 38092253106015376, 224798788, 224798797, 9, 1440x900 
0x37CA2318, 38092253106674640, 224798853, 224798862, 9, 1440x900 
0x37CA2318, 38092253107334976, 224798919, 224798927, 8, 1440x900 
0x37CA2318, 38092253108003832, 224798988, 224798997, 9, 1440x900 
0x37CA2318, 38092253108664192, 224799053, 224799062, 9, 1440x900 
0x37CA2318, 38092253109324040, 224799118, 224799127, 9, 1440x900 
0x37CA2318, 38092253109778968, 224799163, 224799171, 8, 1440x900 
0x37CA2318, 38092253110633008, 224799247, 224799255, 8, 1440x900 
0x37CA2318, 38092253111097440, 224799293, 224799300, 7, 1440x900 
0x37CA2318, 38092253111955824, 224799382, 224799389, 7, 1440x900 
0x37CA2318, 38092253112624096, 224799452, 224799460, 8, 1440x900 
0x37CA2318, 38092253113274448, 224799514, 224799523, 9, 1440x900 
0x37CA2318, 38092253113739144, 224799558, 224799565, 7, 1440x900 
0x37CA2318, 38092253114398496, 224799627, 224799634, 7, 1440x900 
0x37CA2318, 38092253115178032, 224799703, 224799712, 9, 1440x900 
0x37CA2318, 38092253115909104, 224799777, 224799785, 8, 1440x900 
0x37CA2318, 38092253116381944, 224799827, 224799834, 7, 1440x900 
0x37CA2318, 38092253117038688, 224799891, 224799898, 7, 1440x900 
0x37CA2318, 38092253117698696, 224799957, 224799964, 7, 1440x900 
0x37CA2318, 38092253118369240, 224800023, 224800029, 6, 1440x900 
0x37CA2318, 38092253119029016, 224800088, 224800095, 7, 1440x900 
0x37CA2318, 38092253119689056, 224800153, 224800161, 8, 1440x900 
0x37CA2318, 38092253120465688, 224800232, 224800240, 8, 1440x900 
0x37CA2318, 38092253121019472, 224800287, 224800296, 9, 1440x900 
0x37CA2318, 38092253121673176, 224800357, 224800365, 8, 1440x900 
0x37CA2318, 38092253122333312, 224800422, 224800431, 9, 1440x900 
0x37CA2318, 38092253123003784, 224800493, 224800501, 8, 1440x900 
0x37CA2318, 38092253123664344, 224800557, 224800565, 8, 1440x900 
0x37CA2318, 38092253124325536, 224800623, 224800631, 8, 1440x900 
0x37CA2318, 38092253124985376, 224800688, 224800696, 8, 1440x900 
0x37CA2318, 38092253125652264, 224800752, 224800761, 9, 1440x900 
0x37CA2318, 38092253126314640, 224800819, 224800827, 8, 1440x900 
0x37CA2318, 38092253126974760, 224800887, 224800896, 9, 1440x900 
0x37CA2318, 38092253127633656, 224800953, 224800961, 8, 1440x900 
0x37CA2318, 38092253128304304, 224801022, 224801030, 8, 1440x900 
0x37CA2318, 38092253128955920, 224801082, 224801090, 8, 1440x900 
0x37CA2318, 38092253129621992, 224801153, 224801161, 8, 1440x900 
0x37CA2318, 38092253130281528, 224801217, 224801225, 8, 1440x900 
0x37CA2318, 38092253130943064, 224801283, 224801291, 8, 1440x900 
0x37CA2318, 38092253131605248, 224801348, 224801357, 9, 1440x900 
0x37CA2318, 38092253132263264, 224801418, 224801426, 8, 1440x900 
0x37CA2318, 38092253132920784, 224801478, 224801486, 8, 1440x900 
0x37CA2318, 38092253133580056, 224801543, 224801551, 8, 1440x900 
0x37CA2318, 38092253134238360, 224801608, 224801615, 7, 1440x900 
0x37CA2318, 38092253134898552, 224801673, 224801680, 7, 1440x900 
0x37CA2318, 38092253135559288, 224801742, 224801750, 8, 1440x900 
0x37CA2318, 38092253136416344, 224801829, 224801837, 8, 1440x900 
0x37CA2318, 38092253137068312, 224801893, 224801903, 10, 1440x900 
0x37CA2318, 38092253137729856, 224801963, 224801971, 8, 1440x900 
0x37CA2318, 38092253138400032, 224802028, 224802036, 8, 1440x900 
0x37CA2318, 38092253139059864, 224802092, 224802099, 7, 1440x900 
0x37CA2318, 38092253139732160, 224802163, 224802171, 8, 1440x900 
0x37CA2318, 38092253140382832, 224802227, 224802235, 8, 1440x900 
0x37CA2318, 38092253141052496, 224802292, 224802300, 8, 1440x900 
0x37CA2318, 38092253141701528, 224802357, 224802365, 8, 1440x900 
0x37CA2318, 38092253142372728, 224802428, 224802437, 9, 1440x900 
0x37CA2318, 38092253143016608, 224802488, 224802497, 9, 1440x900 
0x37CA2318, 38092253143499488, 224802542, 224802550, 8, 1440x900 
0x37CA2318, 38092253144345968, 224802625, 224802633, 8, 1440x900 
0x37CA2318, 38092253144831432, 224802671, 224802679, 8, 1440x900 
0x37CA2318, 38092253145491848, 224802737, 224802745, 8, 1440x900 
0x37CA2318, 38092253146152920, 224802802, 224802810, 8, 1440x900 
0x37CA2318, 38092253146810976, 224802871, 224802879, 8, 1440x900 
0x37CA2318, 38092253147478008, 224802937, 224802946, 9, 1440x900 
0x37CA2318, 38092253148150568, 224803008, 224803016, 8, 1440x900 
0x37CA2318, 38092253148807688, 224803070, 224803079, 9, 1440x900 
0x37CA2318, 38092253149466816, 224803132, 224803140, 8, 1440x900 
0x37CA2318, 38092253150124576, 224803198, 224803206, 8, 1440x900 
0x37CA2318, 38092253150784272, 224803263, 224803271, 8, 1440x900 
0x37CA2318, 38092253151442248, 224803332, 224803339, 7, 1440x900 
0x37CA2318, 38092253152102424, 224803397, 224803404, 7, 1440x900 
0x37CA2318, 38092253152763544, 224803463, 224803471, 8, 1440x900 
0x37CA2318, 38092253153422240, 224803527, 224803535, 8, 1440x900 
0x37CA2318, 38092253154083736, 224803593, 224803601, 8, 1440x900 
0x37CA2318, 38092253154742768, 224803661, 224803668, 7, 1440x900 
0x37CA2318, 38092253155402472, 224803727, 224803734, 7, 1440x900 
0x37CA2318, 38092253156069696, 224803793, 224803800, 7, 1440x900 
0x37CA2318, 38092253156730480, 224803859, 224803866, 7, 1440x900 
0x37CA2318, 38092253157391176, 224803927, 224803935, 8, 1440x900 
0x37CA2318, 38092253158049080, 224803992, 224804000, 8, 1440x900 
0x37CA2318, 38092253158708496, 224804057, 224804065, 8, 1440x900 
0x37CA2318, 38092253159377688, 224804122, 224804130, 8, 1440x900 
0x37CA2318, 38092253160042608, 224804193, 224804201, 8, 1440x900 
0x37CA2318, 38092253160698848, 224804257, 224804264, 7, 1440x900 
0x37CA2318, 38092253161359920, 224804323, 224804330, 7, 1440x900 
0x37CA2318, 38092253162020336, 224804387, 224804404, 17, 1440x900 
0x37CA2318, 38092253162722808, 224804460, 224804467, 7, 1440x900 
0x37CA2318, 38092253164000312, 224804584, 224804593, 9, 1440x900 
0x37CA2318, 38092253164660352, 224804653, 224804663, 10, 1440x900 
0x37CA2318, 38092253165322824, 224804718, 224804728, 10, 1440x900 
0x37CA2318, 38092253165983080, 224804783, 224804793, 10, 1440x900 
0x37CA2318, 38092253166645544, 224804851, 224804859, 8, 1440x900 
0x37CA2318, 38092253167304352, 224804917, 224804926, 9, 1440x900 
0x37CA2318, 38092253167964976, 224804983, 224804991, 8, 1440x900 
0x37CA2318, 38092253168624432, 224805047, 224805056, 9, 1440x900 
0x37CA2318, 38092253169289704, 224805117, 224805125, 8, 1440x900 
0x37CA2318, 38092253169948000, 224805182, 224805190, 8, 1440x900 
0x37CA2318, 38092253170608664, 224805248, 224805256, 8, 1440x900 
0x37CA2318, 38092253171268128, 224805312, 224805320, 8, 1440x900 
0x37CA2318, 38092253171928424, 224805378, 224805386, 8, 1440x900 
0x37CA2318, 38092253172588224, 224805443, 224805451, 8, 1440x900 
0x37CA2318, 38092253173252056, 224805513, 224805522, 9, 1440x900 
0x37CA2318, 38092253173914520, 224805582, 224805590, 8, 1440x900 
0x37CA2318, 38092253174570320, 224805642, 224805650, 8, 1440x900 
0x37CA2318, 38092253175234752, 224805708, 224805716, 8, 1440x900 
0x37CA2318, 38092253175894360, 224805773, 224805781, 8, 1440x900 
0x37CA2318, 38092253176554816, 224805842, 224805849, 7, 1440x900 
0x37CA2318, 38092253177217672, 224805907, 224805914, 7, 1440x900 
0x37CA2318, 38092253177887120, 224805973, 224805981, 8, 1440x900 
0x37CA2318, 38092253178539264, 224806042, 224806050, 8, 1440x900 
0x37CA2318, 38092253179199440, 224806107, 224806114, 7, 1440x900 
0x37CA2318, 38092253179860136, 224806172, 224806182, 10, 1440x900 
0x37CA2318, 38092253180519984, 224806238, 224806247, 9, 1440x900 
0x37CA2318, 38092253181180048, 224806303, 224806312, 9, 1440x900 
0x37CA2318, 38092253181839472, 224806368, 224806377, 9, 1440x900 
0x37CA2318, 38092253182499456, 224806438, 224806445, 7, 1440x900 
0x37CA2318, 38092253183159264, 224806503, 224806511, 8, 1440x900 
0x37CA2318, 38092253183819392, 224806568, 224806576, 8, 1440x900 
0x37CA2318, 38092253184479344, 224806633, 224806642, 9, 1440x900 
0x37CA2318, 38092253185139392, 224806698, 224806707, 9, 1440x900 
0x37CA2318, 38092253185799760, 224806766, 224806773, 7, 1440x900 
0x37CA2318, 38092253186462832, 224806832, 224806840, 8, 1440x900 
0x37CA2318, 38092253187120808, 224806898, 224806905, 7, 1440x900 
0x37CA2318, 38092253187781224, 224806963, 224806971, 8, 1440x900 
0x37CA2318, 38092253188440112, 224807028, 224807036, 8, 1440x900 
0x37CA2318, 38092253189103208, 224807097, 224807105, 8, 1440x900 
0x37CA2318, 38092253189762144, 224807162, 224807169, 7, 1440x900 
0x37CA2318, 38092253190421000, 224807228, 224807236, 8, 1440x900 
0x37CA2318, 38092253191081056, 224807292, 224807300, 8, 1440x900 
0x37CA2318, 38092253191744848, 224807363, 224807371, 8, 1440x900 
0x37CA2318, 38092253192406736, 224807428, 224807436, 8, 1440x900 
0x37CA2318, 38092253193066720, 224807498, 224807506, 8, 1440x900 
0x37CA2318, 38092253193722560, 224807561, 224807569, 8, 1440x900 
0x37CA2318, 38092253194383720, 224807627, 224807635, 8, 1440x900 
0x37CA2318, 38092253195042376, 224807692, 224807699, 7, 1440x900 
0x37CA2318, 38092253195702016, 224807757, 224807765, 8, 1440x900 
0x37CA2318, 38092253196361840, 224807823, 224807830, 7, 1440x900 
0x37CA2318, 38092253197026392, 224807888, 224807898, 10, 1440x900 
0x37CA2318, 38092253197682408, 224807954, 224807961, 7, 1440x900 
0x37CA2318, 38092253198354464, 224808023, 224808031, 8, 1440x900 
0x37CA2318, 38092253199014752, 224808089, 224808097, 8, 1440x900 
0x37CA2318, 38092253199673672, 224808152, 224808161, 9, 1440x900 
0x37CA2318, 38092253200331072, 224808217, 224808225, 8, 1440x900 
0x37CA2318, 38092253200992904, 224808287, 224808296, 9, 1440x900 
0x37CA2318, 38092253201653536, 224808352, 224808361, 9, 1440x900 
0x37CA2318, 38092253202346296, 224808422, 224808429, 7, 1440x900 
0x37CA2318, 38092253202973896, 224808483, 224808490, 7, 1440x900 
0x37CA2318, 38092253203638136, 224808553, 224808562, 9, 1440x900 
0x37CA2318, 38092253204295704, 224808616, 224808624, 8, 1440x900 
0x37CA2318, 38092253204962928, 224808683, 224808691, 8, 1440x900 
0x37CA2318, 38092253205620944, 224808748, 224808755, 7, 1440x900 
0x37CA2318, 38092253206280944, 224808812, 224808820, 8, 1440x900 
0x37CA2318, 38092253206940704, 224808882, 224808889, 7, 1440x900 
0x37CA2318, 38092253207600736, 224808947, 224808955, 8, 1440x900 
0x37CA2318, 38092253208262392, 224809013, 224809020, 7, 1440x900 
0x37CA2318, 38092253208934768, 224809084, 224809092, 8, 1440x900 
0x37CA2318, 38092253209585840, 224809147, 224809155, 8, 1440x900 
0x37CA2318, 38092253210245656, 224809212, 224809219, 7, 1440x900 
0x37CA2318, 38092253210906488, 224809277, 224809287, 10, 1440x900 
0x37CA2318, 38092253211563512, 224809342, 224809352, 10, 1440x900 
0x37CA2318, 38092253212223888, 224809409, 224809418, 9, 1440x900 
0x37CA2318, 38092253212883760, 224809473, 224809484, 11, 1440x900 
0x37CA2318, 38092253213543824, 224809542, 224809549, 7, 1440x900 
0x37CA2318, 38092253214203864, 224809608, 224809616, 8, 1440x900 
0x37CA2318, 38092253214871688, 224809673, 224809681, 8, 1440x900 
0x37CA2318, 38092253215527448, 224809738, 224809746, 8, 1440x900 
0x37CA2318, 38092253216193168, 224809807, 224809815, 8, 1440x900 
0x37CA2318, 38092253216850864, 224809873, 224809881, 8, 1440x900 
0x37CA2318, 38092253217505432, 224809937, 224809945, 8, 1440x900 
0x37CA2318, 38092253218165856, 224810002, 224810012, 10, 1440x900 
0x37CA2318, 38092253218979992, 224810084, 224810093, 9, 1440x900 
0x37CA2318, 38092253219613768, 224810145, 224810153, 8, 1440x900 
0x37CA2318, 38092253220480640, 224810232, 224810240, 8, 1440x900 
0x37CA2318, 38092253221140272, 224810308, 224810318, 10, 1440x900 
0x37CA2318, 38092253221810008, 224810379, 224810393, 14, 1440x900 
0x37CA2318, 38092253222284280, 224810432, 224810440, 8, 1440x900 
0x37CA2318, 38092253223007664, 224810487, 224810496, 9, 1440x900 
0x37CA2318, 38092253223617768, 224810547, 224810555, 8, 1440x900 
0x37CA2318, 38092253224278288, 224810612, 224810620, 8, 1440x900 
0x37CA2318, 38092253224937504, 224810677, 224810685, 8, 1440x900 
0x37CA2318, 38092253225598416, 224810747, 224810754, 7, 1440x900 
0x37CA2318, 38092253226266952, 224810813, 224810820, 7, 1440x900 
0x37CA2318, 38092253226921248, 224810877, 224810889, 12, 1440x900 
0x37CA2318, 38092253227582072, 224810943, 224810955, 12, 1440x900 
0x37CA2318, 38092253228241216, 224811008, 224811017, 9, 1440x900 
0x37CA2318, 38092253228911008, 224811075, 224811086, 11, 1440x900 
0x37CA2318, 38092253229571448, 224811142, 224811151, 9, 1440x900 
0x37CA2318, 38092253230230656, 224811208, 224811220, 12, 1440x900 
0x37CA2318, 38092253230891880, 224811273, 224811282, 9, 1440x900 
0x37CA2318, 38092253231552136, 224811342, 224811352, 10, 1440x900 
0x37CA2318, 38092253232211544, 224811407, 224811418, 11, 1440x900 
0x37CA2318, 38092253232871280, 224811472, 224811480, 8, 1440x900 
0x37CA2318, 38092253233536104, 224811537, 224811546, 9, 1440x900 
0x37CA2318, 38092253234196072, 224811607, 224811614, 7, 1440x900 
0x37CA2318, 38092253234866112, 224811675, 224811683, 8, 1440x900 
0x37CA2318, 38092253235542048, 224811743, 224811762, 19, 1440x900 
0x37CA2318, 38092253236196440, 224811808, 224811818, 10, 1440x900 
0x37CA2318, 38092253236854008, 224811872, 224811881, 9, 1440x900 
0x37CA2318, 38092253237524648, 224811937, 224811946, 9, 1440x900 
0x37CA2318, 38092253238184648, 224812003, 224812011, 8, 1440x900 
0x37CA2318, 38092253239045632, 224812091, 224812098, 7, 1440x900 
0x37CA2318, 38092253239712512, 224812158, 224812165, 7, 1440x900 
0x37CA2318, 38092253240379904, 224812226, 224812234, 8, 1440x900 
0x37CA2318, 38092253241032840, 224812288, 224812296, 8, 1440x900 
0x37CA2318, 38092253241495936, 224812336, 224812344, 8, 1440x900 
0x37CA2318, 38092253242351840, 224812422, 224812430, 8, 1440x900 
0x37CA2318, 38092253243023624, 224812488, 224812495, 7, 1440x900 
0x37CA2318, 38092253243671328, 224812553, 224812560, 7, 1440x900 
0x37CA2318, 38092253244345680, 224812622, 224812630, 8, 1440x900 
0x37CA2318, 38092253244996032, 224812686, 224812694, 8, 1440x900 
0x37CA2318, 38092253245664776, 224812753, 224812760, 7, 1440x900 
0x37CA2318, 38092253246142344, 224812799, 224812807, 8, 1440x900 
0x37CA2318, 38092253246787016, 224812864, 224812871, 7, 1440x900 
0x37CA2318, 38092253247646464, 224812952, 224812960, 8, 1440x900 
0x37CA2318, 38092253248307136, 224813017, 224813024, 7, 1440x900 
0x37CA2318, 38092253248967136, 224813083, 224813090, 7, 1440x900 
0x37CA2318, 38092253249627648, 224813148, 224813156, 8, 1440x900 
0x37CA2318, 38092253250288920, 224813218, 224813226, 8, 1440x900 
0x37CA2318, 38092253250950440, 224813282, 224813291, 9, 1440x900 
0x37CA2318, 38092253251606376, 224813353, 224813361, 8, 1440x900 
0x37CA2318, 38092253252143424, 224813403, 224813411, 8, 1440x900 
0x37CA2318, 38092253252944960, 224813478, 224813488, 10, 1440x900 
0x37CA2318, 38092253253542904, 224813540, 224813561, 21, 1440x900 
0x37CA2318, 38092253254180912, 224813603, 224813627, 24, 1440x900 
0x37CA2318, 38092253254843960, 224813673, 224813689, 16, 1440x900 
0x37CA2318, 38092253255505608, 224813745, 224813757, 12, 1440x900 
0x37CA2318, 38092253256163256, 224813807, 224813817, 10, 1440x900 
0x37CA2318, 38092253256751952, 224813863, 224813884, 21, 1440x900 
0x37CA2318, 38092253257435424, 224813929, 224813948, 19, 1440x900 
0x37CA2318, 38092253258111824, 224814000, 224814015, 15, 1440x900 
0x37CA2318, 38092253258755256, 224814064, 224814078, 14, 1440x900 
0x37CA2318, 38092253259370688, 224814123, 224814130, 7, 1440x900 
0x37CA2318, 38092253260783520, 224814267, 224814275, 8, 1440x900 
0x37CA2318, 38092253261333048, 224814322, 224814330, 8, 1440x900 
0x37CA2318, 38092253261988384, 224814386, 224814393, 7, 1440x900 
0x37CA2318, 38092253262649640, 224814452, 224814459, 7, 1440x900 
0x37CA2318, 38092253263319136, 224814517, 224814524, 7, 1440x900 
0x37CA2318, 38092253263976752, 224814584, 224814591, 7, 1440x900 
0x37CA2318, 38092253264628296, 224814648, 224814655, 7, 1440x900 
0x37CA2318, 38092253265302552, 224814723, 224814730, 7, 1440x900 
0x37CA2318, 38092253265962696, 224814782, 224814789, 7, 1440x900 
0x37CA2318, 38092253266816504, 224814867, 224814874, 7, 1440x900 
0x37CA2318, 38092253267469264, 224814933, 224814940, 7, 1440x900 
0x37CA2318, 38092253268147536, 224815002, 224815011, 9, 1440x900 
0x37CA2318, 38092253268807704, 224815068, 224815082, 14, 1440x900 
0x37CA2318, 38092253269476912, 224815138, 224815146, 8, 1440x900 
0x37CA2318, 38092253270125168, 224815197, 224815204, 7, 1440x900 
0x37CA2318, 38092253270658448, 224815252, 224815260, 8, 1440x900 
0x37CA2318, 38092253271440248, 224815332, 224815339, 7, 1440x900 
0x37CA2318, 38092253272104616, 224815398, 224815405, 7, 1440x900 
0x37CA2318, 38092253272774168, 224815468, 224815476, 8, 1440x900 
0x37CA2318, 38092253273436528, 224815532, 224815540, 8, 1440x900 
0x37CA2318, 38092253274095624, 224815597, 224815605, 8, 1440x900 
0x37CA2318, 38092253274755176, 224815662, 224815669, 7, 1440x900 
0x37CA2318, 38092253275415344, 224815733, 224815741, 8, 1440x900 
0x37CA2318, 38092253276076880, 224815798, 224815806, 8, 1440x900 
0x37CA2318, 38092253276746624, 224815867, 224815877, 10, 1440x900 
0x37CA2318, 38092253277390144, 224815928, 224815936, 8, 1440x900 
0x37CA2318, 38092253278065328, 224815993, 224815999, 6, 1440x900 
0x37CA2318, 38092253278673440, 224816053, 224816062, 9, 1440x900 
0x37CA2318, 38092253279196560, 224816103, 224816114, 11, 1440x900 
0x37CA2318, 38092253279854032, 224816173, 224816181, 8, 1440x900 
0x37CA2318, 38092253280707688, 224816257, 224816265, 8, 1440x900 
0x37CA2318, 38092253281369560, 224816323, 224816332, 9, 1440x900 
0x37CA2318, 38092253282024720, 224816393, 224816400, 7, 1440x900 
0x37CA2318, 38092253282701904, 224816458, 224816466, 8, 1440x900 
0x37CA2318, 38092253283360928, 224816522, 224816529, 7, 1440x900 
0x37CA2318, 38092253283870912, 224816573, 224816580, 7, 1440x900 
0x37CA2318, 38092253284498688, 224816637, 224816644, 7, 1440x900 
0x37CA2318, 38092253285154824, 224816702, 224816709, 7, 1440x900 
0x37CA2318, 38092253285816632, 224816767, 224816774, 7, 1440x900 
0x37CA2318, 38092253286475888, 224816833, 224816840, 7, 1440x900 
0x37CA2318, 38092253287135880, 224816899, 224816906, 7, 1440x900 
0x37CA2318, 38092253287796232, 224816963, 224816971, 8, 1440x900 
0x37CA2318, 38092253288452824, 224817032, 224817039, 7, 1440x900 
0x37CA2318, 38092253289113032, 224817097, 224817104, 7, 1440x900 
0x37CA2318, 38092253289892800, 224817177, 224817185, 8, 1440x900 
0x37CA2318, 38092253290494784, 224817237, 224817245, 8, 1440x900 
0x37CA2318, 38092253291143872, 224817300, 224817308, 8, 1440x900 
0x37CA2318, 38092253291770224, 224817363, 224817370, 7, 1440x900 
0x37CA2318, 38092253292438008, 224817428, 224817436, 8, 1440x900 
0x37CA2318, 38092253293090256, 224817493, 224817501, 8, 1440x900 
0x37CA2318, 38092253293750280, 224817562, 224817569, 7, 1440x900 
0x37CA2318, 38092253294410464, 224817628, 224817635, 7, 1440x900 
0x37CA2318, 38092253295261656, 224817718, 224817726, 8, 1440x900 
0x37CA2318, 38092253295741488, 224817763, 224817772, 9, 1440x900 
0x37CA2318, 38092253296607480, 224817848, 224817857, 9, 1440x900 
0x37CA2318, 38092253297268248, 224817914, 224817923, 9, 1440x900 
0x37CA2318, 38092253297927192, 224817983, 224817991, 8, 1440x900 
0x37CA2318, 38092253298591032, 224818049, 224818058, 9, 1440x900 
0x37CA2318, 38092253299091448, 224818099, 224818106, 7, 1440x900 
0x37CA2318, 38092253299712384, 224818157, 224818165, 8, 1440x900 
0x37CA2318, 38092253300377696, 224818223, 224818231, 8, 1440x900 
0x37CA2318, 38092253301029408, 224818288, 224818296, 8, 1440x900 
0x37CA2318, 38092253301689472, 224818353, 224818361, 8, 1440x900 
0x37CA2318, 38092253302351584, 224818423, 224818431, 8, 1440x900 
0x37CA2318, 38092253303017592, 224818492, 224818500, 8, 1440x900 
0x37CA2318, 38092253303682752, 224818556, 224818564, 8, 1440x900 
0x37CA2318, 38092253304336008, 224818618, 224818626, 8, 1440x900 
0x37CA2318, 38092253305004016, 224818687, 224818694, 7, 1440x900 
0x37CA2318, 38092253305655968, 224818752, 224818760, 8, 1440x900 
0x37CA2318, 38092253306319032, 224818819, 224818828, 9, 1440x900 
0x37CA2318, 38092253306976520, 224818883, 224818891, 8, 1440x900 
0x37CA2318, 38092253307636656, 224818948, 224818957, 9, 1440x900 
0x37CA2318, 38092253308296760, 224819016, 224819023, 7, 1440x900 
0x37CA2318, 38092253308963920, 224819083, 224819091, 8, 1440x900 
0x37CA2318, 38092253309622384, 224819148, 224819156, 8, 1440x900 
0x37CA2318, 38092253310280728, 224819218, 224819226, 8, 1440x900 
0x37CA2318, 38092253311130176, 224819303, 224819312, 9, 1440x900 
0x37CA2318, 38092253311606584, 224819348, 224819357, 9, 1440x900 
0x37CA2318, 38092253312472016, 224819438, 224819446, 8, 1440x900 
0x37CA2318, 38092253313123560, 224819499, 224819508, 9, 1440x900 
0x37CA2318, 38092253313736808, 224819562, 224819570, 8, 1440x900 
0x37CA2318, 38092253314249256, 224819613, 224819621, 8, 1440x900 
0x37CA2318, 38092253314909040, 224819683, 224819691, 8, 1440x900 
0x37CA2318, 38092253315582560, 224819746, 224819753, 7, 1440x900 
0x37CA2318, 38092253316230464, 224819810, 224819819, 9, 1440x900 
0x37CA2318, 38092253316895904, 224819877, 224819885, 8, 1440x900 
0x37CA2318, 38092253317547104, 224819942, 224819949, 7, 1440x900 
0x37CA2318, 38092253318211384, 224820007, 224820013, 6, 1440x900 
0x37CA2318, 38092253318873120, 224820072, 224820080, 8, 1440x900 
0x37CA2318, 38092253319530488, 224820138, 224820146, 8, 1440x900 
0x37CA2318, 38092253320194424, 224820207, 224820215, 8, 1440x900 
0x37CA2318, 38092253320851472, 224820272, 224820279, 7, 1440x900 
0x37CA2318, 38092253321509792, 224820337, 224820344, 7, 1440x900 
0x37CA2318, 38092253322170128, 224820403, 224820411, 8, 1440x900 
0x37CA2318, 38092253322829928, 224820471, 224820479, 8, 1440x900 
0x37CA2318, 38092253323491808, 224820536, 224820544, 8, 1440x900 
0x37CA2318, 38092253324150024, 224820601, 224820609, 8, 1440x900 
0x37CA2318, 38092253325472752, 224820732, 224820740, 8, 1440x900 
0x37CA2318, 38092253326132368, 224820798, 224820806, 8, 1440x900 
0x37CA2318, 38092253326795920, 224820868, 224820876, 8, 1440x900 
0x37CA2318, 38092253327455040, 224820937, 224820944, 7, 1440x900 
0x37CA2318, 38092253328120960, 224821003, 224821010, 7, 1440x900 
0x37CA2318, 38092253328783840, 224821063, 224821071, 8, 1440x900 
0x37CA2318, 38092253329439992, 224821131, 224821139, 8, 1440x900 
0x37CA2318, 38092253330100160, 224821197, 224821204, 7, 1440x900 
0x37CA2318, 38092253330760136, 224821262, 224821270, 8, 1440x900 
0x37CA2318, 38092253331616048, 224821347, 224821354, 7, 1440x900 
0x37CA2318, 38092253332287776, 224821413, 224821421, 8, 1440x900 
0x37CA2318, 38092253332948184, 224821482, 224821490, 8, 1440x900 
0x37CA2318, 38092253333413872, 224821527, 224821534, 7, 1440x900 
0x37CA2318, 38092253334072920, 224821592, 224821600, 8, 1440x900 
0x37CA2318, 38092253334927656, 224821678, 224821685, 7, 1440x900 
0x37CA2318, 38092253335549552, 224821742, 224821749, 7, 1440x900 
0x37CA2318, 38092253336250784, 224821812, 224821820, 8, 1440x900 
0x37CA2318, 38092253336912800, 224821878, 224821887, 9, 1440x900 
0x37CA2318, 38092253337577352, 224821947, 224821955, 8, 1440x900 
0x37CA2318, 38092253338229152, 224822012, 224822020, 8, 1440x900 
0x37CA2318, 38092253338897432, 224822077, 224822086, 9, 1440x900 
0x37CA2318, 38092253339550360, 224822142, 224822150, 8, 1440x900 
0x37CA2318, 38092253340219584, 224822213, 224822221, 8, 1440x900 
0x37CA2318, 38092253340888584, 224822276, 224822284, 8, 1440x900 
0x37CA2318, 38092253341540824, 224822341, 224822348, 7, 1440x900 
0x37CA2318, 38092253342291128, 224822416, 224822423, 7, 1440x900 
0x37CA2318, 38092253342852456, 224822472, 224822480, 8, 1440x900 
0x37CA2318, 38092253343523808, 224822538, 224822547, 9, 1440x900 
0x37CA2318, 38092253343989648, 224822583, 224822591, 8, 1440x900 
0x37CA2318, 38092253344836880, 224822677, 224822685, 8, 1440x900 
0x37CA2318, 38092253345507952, 224822738, 224822747, 9, 1440x900 
0x37CA2318, 38092253346172624, 224822807, 224822815, 8, 1440x900 
0x37CA2318, 38092253346831040, 224822867, 224822875, 8, 1440x900 
0x37CA2318, 38092253347491552, 224822936, 224822944, 8, 1440x900 
0x37CA2318, 38092253348152528, 224823002, 224823009, 7, 1440x900 
0x37CA2318, 38092253348816168, 224823068, 224823077, 9, 1440x900 
0x37CA2318, 38092253349469080, 224823138, 224823146, 8, 1440x900 
0x37CA2318, 38092253350138568, 224823198, 224823206, 8, 1440x900 
0x37CA2318, 38092253350800016, 224823266, 224823273, 7, 1440x900 
0x37CA2318, 38092253351469544, 224823338, 224823347, 9, 1440x900 
0x37CA2318, 38092253351928832, 224823378, 224823386, 8, 1440x900 
0x37CA2318, 38092253352779904, 224823468, 224823476, 8, 1440x900 
0x37CA2318, 38092253353441176, 224823532, 224823541, 9, 1440x900 
0x37CA2318, 38092253354132928, 224823602, 224823611, 9, 1440x900 
0x37CA2318, 38092253354575856, 224823647, 224823654, 7, 1440x900 
0x37CA2318, 38092253355226680, 224823708, 224823716, 8, 1440x900 
0x37CA2318, 38092253356084504, 224823793, 224823801, 8, 1440x900 
0x37CA2318, 38092253356737128, 224823863, 224823870, 7, 1440x900 
0x37CA2318, 38092253357411096, 224823927, 224823937, 10, 1440x900 
0x37CA2318, 38092253357866752, 224823972, 224823982, 10, 1440x900 
0x37CA2318, 38092253358643656, 224824053, 224824061, 8, 1440x900 
0x37CA2318, 38092253359184024, 224824102, 224824110, 8, 1440x900 
0x37CA2318, 38092253359847256, 224824172, 224824179, 7, 1440x900 
0x37CA2318, 38092253360516056, 224824237, 224824245, 8, 1440x900 
0x37CA2318, 38092253361175304, 224824303, 224824311, 8, 1440x900 
0x37CA2318, 38092253361839896, 224824373, 224824380, 7, 1440x900 
0x37CA2318, 38092253362535000, 224824442, 224824450, 8, 1440x900 
0x37CA2318, 38092253363159640, 224824502, 224824510, 8, 1440x900 
0x37CA2318, 38092253363816296, 224824568, 224824574, 6, 1440x900 
0x37CA2318, 38092253364484784, 224824633, 224824640, 7, 1440x900 
0x37CA2318, 38092253365159248, 224824704, 224824713, 9, 1440x900 
0x37CA2318, 38092253365821056, 224824773, 224824780, 7, 1440x900 
0x37CA2318, 38092253366480688, 224824837, 224824846, 9, 1440x900 
0x37CA2318, 38092253367140088, 224824902, 224824910, 8, 1440x900 
0x37CA2318, 38092253367800424, 224824973, 224824981, 8, 1440x900 
0x37CA2318, 38092253368461704, 224825038, 224825046, 8, 1440x900 
0x37CA2318, 38092253369210088, 224825111, 224825119, 8, 1440x900 
0x37CA2318, 38092253369781792, 224825166, 224825174, 8, 1440x900 
0x37CA2318, 38092253370439568, 224825231, 224825238, 7, 1440x900 
0x37CA2318, 38092253371099080, 224825297, 224825305, 8, 1440x900 
0x37CA2318, 38092253371772640, 224825365, 224825374, 9, 1440x900 
0x37CA2318, 38092253372427608, 224825428, 224825436, 8, 1440x900 
0x37CA2318, 38092253373093080, 224825497, 224825504, 7, 1440x900 
0x37CA2318, 38092253373748144, 224825562, 224825570, 8, 1440x900 
0x37CA2318, 38092253374406456, 224825628, 224825636, 8, 1440x900 
0x37CA2318, 38092253375066304, 224825693, 224825701, 8, 1440x900 
0x37CA2318, 38092253375724104, 224825758, 224825767, 9, 1440x900 
0x37CA2318, 38092253376385040, 224825827, 224825835, 8, 1440x900 
0x37CA2318, 38092253377046552, 224825893, 224825900, 7, 1440x900 
0x37CA2318, 38092253377709128, 224825958, 224825965, 7, 1440x900 
0x37CA2318, 38092253378371648, 224826027, 224826042, 15, 1440x900 
0x37CA2318, 38092253379030848, 224826088, 224826101, 13, 1440x900 
0x37CA2318, 38092253379698816, 224826157, 224826165, 8, 1440x900 
0x37CA2318, 38092253380344056, 224826222, 224826230, 8, 1440x900 
0x37CA2318, 38092253381034000, 224826294, 224826303, 9, 1440x900 
0x37CA2318, 38092253381694544, 224826357, 224826368, 11, 1440x900 
0x37CA2318, 38092253382355016, 224826422, 224826430, 8, 1440x900 
0x37CA2318, 38092253383000576, 224826487, 224826494, 7, 1440x900 
0x37CA2318, 38092253383646192, 224826551, 224826559, 8, 1440x900 
0x37CA2318, 38092253384306848, 224826617, 224826624, 7, 1440x900 
0x37CA2318, 38092253384961408, 224826683, 224826690, 7, 1440x900 
0x37CA2318, 38092253386292816, 224826817, 224826825, 8, 1440x900 
0x37CA2318, 38092253386940528, 224826883, 224826891, 8, 1440x900 
0x37CA2318, 38092253387797608, 224826966, 224826974, 8, 1440x900 
0x37CA2318, 38092253388457848, 224827033, 224827042, 9, 1440x900 
0x37CA2318, 38092253388926080, 224827081, 224827092, 11, 1440x900 
0x37CA2318, 38092253389713320, 224827157, 224827168, 11, 1440x900 
0x37CA2318, 38092253390239328, 224827208, 224827217, 9, 1440x900 
0x37CA2318, 38092253390904856, 224827277, 224827287, 10, 1440x900 
0x37CA2318, 38092253393280896, 224827518, 224827527, 9, 1440x900 
0x37CA2318, 38092253393502472, 224827537, 224827545, 8, 1440x900 
0x37CA2318, 38092253398630032, 224828047, 224828056, 9, 1440x900 
0x37CA2318, 38092253399291008, 224828119, 224828128, 9, 1440x900 
0x37CA2318, 38092253401271064, 224828313, 224828321, 8, 1440x900 
0x37CA2318, 38092253401930408, 224828381, 224828389, 8, 1440x900 
0x37CA2318, 38092253402591920, 224828443, 224828451, 8, 1440x900 
0x37CA2318, 38092253403263184, 224828520, 224828530, 10, 1440x900 
0x37CA2318, 38092253403919192, 224828578, 224828586, 8, 1440x900 
0x37CA2318, 38092253404584072, 224828644, 224828652, 8, 1440x900 
0x37CA2318, 38092253405239792, 224828708, 224828716, 8, 1440x900 
0x37CA2318, 38092253405900944, 224828780, 224828790, 10, 1440x900 
0x37CA2318, 38092253406563720, 224828842, 224828850, 8, 1440x900 
0x37CA2318, 38092253407238168, 224828913, 224828921, 8, 1440x900 
0x37CA2318, 38092253407892712, 224828977, 224828984, 7, 1440x900 
0x37CA2318, 38092253408553496, 224829043, 224829050, 7, 1440x900 
0x37CA2318, 38092253409211544, 224829108, 224829115, 7, 1440x900 
0x37CA2318, 38092253409871520, 224829173, 224829181, 8, 1440x900 
0x37CA2318, 38092253410531648, 224829238, 224829246, 8, 1440x900 
0x37CA2318, 38092253411192832, 224829307, 224829314, 7, 1440x900 
0x37CA2318, 38092253411979208, 224829383, 224829391, 8, 1440x900 
0x37CA2318, 38092253412599576, 224829450, 224829459, 9, 1440x900 
0x37CA2318, 38092253413217184, 224829508, 224829523, 15, 1440x900 
0x37CA2318, 38092253413872704, 224829573, 224829581, 8, 1440x900 
0x37CA2318, 38092253414568016, 224829640, 224829650, 10, 1440x900 
0x37CA2318, 38092253415198464, 224829708, 224829724, 16, 1440x900 
0x37CA2318, 38092253415997208, 224829787, 224829795, 8, 1440x900 
0x37CA2318, 38092253416659648, 224829853, 224829863, 10, 1440x900 
0x37CA2318, 38092253417357264, 224829919, 224829928, 9, 1440x900 
0x37CA2318, 38092253417986944, 224829987, 224829994, 7, 1440x900 
0x37CA2318, 38092253418646464, 224830049, 224830061, 12, 1440x900 
0x37CA2318, 38092253419302400, 224830114, 224830124, 10, 1440x900 
0x37CA2318, 38092253419963752, 224830183, 224830190, 7, 1440x900 
0x37CA2318, 38092253420621032, 224830248, 224830256, 8, 1440x900 
0x37CA2318, 38092253421282056, 224830312, 224830338, 26, 1440x900 
0x37CA2318, 38092253422047992, 224830410, 224830444, 34, 1440x900 
0x37CA2318, 38092253422746840, 224830459, 224830475, 16, 1440x900 
0x37CA2318, 38092253423348696, 224830523, 224830530, 7, 1440x900 
0x37CA2318, 38092253424013056, 224830585, 224830594, 9, 1440x900 
0x37CA2318, 38092253424673624, 224830652, 224830660, 8, 1440x900 
0x37CA2318, 38092253425334184, 224830718, 224830726, 8, 1440x900 
0x37CA2318, 38092253425992680, 224830783, 224830791, 8, 1440x900 
0x37CA2318, 38092253426786200, 224830868, 224830891, 23, 1440x900 
0x37CA2318, 38092253427330048, 224830918, 224830926, 8, 1440x900 
0x37CA2318, 38092253427986072, 224830987, 224830995, 8, 1440x900 
0x37CA2318, 38092253428715088, 224831057, 224831068, 11, 1440x900 
0x37CA2318, 38092253429457208, 224831136, 224831147, 11, 1440x900 
0x37CA2318, 38092253430013216, 224831188, 224831195, 7, 1440x900 
0x37CA2318, 38092253430671432, 224831253, 224831260, 7, 1440x900 
0x37CA2318, 38092253431341904, 224831323, 224831331, 8, 1440x900 
0x37CA2318, 38092253432004088, 224831388, 224831399, 11, 1440x900 
0x37CA2318, 38092253432733280, 224831460, 224831472, 12, 1440x900 
0x37CA2318, 38092253433367928, 224831524, 224831532, 8, 1440x900 
0x37CA2318, 38092253433994984, 224831585, 224831593, 8, 1440x900 
0x37CA2318, 38092253434649856, 224831648, 224831656, 8, 1440x900 
0x37CA2318, 38092253435310848, 224831722, 224831730, 8, 1440x900 
0x37CA2318, 38092253435969920, 224831785, 224831802, 17, 1440x900 
0x37CA2318, 38092253436638632, 224831852, 224831860, 8, 1440x900 
0x37CA2318, 38092253437298464, 224831913, 224831922, 9, 1440x900 
0x37CA2318, 38092253437957712, 224831983, 224831990, 7, 1440x900 
0x37CA2318, 38092253438620248, 224832047, 224832056, 9, 1440x900 
0x37CA2318, 38092253439279808, 224832113, 224832122, 9, 1440x900 
0x37CA2318, 38092253440141312, 224832199, 224832207, 8, 1440x900 
0x37CA2318, 38092253440803928, 224832268, 224832277, 9, 1440x900 
0x37CA2318, 38092253441454864, 224832332, 224832339, 7, 1440x900 
0x37CA2318, 38092253442113736, 224832397, 224832406, 9, 1440x900 
0x37CA2318, 38092253442774288, 224832465, 224832473, 8, 1440x900 
0x37CA2318, 38092253443268160, 224832514, 224832524, 10, 1440x900 
0x37CA2318, 38092253444094944, 224832600, 224832609, 9, 1440x900 
0x37CA2318, 38092253444887648, 224832677, 224832687, 10, 1440x900 
0x37CA2318, 38092253445264552, 224832712, 224832719, 7, 1440x900 
0x37CA2318, 38092253446087416, 224832793, 224832801, 8, 1440x900 
0x37CA2318, 38092253447105256, 224832900, 224832929, 29, 1440x900 
0x37CA2318, 38092253447446248, 224832932, 224832940, 8, 1440x900 
0x37CA2318, 38092253448128920, 224833008, 224833018, 10, 1440x900 
0x37CA2318, 38092253448592544, 224833052, 224833069, 17, 1440x900 
0x37CA2318, 38092253449375072, 224833122, 224833131, 9, 1440x900 
0x37CA2318, 38092253450075480, 224833192, 224833201, 9, 1440x900 
0x37CA2318, 38092253450537632, 224833238, 224833246, 8, 1440x900 
0x37CA2318, 38092253451283032, 224833321, 224833332, 11, 1440x900 
0x37CA2318, 38092253452053224, 224833397, 224833421, 24, 1440x900 
0x37CA2318, 38092253452682880, 224833453, 224833480, 27, 1440x900 
0x37CA2318, 38092253453354712, 224833523, 224833530, 7, 1440x900 
0x37CA2318, 38092253454021232, 224833591, 224833620, 29, 1440x900 
0x37CA2318, 38092253454572496, 224833660, 224833688, 28, 1440x900 
0x37CA2318, 38092253455451280, 224833733, 224833756, 23, 1440x900 
0x37CA2318, 38092253455913160, 224833778, 224833788, 10, 1440x900 
0x37CA2318, 38092253456678432, 224833860, 224833874, 14, 1440x900 
0x37CA2318, 38092253457259736, 224833913, 224833921, 8, 1440x900 
0x37CA2318, 38092253457908424, 224833978, 224833987, 9, 1440x900 
0x37CA2318, 38092253458653648, 224834060, 224834092, 32, 1440x900 
0x37CA2318, 38092253459205416, 224834107, 224834113, 6, 1440x900 
0x37CA2318, 38092253459854352, 224834173, 224834179, 6, 1440x900 
0x37CA2318, 38092253460590520, 224834248, 224834270, 22, 1440x900 
0x37CA2318, 38092253461192128, 224834306, 224834313, 7, 1440x900 
0x37CA2318, 38092253461811592, 224834367, 224834375, 8, 1440x900 
0x37CA2318, 38092253462667400, 224834453, 224834461, 8, 1440x900 
0x37CA2318, 38092253463175664, 224834503, 224834511, 8, 1440x900 
0x37CA2318, 38092253463860768, 224834572, 224834579, 7, 1440x900 
0x37CA2318, 38092253464459592, 224834633, 224834640, 7, 1440x900 
0x37CA2318, 38092253465119936, 224834697, 224834708, 11, 1440x900 
0x37CA2318, 38092253465790112, 224834763, 224834772, 9, 1440x900 
0x37CA2318, 38092253466439672, 224834828, 224834836, 8, 1440x900 
0x37CA2318, 38092253467761824, 224834962, 224834969, 7, 1440x900 
0x37CA2318, 38092253468424416, 224835028, 224835036, 8, 1440x900 
0x37CA2318, 38092253469171784, 224835108, 224835116, 8, 1440x900 
0x37CA2318, 38092253469743896, 224835163, 224835171, 8, 1440x900 
0x37CA2318, 38092253470406424, 224835233, 224835244, 11, 1440x900 
0x37CA2318, 38092253471076664, 224835293, 224835302, 9, 1440x900 
0x37CA2318, 38092253471753544, 224835362, 224835370, 8, 1440x900 
0x37CA2318, 38092253472579328, 224835448, 224835457, 9, 1440x900 
0x37CA2318, 38092253473053560, 224835494, 224835502, 8, 1440x900 
0x37CA2318, 38092253473711160, 224835563, 224835571, 8, 1440x900 
0x37CA2318, 38092253474373216, 224835623, 224835631, 8, 1440x900 
0x37CA2318, 38092253475048520, 224835693, 224835699, 6, 1440x900 
0x37CA2318, 38092253475691448, 224835753, 224835761, 8, 1440x900 
0x37CA2318, 38092253476366864, 224835823, 224835831, 8, 1440x900 
0x37CA2318, 38092253477053016, 224835892, 224835900, 8, 1440x900 
0x37CA2318, 38092253477675320, 224835954, 224835961, 7, 1440x900 
0x37CA2318, 38092253478335792, 224836019, 224836028, 9, 1440x900 
0x37CA2318, 38092253478995128, 224836083, 224836092, 9, 1440x900 
0x37CA2318, 38092253479655208, 224836153, 224836160, 7, 1440x900 
0x37CA2318, 38092253480355056, 224836221, 224836229, 8, 1440x900 
0x37CA2318, 38092253481086640, 224836296, 224836304, 8, 1440x900 
0x37CA2318, 38092253481641576, 224836348, 224836356, 8, 1440x900 
0x37CA2318, 38092253482303168, 224836419, 224836427, 8, 1440x900 
0x37CA2318, 38092253483032824, 224836490, 224836509, 19, 1440x900 
0x37CA2318, 38092253483667320, 224836556, 224836564, 8, 1440x900 
0x37CA2318, 38092253484322248, 224836618, 224836625, 7, 1440x900 
0x37CA2318, 38092253484947624, 224836678, 224836686, 8, 1440x900 
0x37CA2318, 38092253485856000, 224836775, 224836791, 16, 1440x900 
0x37CA2318, 38092253486300976, 224836813, 224836823, 10, 1440x900 
0x37CA2318, 38092253486967432, 224836883, 224836900, 17, 1440x900 
0x37CA2318, 38092253487626088, 224836948, 224836955, 7, 1440x900 
0x37CA2318, 38092253488366424, 224837024, 224837032, 8, 1440x900 
0x37CA2318, 38092253489025440, 224837088, 224837097, 9, 1440x900 
0x37CA2318, 38092253489604496, 224837146, 224837154, 8, 1440x900 
0x37CA2318, 38092253490249032, 224837211, 224837219, 8, 1440x900 
0x37CA2318, 38092253490937664, 224837282, 224837289, 7, 1440x900 
0x37CA2318, 38092253491606144, 224837347, 224837356, 9, 1440x900 
0x37CA2318, 38092253492262600, 224837412, 224837420, 8, 1440x900 
0x37CA2318, 38092253492907464, 224837474, 224837484, 10, 1440x900 
0x37CA2318, 38092253493595408, 224837543, 224837551, 8, 1440x900 
0x37CA2318, 38092253494211536, 224837604, 224837613, 9, 1440x900 
0x37CA2318, 38092253494871728, 224837672, 224837680, 8, 1440x900 
0x37CA2318, 38092253495532952, 224837740, 224837747, 7, 1440x900 
0x37CA2318, 38092253496191392, 224837804, 224837813, 9, 1440x900 
0x37CA2318, 38092253496888640, 224837878, 224837886, 8, 1440x900 
0x37CA2318, 38092253497522416, 224837938, 224837948, 10, 1440x900 
0x37CA2318, 38092253498202584, 224838004, 224838013, 9, 1440x900 
0x37CA2318, 38092253498834752, 224838068, 224838077, 9, 1440x900 
0x37CA2318, 38092253499494648, 224838133, 224838142, 9, 1440x900 
0x37CA2318, 38092253500153872, 224838202, 224838210, 8, 1440x900 
0x37CA2318, 38092253500814264, 224838267, 224838275, 8, 1440x900 
0x37CA2318, 38092253501476632, 224838333, 224838341, 8, 1440x900 
0x37CA2318, 38092253502136856, 224838398, 224838407, 9, 1440x900 
0x37CA2318, 38092253502806248, 224838467, 224838474, 7, 1440x900 
0x37CA2318, 38092253503659704, 224838552, 224838560, 8, 1440x900 
0x37CA2318, 38092253504212248, 224838608, 224838615, 7, 1440x900 
0x37CA2318, 38092253504782184, 224838664, 224838673, 9, 1440x900 
0x37CA2318, 38092253505438696, 224838732, 224838739, 7, 1440x900 
0x37CA2318, 38092253506098768, 224838797, 224838805, 8, 1440x900 
0x37CA2318, 38092253506764864, 224838862, 224838870, 8, 1440x900 
0x37CA2318, 38092253507425224, 224838928, 224838937, 9, 1440x900 
0x37CA2318, 38092253508095680, 224838993, 224839001, 8, 1440x900 
0x37CA2318, 38092253508738248, 224839058, 224839067, 9, 1440x900 
0x37CA2318, 38092253509441624, 224839132, 224839141, 9, 1440x900 
0x37CA2318, 38092253510071320, 224839192, 224839201, 9, 1440x900 
0x37CA2318, 38092253510748592, 224839258, 224839266, 8, 1440x900 
0x37CA2318, 38092253511383440, 224839323, 224839331, 8, 1440x900 
0x37CA2318, 38092253512044056, 224839391, 224839399, 8, 1440x900 
0x37CA2318, 38092253512710128, 224839458, 224839466, 8, 1440x900 
0x37CA2318, 38092253513373400, 224839523, 224839532, 9, 1440x900 
0x37CA2318, 38092253514028648, 224839588, 224839597, 9, 1440x900 
0x37CA2318, 38092253514689704, 224839653, 224839662, 9, 1440x900 
0x37CA2318, 38092253515349192, 224839722, 224839730, 8, 1440x900 
0x37CA2318, 38092253516014336, 224839787, 224839795, 8, 1440x900 
0x37CA2318, 38092253516674200, 224839852, 224839860, 8, 1440x900 
0x37CA2318, 38092253517522896, 224839938, 224839945, 7, 1440x900 
0x37CA2318, 38092253518187392, 224840008, 224840016, 8, 1440x900 
0x37CA2318, 38092253518856384, 224840072, 224840081, 9, 1440x900 
0x37CA2318, 38092253519505808, 224840138, 224840146, 8, 1440x900 
0x37CA2318, 38092253519974496, 224840183, 224840192, 9, 1440x900 
0x37CA2318, 38092253520634984, 224840253, 224840262, 9, 1440x900 
0x37CA2318, 38092253521294480, 224840318, 224840326, 8, 1440x900 
0x37CA2318, 38092253521964576, 224840388, 224840396, 8, 1440x900 
0x37CA2318, 38092253522622832, 224840453, 224840461, 8, 1440x900 
0x37CA2318, 38092253523283896, 224840519, 224840529, 10, 1440x900 
0x37CA2318, 38092253523968424, 224840583, 224840592, 9, 1440x900 
0x37CA2318, 38092253524808160, 224840667, 224840674, 7, 1440x900 
0x37CA2318, 38092253525462712, 224840732, 224840740, 8, 1440x900 
0x37CA2318, 38092253526140744, 224840802, 224840811, 9, 1440x900 
0x37CA2318, 38092253526795344, 224840868, 224840876, 8, 1440x900 
0x37CA2318, 38092253527455432, 224840933, 224840942, 9, 1440x900 
0x37CA2318, 38092253528116384, 224841003, 224841013, 10, 1440x900 
0x37CA2318, 38092253528587832, 224841045, 224841053, 8, 1440x900 
0x37CA2318, 38092253530096232, 224841197, 224841205, 8, 1440x900 
0x37CA2318, 38092253530766528, 224841263, 224841270, 7, 1440x900 
0x37CA2318, 38092253531423568, 224841333, 224841341, 8, 1440x900 
0x37CA2318, 38092253531991504, 224841388, 224841398, 10, 1440x900 
0x37CA2318, 38092253532577360, 224841442, 224841450, 8, 1440x900 
0x37CA2318, 38092253533331008, 224841518, 224841526, 8, 1440x900 
0x37CA2318, 38092253534065000, 224841593, 224841600, 7, 1440x900 
0x37CA2318, 38092253534734624, 224841658, 224841667, 9, 1440x900 
0x37CA2318, 38092253535394552, 224841727, 224841734, 7, 1440x900 
0x37CA2318, 38092253536055832, 224841791, 224841799, 8, 1440x900 
0x37CA2318, 38092253536539912, 224841842, 224841849, 7, 1440x900 
0x37CA2318, 38092253537376688, 224841923, 224841931, 8, 1440x900 
0x37CA2318, 38092253537838208, 224841968, 224841976, 8, 1440x900 
0x37CA2318, 38092253538705928, 224842057, 224842066, 9, 1440x900 
0x37CA2318, 38092253539357128, 224842122, 224842131, 9, 1440x900 
0x37CA2318, 38092253540018200, 224842188, 224842197, 9, 1440x900 
0x37CA2318, 38092253540678968, 224842257, 224842265, 8, 1440x900 
0x37CA2318, 38092253541339992, 224842323, 224842331, 8, 1440x900 
0x37CA2318, 38092253541999728, 224842387, 224842395, 8, 1440x900 
0x37CA2318, 38092253542661304, 224842453, 224842461, 8, 1440x900 
0x37CA2318, 38092253543321968, 224842518, 224842526, 8, 1440x900 
0x37CA2318, 38092253543990504, 224842588, 224842596, 8, 1440x900 
0x37CA2318, 38092253544651376, 224842652, 224842660, 8, 1440x900 
0x37CA2318, 38092253545320208, 224842723, 224842731, 8, 1440x900 
0x37CA2318, 38092253545774456, 224842763, 224842770, 7, 1440x900 
0x37CA2318, 38092253546445952, 224842833, 224842842, 9, 1440x900 
0x37CA2318, 38092253547105656, 224842902, 224842910, 8, 1440x900 
0x37CA2318, 38092253547777176, 224842968, 224842977, 9, 1440x900 
0x37CA2318, 38092253548630688, 224843053, 224843061, 8, 1440x900 
0x37CA2318, 38092253549300976, 224843119, 224843128, 9, 1440x900 
0x37CA2318, 38092253549781304, 224843165, 224843172, 7, 1440x900 
0x37CA2318, 38092253550618952, 224843248, 224843256, 8, 1440x900 
0x37CA2318, 38092253551279008, 224843316, 224843324, 8, 1440x900 
0x37CA2318, 38092253551929968, 224843381, 224843389, 8, 1440x900 
0x37CA2318, 38092253552601856, 224843448, 224843457, 9, 1440x900 
0x37CA2318, 38092253553066016, 224843494, 224843503, 9, 1440x900 
0x37CA2318, 38092253553922248, 224843583, 224843591, 8, 1440x900 
0x37CA2318, 38092253554578464, 224843647, 224843655, 8, 1440x900 
0x37CA2318, 38092253555248400, 224843713, 224843721, 8, 1440x900 
0x37CA2318, 38092253555902080, 224843778, 224843786, 8, 1440x900 
0x37CA2318, 38092253556562328, 224843842, 224843850, 8, 1440x900 
0x37CA2318, 38092253557026192, 224843887, 224843895, 8, 1440x900 
0x37CA2318, 38092253557688080, 224843958, 224843966, 8, 1440x900 
0x37CA2318, 38092253558350576, 224844028, 224844036, 8, 1440x900 
0x37CA2318, 38092253559012608, 224844088, 224844098, 10, 1440x900 
0x37CA2318, 38092253559707944, 224844159, 224844169, 10, 1440x900 
0x37CA2318, 38092253560351136, 224844222, 224844229, 7, 1440x900 
0x37CA2318, 38092253561009288, 224844287, 224844294, 7, 1440x900 
0x37CA2318, 38092253561675840, 224844352, 224844360, 8, 1440x900 
0x37CA2318, 38092253562376472, 224844423, 224844432, 9, 1440x900 
0x37CA2318, 38092253563020320, 224844488, 224844496, 8, 1440x900 
0x37CA2318, 38092253563656192, 224844552, 224844559, 7, 1440x900 
0x37CA2318, 38092253564330864, 224844618, 224844626, 8, 1440x900 
0x37CA2318, 38092253564976696, 224844682, 224844690, 8, 1440x900 
0x37CA2318, 38092253565657768, 224844753, 224844761, 8, 1440x900 
0x37CA2318, 38092253566361936, 224844823, 224844832, 9, 1440x900 
0x37CA2318, 38092253566985840, 224844888, 224844895, 7, 1440x900 
0x37CA2318, 38092253567695744, 224844955, 224844965, 10, 1440x900 
0x37CA2318, 38092253568303520, 224845016, 224845046, 30, 1440x900 
0x37CA2318, 38092253568961040, 224845080, 224845090, 10, 1440x900 
0x37CA2318, 38092253569660864, 224845152, 224845160, 8, 1440x900 
0x37CA2318, 38092253570288032, 224845213, 224845234, 21, 1440x900 
0x37CA2318, 38092253570946536, 224845283, 224845290, 7, 1440x900 
0x37CA2318, 38092253571640584, 224845348, 224845356, 8, 1440x900 
0x37CA2318, 38092253572302936, 224845417, 224845424, 7, 1440x900 
0x37CA2318, 38092253572924392, 224845477, 224845485, 8, 1440x900 
0x37CA2318, 38092253573585272, 224845543, 224845552, 9, 1440x900 
0x37CA2318, 38092253574278656, 224845612, 224845620, 8, 1440x900 
0x37CA2318, 38092253574903872, 224845677, 224845684, 7, 1440x900 
0x37CA2318, 38092253575569552, 224845748, 224845762, 14, 1440x900 
0x37CA2318, 38092253576284784, 224845816, 224845823, 7, 1440x900 
0x37CA2318, 38092253576890216, 224845879, 224845889, 10, 1440x900 
0x37CA2318, 38092253577551648, 224845941, 224845948, 7, 1440x900 
0x37CA2318, 38092253578246176, 224846012, 224846023, 11, 1440x900 
0x37CA2318, 38092253578871544, 224846073, 224846081, 8, 1440x900 
0x37CA2318, 38092253579531536, 224846139, 224846148, 9, 1440x900 
0x37CA2318, 38092253580202192, 224846207, 224846215, 8, 1440x900 
0x37CA2318, 38092253580862208, 224846273, 224846280, 7, 1440x900 
0x37CA2318, 38092253581522568, 224846337, 224846345, 8, 1440x900 
0x37CA2318, 38092253582183504, 224846402, 224846410, 8, 1440x900 
0x37CA2318, 38092253583001848, 224846483, 224846492, 9, 1440x900 
0x37CA2318, 38092253583509096, 224846537, 224846545, 8, 1440x900 
0x37CA2318, 38092253584363432, 224846622, 224846629, 7, 1440x900 
0x37CA2318, 38092253585014360, 224846688, 224846695, 7, 1440x900 
0x37CA2318, 38092253585686464, 224846756, 224846764, 8, 1440x900 
0x37CA2318, 38092253586288888, 224846818, 224846825, 7, 1440x900 
0x37CA2318, 38092253586810600, 224846872, 224846880, 8, 1440x900 
0x37CA2318, 38092253587468320, 224846933, 224846941, 8, 1440x900 
0x37CA2318, 38092253588337048, 224847023, 224847031, 8, 1440x900 
0x37CA2318, 38092253588996288, 224847087, 224847096, 9, 1440x900 
0x37CA2318, 38092253589657440, 224847158, 224847166, 8, 1440x900 
0x37CA2318, 38092253590313400, 224847220, 224847229, 9, 1440x900 
0x37CA2318, 38092253590973448, 224847287, 224847295, 8, 1440x900 
0x37CA2318, 38092253591635184, 224847353, 224847402, 49, 1440x900 
0x37CA2318, 38092253592306800, 224847426, 224847434, 8, 1440x900 
0x37CA2318, 38092253593417624, 224847528, 224847535, 7, 1440x900 
0x37CA2318, 38092253594077696, 224847593, 224847600, 7, 1440x900 
0x37CA2318, 38092253594739736, 224847658, 224847667, 9, 1440x900 
0x37CA2318, 38092253595397720, 224847723, 224847731, 8, 1440x900 
0x37CA2318, 38092253596057648, 224847792, 224847799, 7, 1440x900 
0x37CA2318, 38092253596725280, 224847858, 224847866, 8, 1440x900 
0x37CA2318, 38092253597384416, 224847924, 224847932, 8, 1440x900 
0x37CA2318, 38092253598039512, 224847989, 224847997, 8, 1440x900 
0x37CA2318, 38092253598714424, 224848064, 224848073, 9, 1440x900 
0x37CA2318, 38092253599362440, 224848123, 224848132, 9, 1440x900 
0x37CA2318, 38092253600024672, 224848188, 224848196, 8, 1440x900 
0x37CA2318, 38092253600687944, 224848258, 224848265, 7, 1440x900 
0x37CA2318, 38092253601365528, 224848322, 224848331, 9, 1440x900 
0x37CA2318, 38092253602014800, 224848387, 224848395, 8, 1440x900 
0x37CA2318, 38092253602675752, 224848452, 224848461, 9, 1440x900 
0x37CA2318, 38092253603336016, 224848521, 224848529, 8, 1440x900 
0x37CA2318, 38092253603994520, 224848587, 224848595, 8, 1440x900 
0x37CA2318, 38092253604654808, 224848652, 224848660, 8, 1440x900 
0x37CA2318, 38092253605315632, 224848718, 224848726, 8, 1440x900 
0x37CA2318, 38092253605975512, 224848783, 224848791, 8, 1440x900 
0x37CA2318, 38092253606635616, 224848851, 224848859, 8, 1440x900 
0x37CA2318, 38092253607299328, 224848918, 224848926, 8, 1440x900 
0x37CA2318, 38092253607962856, 224848988, 224848996, 8, 1440x900 
0x37CA2318, 38092253608614496, 224849047, 224849055, 8, 1440x900 
0x37CA2318, 38092253609275344, 224849113, 224849123, 10, 1440x900 
0x37CA2318, 38092253609940544, 224849182, 224849189, 7, 1440x900 
0x37CA2318, 38092253610600616, 224849247, 224849255, 8, 1440x900 
0x37CA2318, 38092253611261424, 224849312, 224849320, 8, 1440x900 
0x37CA2318, 38092253611922376, 224849378, 224849386, 8, 1440x900 
0x37CA2318, 38092253612587664, 224849443, 224849451, 8, 1440x900 
0x37CA2318, 38092253613250800, 224849512, 224849521, 9, 1440x900 
0x37CA2318, 38092253613973008, 224849588, 224849596, 8, 1440x900 
0x37CA2318, 38092253614561584, 224849642, 224849650, 8, 1440x900 
0x37CA2318, 38092253615225376, 224849713, 224849721, 8, 1440x900 
0x37CA2318, 38092253616100496, 224849802, 224849810, 8, 1440x900 
0x37CA2318, 38092253616566272, 224849843, 224849850, 7, 1440x900 
0x37CA2318, 38092253617420632, 224849932, 224849943, 11, 1440x900 
0x37CA2318, 38092253618080640, 224849993, 224850001, 8, 1440x900 
0x37CA2318, 38092253618542912, 224850043, 224850050, 7, 1440x900 
0x37CA2318, 38092253619205952, 224850107, 224850115, 8, 1440x900 
0x37CA2318, 38092253620050896, 224850192, 224850199, 7, 1440x900 
0x37CA2318, 38092253620536264, 224850242, 224850250, 8, 1440x900 
0x37CA2318, 38092253621379592, 224850326, 224850334, 8, 1440x900 
0x37CA2318, 38092253622049648, 224850392, 224850400, 8, 1440x900 
0x37CA2318, 38092253622702280, 224850457, 224850465, 8, 1440x900 
0x37CA2318, 38092253623366400, 224850522, 224850530, 8, 1440x900 
0x37CA2318, 38092253624038056, 224850606, 224850617, 11, 1440x900 
0x37CA2318, 38092253624573704, 224850642, 224850651, 9, 1440x900 
0x37CA2318, 38092253625185800, 224850707, 224850714, 7, 1440x900 
0x37CA2318, 38092253625949528, 224850782, 224850801, 19, 1440x900 
0x37CA2318, 38092253626512920, 224850837, 224850846, 9, 1440x900 
0x37CA2318, 38092253627171344, 224850903, 224850912, 9, 1440x900 
0x37CA2318, 38092253627802600, 224850967, 224850976, 9, 1440x900 
0x37CA2318, 38092253628462208, 224851033, 224851040, 7, 1440x900 
0x37CA2318, 38092253629317360, 224851118, 224851126, 8, 1440x900 
0x37CA2318, 38092253629970288, 224851187, 224851195, 8, 1440x900 
0x37CA2318, 38092253630473936, 224851234, 224851256, 22, 1440x900 
0x37CA2318, 38092253631132816, 224851301, 224851308, 7, 1440x900 
0x37CA2318, 38092253631761360, 224851363, 224851370, 7, 1440x900 
0x37CA2318, 38092253632449736, 224851431, 224851438, 7, 1440x900 
0x37CA2318, 38092253633090696, 224851497, 224851504, 7, 1440x900 
0x37CA2318, 38092253633747416, 224851562, 224851569, 7, 1440x900 
0x37CA2318, 38092253634411896, 224851632, 224851640, 8, 1440x900 
0x37CA2318, 38092253635073424, 224851698, 224851705, 7, 1440x900 
0x37CA2318, 38092253635920744, 224851783, 224851791, 8, 1440x900 
0x37CA2318, 38092253636416792, 224851828, 224851835, 7, 1440x900 
0x37CA2318, 38092253637135032, 224851904, 224851912, 8, 1440x900 
0x37CA2318, 38092253637749760, 224851962, 224851969, 7, 1440x900 
0x37CA2318, 38092253638568528, 224852043, 224852050, 7, 1440x900 
0x37CA2318, 38092253639238200, 224852107, 224852115, 8, 1440x900 
0x37CA2318, 38092253639898704, 224852177, 224852184, 7, 1440x900 
0x37CA2318, 38092253640561288, 224852242, 224852250, 8, 1440x900 
0x37CA2318, 38092253641211336, 224852313, 224852320, 7, 1440x900 
0x37CA2318, 38092253641882200, 224852373, 224852381, 8, 1440x900 
0x37CA2318, 38092253642544032, 224852443, 224852451, 8, 1440x900 
0x37CA2318, 38092253643196808, 224852508, 224852516, 8, 1440x900 
0x37CA2318, 38092253643866512, 224852577, 224852585, 8, 1440x900 
0x37CA2318, 38092253644537096, 224852643, 224852651, 8, 1440x900 
0x37CA2318, 38092253645187856, 224852708, 224852716, 8, 1440x900 
0x37CA2318, 38092253645849680, 224852772, 224852780, 8, 1440x900 
0x37CA2318, 38092253646509672, 224852840, 224852848, 8, 1440x900 
0x37CA2318, 38092253647177528, 224852907, 224852914, 7, 1440x900 
0x37CA2318, 38092253647828064, 224852968, 224852976, 8, 1440x900 
0x37CA2318, 38092253648496952, 224853037, 224853044, 7, 1440x900 
0x37CA2318, 38092253649149504, 224853103, 224853111, 8, 1440x900 
0x37CA2318, 38092253649809936, 224853172, 224853180, 8, 1440x900 
0x37CA2318, 38092253650478872, 224853238, 224853247, 9, 1440x900 
0x37CA2318, 38092253651148672, 224853302, 224853309, 7, 1440x900 
0x37CA2318, 38092253651808928, 224853369, 224853378, 9, 1440x900 
0x37CA2318, 38092253652468296, 224853438, 224853446, 8, 1440x900 
0x37CA2318, 38092253653138600, 224853502, 224853511, 9, 1440x900 
0x37CA2318, 38092253653788584, 224853567, 224853576, 9, 1440x900 
0x37CA2318, 38092253654448784, 224853633, 224853641, 8, 1440x900 
0x37CA2318, 38092253655118152, 224853703, 224853711, 8, 1440x900 
0x37CA2318, 38092253655767872, 224853768, 224853776, 8, 1440x900 
0x37CA2318, 38092253656437048, 224853833, 224853842, 9, 1440x900 
0x37CA2318, 38092253657097440, 224853897, 224853905, 8, 1440x900 
0x37CA2318, 38092253657760688, 224853962, 224853970, 8, 1440x900 
0x37CA2318, 38092253658412392, 224854027, 224854035, 8, 1440x900 
0x37CA2318, 38092253659079656, 224854093, 224854101, 8, 1440x900 
0x37CA2318, 38092253659742224, 224854163, 224854171, 8, 1440x900 
0x37CA2318, 38092253660411424, 224854233, 224854241, 8, 1440x900 
0x37CA2318, 38092253661014016, 224854290, 224854298, 8, 1440x900 
0x37CA2318, 38092253661731928, 224854358, 224854366, 8, 1440x900 
0x37CA2318, 38092253662386000, 224854427, 224854434, 7, 1440x900 
0x37CA2318, 38092253663044440, 224854493, 224854500, 7, 1440x900 
0x37CA2318, 38092253663706104, 224854557, 224854564, 7, 1440x900 
0x37CA2318, 38092253664372368, 224854623, 224854630, 7, 1440x900 
0x37CA2318, 38092253665024264, 224854688, 224854695, 7, 1440x900 
0x37CA2318, 38092253665704080, 224854758, 224854765, 7, 1440x900 
0x37CA2318, 38092253666362800, 224854822, 224854829, 7, 1440x900 
0x37CA2318, 38092253666949416, 224854881, 224854888, 7, 1440x900 
0x37CA2318, 38092253667685632, 224854953, 224854960, 7, 1440x900 
0x37CA2318, 38092253668343648, 224855018, 224855026, 8, 1440x900 
0x37CA2318, 38092253669006800, 224855087, 224855095, 8, 1440x900 
0x37CA2318, 38092253669476176, 224855133, 224855140, 7, 1440x900 
0x37CA2318, 38092253670318256, 224855218, 224855226, 8, 1440x900 
0x37CA2318, 38092253670978608, 224855284, 224855291, 7, 1440x900 
0x37CA2318, 38092253671638984, 224855348, 224855356, 8, 1440x900 
0x37CA2318, 38092253672311080, 224855418, 224855426, 8, 1440x900 
0x37CA2318, 38092253672970728, 224855487, 224855495, 8, 1440x900 
0x37CA2318, 38092253673632992, 224855552, 224855559, 7, 1440x900 
0x37CA2318, 38092253674301872, 224855618, 224855626, 8, 1440x900 
0x37CA2318, 38092253674960816, 224855686, 224855693, 7, 1440x900 
0x37CA2318, 38092253675612056, 224855747, 224855755, 8, 1440x900 
0x37CA2318, 38092253676275456, 224855818, 224855826, 8, 1440x900 
0x37CA2318, 38092253676935408, 224855884, 224855892, 8, 1440x900 
0x37CA2318, 38092253677595704, 224855948, 224855955, 7, 1440x900 
0x37CA2318, 38092253678248336, 224856017, 224856025, 8, 1440x900 
0x37CA2318, 38092253678913064, 224856078, 224856087, 9, 1440x900 
0x37CA2318, 38092253679591928, 224856147, 224856156, 9, 1440x900 
0x37CA2318, 38092253680242688, 224856213, 224856221, 8, 1440x900 
0x37CA2318, 38092253680903856, 224856279, 224856287, 8, 1440x900 
0x37CA2318, 38092253681564992, 224856348, 224856356, 8, 1440x900 
0x37CA2318, 38092253682226416, 224856413, 224856421, 8, 1440x900 
0x37CA2318, 38092253682877568, 224856473, 224856481, 8, 1440x900 
0x37CA2318, 38092253683557200, 224856543, 224856553, 10, 1440x900 
0x37CA2318, 38092253684694632, 224856657, 224856665, 8, 1440x900 
0x37CA2318, 38092253685527264, 224856738, 224856746, 8, 1440x900 
0x37CA2318, 38092253686188024, 224856803, 224856810, 7, 1440x900 
0x37CA2318, 38092253686858160, 224856878, 224856887, 9, 1440x900 
0x37CA2318, 38092253687352456, 224856923, 224856933, 10, 1440x900 
0x37CA2318, 38092253687985632, 224856986, 224856995, 9, 1440x900 
0x37CA2318, 38092253688649648, 224857052, 224857060, 8, 1440x900 
0x37CA2318, 38092253689312760, 224857118, 224857127, 9, 1440x900 
0x37CA2318, 38092253689986968, 224857187, 224857195, 8, 1440x900 
0x37CA2318, 38092253690645088, 224857251, 224857259, 8, 1440x900 
0x37CA2318, 38092253691290608, 224857317, 224857325, 8, 1440x900 
0x37CA2318, 38092253691977832, 224857383, 224857391, 8, 1440x900 
0x37CA2318, 38092253692608136, 224857447, 224857455, 8, 1440x900 
0x37CA2318, 38092253693264608, 224857512, 224857519, 7, 1440x900 
0x37CA2318, 38092253694109096, 224857599, 224857607, 8, 1440x900 
0x37CA2318, 38092253694788240, 224857667, 224857674, 7, 1440x900 
0x37CA2318, 38092253695440080, 224857733, 224857740, 7, 1440x900 
0x37CA2318, 38092253696101016, 224857797, 224857803, 6, 1440x900 
0x37CA2318, 38092253696759856, 224857862, 224857868, 6, 1440x900 
0x37CA2318, 38092253697413720, 224857928, 224857934, 6, 1440x900 
0x37CA2318, 38092253697891072, 224857974, 224857982, 8, 1440x900 
0x37CA2318, 38092253698744472, 224858062, 224858069, 7, 1440x900 
0x37CA2318, 38092253699404656, 224858127, 224858134, 7, 1440x900 
0x37CA2318, 38092253700067264, 224858193, 224858202, 9, 1440x900 
0x37CA2318, 38092253700738544, 224858274, 224858281, 7, 1440x900 
0x37CA2318, 38092253701394808, 224858328, 224858337, 9, 1440x900 
0x37CA2318, 38092253701895288, 224858378, 224858386, 8, 1440x900 
0x37CA2318, 38092253702528488, 224858438, 224858445, 7, 1440x900 
0x37CA2318, 38092253703189336, 224858503, 224858510, 7, 1440x900 
0x37CA2318, 38092253703850360, 224858572, 224858579, 7, 1440x900 
0x37CA2318, 38092253704512952, 224858635, 224858644, 9, 1440x900 
0x37CA2318, 38092253705170832, 224858703, 224858711, 8, 1440x900 
0x37CA2318, 38092253705831120, 224858768, 224858776, 8, 1440x900 
0x37CA2318, 38092253706489712, 224858833, 224858841, 8, 1440x900 
0x37CA2318, 38092253707152728, 224858902, 224858910, 8, 1440x900 
0x37CA2318, 38092253707813408, 224858967, 224858974, 7, 1440x900 
0x37CA2318, 38092253708474496, 224859033, 224859041, 8, 1440x900 
0x37CA2318, 38092253709135664, 224859098, 224859105, 7, 1440x900 
0x37CA2318, 38092253709792888, 224859167, 224859174, 7, 1440x900 
0x37CA2318, 38092253710453752, 224859233, 224859240, 7, 1440x900 
0x37CA2318, 38092253711113376, 224859298, 224859305, 7, 1440x900 
0x37CA2318, 38092253711781848, 224859363, 224859371, 8, 1440x900 
0x37CA2318, 38092253712441992, 224859428, 224859437, 9, 1440x900 
0x37CA2318, 38092253713109944, 224859498, 224859506, 8, 1440x900 
0x37CA2318, 38092253713781160, 224859564, 224859572, 8, 1440x900 
0x37CA2318, 38092253714439952, 224859628, 224859636, 8, 1440x900 
0x37CA2318, 38092253715287904, 224859713, 224859721, 8, 1440x900 
0x37CA2318, 38092253715958496, 224859782, 224859789, 7, 1440x900 
0x37CA2318, 38092253716621864, 224859847, 224859855, 8, 1440x900 
0x37CA2318, 38092253717272048, 224859912, 224859919, 7, 1440x900 
0x37CA2318, 38092253717943176, 224859977, 224859985, 8, 1440x900 
0x37CA2318, 38092253718603304, 224860047, 224860054, 7, 1440x900 
0x37CA2318, 38092253719255880, 224860113, 224860122, 9, 1440x900 
0x37CA2318, 38092253719935224, 224860184, 224860193, 9, 1440x900 
0x37CA2318, 38092253720584552, 224860253, 224860261, 8, 1440x900 
0x37CA2318, 38092253721256368, 224860314, 224860322, 8, 1440x900 
0x37CA2318, 38092253721916912, 224860379, 224860389, 10, 1440x900 
0x37CA2318, 38092253722587512, 224860448, 224860457, 9, 1440x900 
0x37CA2318, 38092253723245840, 224860512, 224860519, 7, 1440x900 
0x37CA2318, 38092253723897088, 224860576, 224860583, 7, 1440x900 
0x37CA2318, 38092253724557368, 224860643, 224860650, 7, 1440x900 
0x37CA2318, 38092253725219520, 224860713, 224860721, 8, 1440x900 
0x37CA2318, 38092253725890416, 224860783, 224860790, 7, 1440x900 
0x37CA2318, 38092253726548784, 224860842, 224860849, 7, 1440x900 
0x37CA2318, 38092253727209528, 224860907, 224860914, 7, 1440x900 
0x37CA2318, 38092253727861856, 224860972, 224860980, 8, 1440x900 
0x37CA2318, 38092253728518128, 224861042, 224861049, 7, 1440x900 
0x37CA2318, 38092253729187088, 224861107, 224861116, 9, 1440x900 
0x37CA2318, 38092253729858296, 224861177, 224861185, 8, 1440x900 
0x37CA2318, 38092253730518248, 224861243, 224861251, 8, 1440x900 
0x37CA2318, 38092253731186544, 224861307, 224861314, 7, 1440x900 
0x37CA2318, 38092253731837080, 224861369, 224861377, 8, 1440x900 
0x37CA2318, 38092253732507488, 224861437, 224861444, 7, 1440x900 
0x37CA2318, 38092253732965392, 224861481, 224861488, 7, 1440x900 
0x37CA2318, 38092253733810056, 224861567, 224861574, 7, 1440x900 
0x37CA2318, 38092253734485088, 224861637, 224861644, 7, 1440x900 
0x37CA2318, 38092253735136640, 224861701, 224861708, 7, 1440x900 
0x37CA2318, 38092253735806208, 224861767, 224861774, 7, 1440x900 
0x37CA2318, 38092253736468768, 224861834, 224861844, 10, 1440x900 
0x37CA2318, 38092253736925720, 224861878, 224861886, 8, 1440x900 
0x37CA2318, 38092253737779152, 224861963, 224861971, 8, 1440x900 
0x37CA2318, 38092253738440000, 224862028, 224862036, 8, 1440x900 
0x37CA2318, 38092253739101272, 224862097, 224862104, 7, 1440x900 
0x37CA2318, 38092253739762072, 224862162, 224862169, 7, 1440x900 
0x37CA2318, 38092253740423824, 224862228, 224862235, 7, 1440x900 
0x37CA2318, 38092253740888840, 224862273, 224862282, 9, 1440x900 
0x37CA2318, 38092253741549224, 224862342, 224862349, 7, 1440x900 
0x37CA2318, 38092253742210416, 224862407, 224862414, 7, 1440x900 
0x37CA2318, 38092253742879088, 224862473, 224862481, 8, 1440x900 
0x37CA2318, 38092253743728064, 224862563, 224862571, 8, 1440x900 
0x37CA2318, 38092253744398552, 224862628, 224862636, 8, 1440x900 
0x37CA2318, 38092253745068176, 224862698, 224862706, 8, 1440x900 
0x37CA2318, 38092253745729488, 224862764, 224862772, 8, 1440x900 
0x37CA2318, 38092253746380416, 224862827, 224862835, 8, 1440x900 
0x37CA2318, 38092253747042712, 224862893, 224862903, 10, 1440x900 
0x37CA2318, 38092253747701840, 224862957, 224862965, 8, 1440x900 
0x37CA2318, 38092253748371672, 224863026, 224863033, 7, 1440x900 
0x37CA2318, 38092253749024312, 224863088, 224863096, 8, 1440x900 
0x37CA2318, 38092253749688664, 224863157, 224863165, 8, 1440x900 
0x37CA2318, 38092253750841416, 224863272, 224863280, 8, 1440x900 
0x37CA2318, 38092253751663776, 224863353, 224863361, 8, 1440x900 
0x37CA2318, 38092253752333248, 224863418, 224863426, 8, 1440x900 
0x37CA2318, 38092253752993152, 224863487, 224863495, 8, 1440x900 
0x37CA2318, 38092253753642304, 224863553, 224863561, 8, 1440x900 
0x37CA2318, 38092253754314904, 224863623, 224863631, 8, 1440x900 
0x37CA2318, 38092253754969496, 224863683, 224863690, 7, 1440x900 
0x37CA2318, 38092253755625200, 224863748, 224863768, 20, 1440x900 
0x37CA2318, 38092253756124368, 224863798, 224863806, 8, 1440x900 
0x37CA2318, 38092253756945680, 224863882, 224863889, 7, 1440x900 
0x37CA2318, 38092253757606800, 224863948, 224863956, 8, 1440x900 
0x37CA2318, 38092253758275840, 224864018, 224864025, 7, 1440x900 
0x37CA2318, 38092253758936312, 224864083, 224864091, 8, 1440x900 
0x37CA2318, 38092253759595480, 224864147, 224864154, 7, 1440x900 
0x37CA2318, 38092253760263568, 224864212, 224864219, 7, 1440x900 
0x37CA2318, 38092253760915232, 224864277, 224864284, 7, 1440x900 
0x37CA2318, 38092253761575760, 224864343, 224864351, 8, 1440x900 
0x37CA2318, 38092253762236104, 224864411, 224864418, 7, 1440x900 
0x37CA2318, 38092253762888064, 224864480, 224864488, 8, 1440x900 
0x37CA2318, 38092253763561168, 224864543, 224864551, 8, 1440x900 
0x37CA2318, 38092253764221992, 224864613, 224864621, 8, 1440x900 
0x37CA2318, 38092253764891352, 224864677, 224864684, 7, 1440x900 
0x37CA2318, 38092253765562816, 224864747, 224864755, 8, 1440x900 
0x37CA2318, 38092253766213776, 224864808, 224864816, 8, 1440x900 
0x37CA2318, 38092253766883344, 224864878, 224864886, 8, 1440x900 
0x37CA2318, 38092253767551376, 224864942, 224864950, 8, 1440x900 
0x37CA2318, 38092253768220288, 224865014, 224865021, 7, 1440x900 
0x37CA2318, 38092253768873712, 224865072, 224865080, 8, 1440x900 
0x37CA2318, 38092253769537216, 224865142, 224865149, 7, 1440x900 
0x37CA2318, 38092253770198400, 224865208, 224865217, 9, 1440x900 
0x37CA2318, 38092253770861768, 224865277, 224865285, 8, 1440x900 
0x37CA2318, 38092253771519400, 224865343, 224865351, 8, 1440x900 
0x37CA2318, 38092253772185696, 224865408, 224865416, 8, 1440x900 
0x37CA2318, 38092253772854088, 224865473, 224865481, 8, 1440x900 
0x37CA2318, 38092253773506416, 224865542, 224865551, 9, 1440x900 
0x37CA2318, 38092253774166808, 224865608, 224865616, 8, 1440x900 
0x37CA2318, 38092253774831360, 224865671, 224865679, 8, 1440x900 
0x37CA2318, 38092253775491136, 224865733, 224865741, 8, 1440x900 
0x37CA2318, 38092253776146232, 224865808, 224865816, 8, 1440x900 
0x37CA2318, 38092253776805248, 224865867, 224865873, 6, 1440x900 
0x37CA2318, 38092253777475712, 224865933, 224865941, 8, 1440x900 
0x37CA2318, 38092253778128264, 224866003, 224866010, 7, 1440x900 
0x37CA2318, 38092253778798648, 224866067, 224866074, 7, 1440x900 
0x37CA2318, 38092253779441648, 224866133, 224866141, 8, 1440x900 
0x37CA2318, 38092253780121208, 224866199, 224866207, 8, 1440x900 
0x37CA2318, 38092253780780576, 224866268, 224866276, 8, 1440x900 
0x37CA2318, 38092253781435592, 224866333, 224866341, 8, 1440x900 
0x37CA2318, 38092253782106400, 224866403, 224866411, 8, 1440x900 
0x37CA2318, 38092253782758656, 224866463, 224866472, 9, 1440x900 
0x37CA2318, 38092253783411160, 224866532, 224866540, 8, 1440x900 
0x37CA2318, 38092253784081184, 224866598, 224866606, 8, 1440x900 
0x37CA2318, 38092253784740640, 224866662, 224866669, 7, 1440x900 
0x37CA2318, 38092253785401344, 224866727, 224866734, 7, 1440x900 
0x37CA2318, 38092253786062928, 224866792, 224866800, 8, 1440x900 
0x37CA2318, 38092253786731264, 224866859, 224866866, 7, 1440x900 
0x37CA2318, 38092253787390448, 224866922, 224866930, 8, 1440x900 
0x37CA2318, 38092253788059968, 224866993, 224866999, 6, 1440x900 
0x37CA2318, 38092253788720008, 224867057, 224867064, 7, 1440x900 
0x37CA2318, 38092253789370432, 224867123, 224867129, 6, 1440x900 
0x37CA2318, 38092253790029880, 224867188, 224867196, 8, 1440x900 
0x37CA2318, 38092253790699456, 224867256, 224867263, 7, 1440x900 
0x37CA2318, 38092253791354968, 224867323, 224867330, 7, 1440x900 
0x37CA2318, 38092253792015296, 224867388, 224867396, 8, 1440x900 
0x37CA2318, 38092253792676384, 224867452, 224867460, 8, 1440x900 
0x37CA2318, 38092253793337864, 224867518, 224867526, 8, 1440x900 
0x37CA2318, 38092253793996568, 224867587, 224867594, 7, 1440x900 
0x37CA2318, 38092253794659200, 224867652, 224867660, 8, 1440x900 
0x37CA2318, 38092253795328232, 224867718, 224867726, 8, 1440x900 
0x37CA2318, 38092253795976640, 224867783, 224867790, 7, 1440x900 
0x37CA2318, 38092253796647552, 224867852, 224867859, 7, 1440x900 
0x37CA2318, 38092253797309208, 224867917, 224867924, 7, 1440x900 
0x37CA2318, 38092253797969720, 224867983, 224867991, 8, 1440x900 
0x37CA2318, 38092253798708656, 224868058, 224868066, 8, 1440x900 
0x37CA2318, 38092253799288184, 224868117, 224868124, 7, 1440x900 
0x37CA2318, 38092253799959688, 224868182, 224868189, 7, 1440x900 
0x37CA2318, 38092253800686200, 224868253, 224868263, 10, 1440x900 
0x37CA2318, 38092253801287608, 224868313, 224868323, 10, 1440x900 
0x37CA2318, 38092253801954128, 224868383, 224868389, 6, 1440x900 
0x37CA2318, 38092253802614952, 224868457, 224868465, 8, 1440x900 
0x37CA2318, 38092253803274656, 224868512, 224868520, 8, 1440x900 
0x37CA2318, 38092253803925864, 224868578, 224868586, 8, 1440x900 
0x37CA2318, 38092253804591464, 224868651, 224868659, 8, 1440x900 
0x37CA2318, 38092253805264696, 224868718, 224868726, 8, 1440x900 
0x37CA2318, 38092253805916848, 224868782, 224868790, 8, 1440x900 
0x37CA2318, 38092253806584920, 224868848, 224868857, 9, 1440x900 
0x37CA2318, 38092253807237744, 224868908, 224868916, 8, 1440x900 
0x37CA2318, 38092253807898760, 224868977, 224868984, 7, 1440x900 
0x37CA2318, 38092253808559912, 224869046, 224869054, 8, 1440x900 
0x37CA2318, 38092253809219392, 224869108, 224869115, 7, 1440x900 
0x37CA2318, 38092253809880512, 224869174, 224869182, 8, 1440x900 
0x37CA2318, 38092253810547632, 224869242, 224869249, 7, 1440x900 
0x37CA2318, 38092253811199480, 224869312, 224869320, 8, 1440x900 
0x37CA2318, 38092253811859312, 224869373, 224869381, 8, 1440x900 
0x37CA2318, 38092253812522488, 224869438, 224869447, 9, 1440x900 
0x37CA2318, 38092253813186168, 224869508, 224869516, 8, 1440x900 
0x37CA2318, 38092253814401888, 224869627, 224869634, 7, 1440x900 
0x37CA2318, 38092253814966344, 224869683, 224869691, 8, 1440x900 
0x37CA2318, 38092253815627272, 224869749, 224869756, 7, 1440x900 
0x37CA2318, 38092253816430560, 224869829, 224869839, 10, 1440x900 
0x37CA2318, 38092253816982224, 224869883, 224869890, 7, 1440x900 
0x37CA2318, 38092253817637144, 224869947, 224869956, 9, 1440x900 
0x37CA2318, 38092253818266864, 224870013, 224870020, 7, 1440x900 
0x37CA2318, 38092253818936936, 224870082, 224870090, 8, 1440x900 
0x37CA2318, 38092253819598632, 224870147, 224870154, 7, 1440x900 
0x37CA2318, 38092253820264360, 224870213, 224870221, 8, 1440x900 
0x37CA2318, 38092253820936944, 224870277, 224870285, 8, 1440x900 
0x37CA2318, 38092253821586152, 224870342, 224870350, 8, 1440x900 
0x37CA2318, 38092253822241792, 224870412, 224870419, 7, 1440x900 
0x37CA2318, 38092253822901648, 224870477, 224870484, 7, 1440x900 
0x37CA2318, 38092253823765328, 224870563, 224870570, 7, 1440x900 
0x37CA2318, 38092253824435472, 224870633, 224870640, 7, 1440x900 
0x37CA2318, 38092253825084024, 224870694, 224870702, 8, 1440x900 
0x37CA2318, 38092253825554504, 224870741, 224870748, 7, 1440x900 
0x37CA2318, 38092253826233664, 224870808, 224870816, 8, 1440x900 
0x37CA2318, 38092253827078728, 224870892, 224870901, 9, 1440x900 
0x37CA2318, 38092253827738640, 224870958, 224870966, 8, 1440x900 
0x37CA2318, 38092253828408656, 224871027, 224871035, 8, 1440x900 
0x37CA2318, 38092253829007344, 224871087, 224871094, 7, 1440x900 
0x37CA2318, 38092253829540880, 224871142, 224871149, 7, 1440x900 
0x37CA2318, 38092253830183280, 224871203, 224871211, 8, 1440x900 
0x37CA2318, 38092253830844128, 224871271, 224871278, 7, 1440x900 
0x37CA2318, 38092253831507240, 224871337, 224871344, 7, 1440x900 
0x37CA2318, 38092253832163792, 224871402, 224871409, 7, 1440x900 
0x37CA2318, 38092253833006768, 224871487, 224871494, 7, 1440x900 
0x37CA2318, 38092253833493616, 224871533, 224871541, 8, 1440x900 
0x37CA2318, 38092253834155680, 224871601, 224871609, 8, 1440x900 
0x37CA2318, 38092253834815792, 224871668, 224871675, 7, 1440x900 
0x37CA2318, 38092253835476288, 224871733, 224871740, 7, 1440x900 
0x37CA2318, 38092253836166304, 224871809, 224871818, 9, 1440x900 
0x37CA2318, 38092253837003264, 224871888, 224871895, 7, 1440x900 
0x37CA2318, 38092253837455424, 224871932, 224871939, 7, 1440x900 
0x37CA2318, 38092253838137328, 224871998, 224872006, 8, 1440x900 
0x37CA2318, 38092253838964064, 224872083, 224872092, 9, 1440x900 
0x37CA2318, 38092253839471680, 224872133, 224872139, 6, 1440x900 
0x37CA2318, 38092253840106024, 224872197, 224872203, 6, 1440x900 
0x37CA2318, 38092253840767760, 224872264, 224872270, 6, 1440x900 
0x37CA2318, 38092253841431152, 224872328, 224872336, 8, 1440x900 
0x37CA2318, 38092253842085568, 224872393, 224872401, 8, 1440x900 
0x37CA2318, 38092253842945376, 224872482, 224872489, 7, 1440x900 
0x37CA2318, 38092253843597056, 224872546, 224872553, 7, 1440x900 
0x37CA2318, 38092253844271864, 224872612, 224872619, 7, 1440x900 
0x37CA2318, 38092253844734920, 224872657, 224872665, 8, 1440x900 
0x37CA2318, 38092253845601864, 224872746, 224872753, 7, 1440x900 
0x37CA2318, 38092253846144504, 224872801, 224872808, 7, 1440x900 
0x37CA2318, 38092253846915512, 224872878, 224872887, 9, 1440x900 
0x37CA2318, 38092253847575648, 224872943, 224872952, 9, 1440x900 
0x37CA2318, 38092253848236928, 224873012, 224873020, 8, 1440x900 
0x37CA2318, 38092253848889368, 224873078, 224873087, 9, 1440x900 
0x37CA2318, 38092253849560392, 224873144, 224873151, 7, 1440x900 
0x37CA2318, 38092253850222176, 224873213, 224873222, 9, 1440x900 
0x37CA2318, 38092253850890520, 224873277, 224873284, 7, 1440x900 
0x37CA2318, 38092253851545520, 224873342, 224873351, 9, 1440x900 
0x37CA2318, 38092253852164208, 224873403, 224873417, 14, 1440x900 
0x37CA2318, 38092253852778792, 224873470, 224873482, 12, 1440x900 
0x37CA2318, 38092253853530368, 224873560, 224873572, 12, 1440x900 
0x37CA2318, 38092253854104752, 224873598, 224873604, 6, 1440x900 
0x37CA2318, 38092253854777432, 224873663, 224873673, 10, 1440x900 
0x37CA2318, 38092253855504824, 224873737, 224873744, 7, 1440x900 
0x37CA2318, 38092253856175208, 224873803, 224873811, 8, 1440x900 
0x37CA2318, 38092253856835280, 224873871, 224873885, 14, 1440x900 
0x37CA2318, 38092253857375048, 224873937, 224873949, 12, 1440x900 
0x37CA2318, 38092253858015656, 224873992, 224874001, 9, 1440x900 
0x37CA2318, 38092253858678496, 224874057, 224874067, 10, 1440x900 
0x37CA2318, 38092253859314944, 224874117, 224874125, 8, 1440x900 
0x37CA2318, 38092253859975904, 224874183, 224874191, 8, 1440x900 
0x37CA2318, 38092253860631872, 224874248, 224874255, 7, 1440x900 
0x37CA2318, 38092253861291080, 224874318, 224874325, 7, 1440x900 
0x37CA2318, 38092253861978912, 224874382, 224874390, 8, 1440x900 
0x37CA2318, 38092253862775232, 224874463, 224874471, 8, 1440x900 
0x37CA2318, 38092253863455696, 224874532, 224874539, 7, 1440x900 
0x37CA2318, 38092253864115632, 224874597, 224874605, 8, 1440x900 
0x37CA2318, 38092253864809064, 224874666, 224874676, 10, 1440x900 
0x37CA2318, 38092253865230176, 224874707, 224874718, 11, 1440x900 
0x37CA2318, 38092253865894472, 224874777, 224874783, 6, 1440x900 
0x37CA2318, 38092253866745088, 224874862, 224874870, 8, 1440x900 
0x37CA2318, 38092253867225136, 224874908, 224874917, 9, 1440x900 
0x37CA2318, 38092253867880768, 224874973, 224874981, 8, 1440x900 
0x37CA2318, 38092253868549936, 224875043, 224875050, 7, 1440x900 
0x37CA2318, 38092253869214832, 224875108, 224875117, 9, 1440x900 
0x37CA2318, 38092253869902416, 224875177, 224875183, 6, 1440x900 
0x37CA2318, 38092253870726720, 224875258, 224875265, 7, 1440x900 
0x37CA2318, 38092253871379800, 224875323, 224875331, 8, 1440x900 
0x37CA2318, 38092253872050384, 224875391, 224875400, 9, 1440x900 
0x37CA2318, 38092253872519216, 224875438, 224875445, 7, 1440x900 
0x37CA2318, 38092253873182560, 224875503, 224875511, 8, 1440x900 
0x37CA2318, 38092253873842696, 224875572, 224875579, 7, 1440x900 
0x37CA2318, 38092253874704976, 224875659, 224875667, 8, 1440x900 
0x37CA2318, 38092253875355696, 224875727, 224875735, 8, 1440x900 
0x37CA2318, 38092253876009360, 224875792, 224875800, 8, 1440x900 
0x37CA2318, 38092253876687512, 224875856, 224875864, 8, 1440x900 
0x37CA2318, 38092253877367088, 224875922, 224875929, 7, 1440x900 
0x37CA2318, 38092253878017184, 224875988, 224875995, 7, 1440x900 
0x37CA2318, 38092253878669168, 224876053, 224876060, 7, 1440x900 
0x37CA2318, 38092253879340544, 224876124, 224876132, 8, 1440x900 
0x37CA2318, 38092253880000408, 224876187, 224876195, 8, 1440x900 
0x37CA2318, 38092253880660984, 224876252, 224876259, 7, 1440x900 
0x37CA2318, 38092253881311984, 224876322, 224876330, 8, 1440x900 
0x37CA2318, 38092253881982696, 224876388, 224876396, 8, 1440x900 
0x37CA2318, 38092253882646816, 224876458, 224876466, 8, 1440x900 
0x37CA2318, 38092253883306000, 224876517, 224876524, 7, 1440x900 
0x37CA2318, 38092253883967400, 224876583, 224876589, 6, 1440x900 
0x37CA2318, 38092253884629184, 224876648, 224876655, 7, 1440x900 
0x37CA2318, 38092253885287440, 224876718, 224876726, 8, 1440x900 
0x37CA2318, 38092253886603256, 224876848, 224876853, 5, 1440x900 
0x37CA2318, 38092253887263568, 224876914, 224876920, 6, 1440x900 
0x37CA2318, 38092253887859056, 224876972, 224876979, 7, 1440x900 
0x37CA2318, 38092253888592760, 224877043, 224877050, 7, 1440x900 
0x37CA2318, 38092253889254568, 224877112, 224877118, 6, 1440x900 
0x37CA2318, 38092253889921984, 224877178, 224877185, 7, 1440x900 
0x37CA2318, 38092253890584640, 224877247, 224877254, 7, 1440x900 
0x37CA2318, 38092253891245856, 224877313, 224877321, 8, 1440x900 
0x37CA2318, 38092253891902352, 224877377, 224877384, 7, 1440x900 
0x37CA2318, 38092253892571672, 224877443, 224877450, 7, 1440x900 
0x37CA2318, 38092253893222016, 224877508, 224877515, 7, 1440x900 
0x37CA2318, 38092253893885040, 224877579, 224877587, 8, 1440x900 
0x37CA2318, 38092253894538080, 224877643, 224877651, 8, 1440x900 
0x37CA2318, 38092253895209280, 224877709, 224877716, 7, 1440x900 
0x37CA2318, 38092253895879712, 224877778, 224877786, 8, 1440x900 
0x37CA2318, 38092253896524112, 224877841, 224877850, 9, 1440x900 
0x37CA2318, 38092253897187088, 224877906, 224877914, 8, 1440x900 
0x37CA2318, 38092253897852192, 224877972, 224877980, 8, 1440x900 
0x37CA2318, 38092253898512208, 224878038, 224878045, 7, 1440x900 
0x37CA2318, 38092253899166680, 224878107, 224878115, 8, 1440x900 
0x37CA2318, 38092253899837144, 224878173, 224878181, 8, 1440x900 
0x37CA2318, 38092253900487576, 224878233, 224878241, 8, 1440x900 
0x37CA2318, 38092253901149872, 224878307, 224878315, 8, 1440x900 
0x37CA2318, 38092253901816096, 224878374, 224878382, 8, 1440x900 
0x37CA2318, 38092253902466640, 224878438, 224878446, 8, 1440x900 
0x37CA2318, 38092253903137864, 224878503, 224878511, 8, 1440x900 
0x37CA2318, 38092253903797848, 224878568, 224878576, 8, 1440x900 
0x37CA2318, 38092253904459968, 224878637, 224878645, 8, 1440x900 
0x37CA2318, 38092253905112984, 224878698, 224878707, 9, 1440x900 
0x37CA2318, 38092253905792032, 224878768, 224878776, 8, 1440x900 
0x37CA2318, 38092253906442928, 224878828, 224878837, 9, 1440x900 
0x37CA2318, 38092253907100120, 224878897, 224878904, 7, 1440x900 
0x37CA2318, 38092253907760768, 224878962, 224878971, 9, 1440x900 
0x37CA2318, 38092253908429168, 224879033, 224879041, 8, 1440x900 
0x37CA2318, 38092253909089112, 224879097, 224879105, 8, 1440x900 
0x37CA2318, 38092253909750776, 224879162, 224879170, 8, 1440x900 
0x37CA2318, 38092253910411856, 224879228, 224879237, 9, 1440x900 
0x37CA2318, 38092253911080648, 224879297, 224879305, 8, 1440x900 
0x37CA2318, 38092253911744160, 224879364, 224879372, 8, 1440x900 
0x37CA2318, 38092253912393848, 224879428, 224879436, 8, 1440x900 
0x37CA2318, 38092253913054696, 224879493, 224879500, 7, 1440x900 
0x37CA2318, 38092253913710016, 224879562, 224879570, 8, 1440x900 
0x37CA2318, 38092253914371888, 224879624, 224879632, 8, 1440x900 
0x37CA2318, 38092253915040816, 224879693, 224879701, 8, 1440x900 
0x37CA2318, 38092253915703112, 224879757, 224879766, 9, 1440x900 
0x37CA2318, 38092253916361936, 224879827, 224879835, 8, 1440x900 
0x37CA2318, 38092253917021616, 224879893, 224879901, 8, 1440x900 
0x37CA2318, 38092253917682960, 224879958, 224879966, 8, 1440x900 
0x37CA2318, 38092253918334920, 224880022, 224880030, 8, 1440x900 
0x37CA2318, 38092253918996224, 224880087, 224880096, 9, 1440x900 
0x37CA2318, 38092253919493240, 224880143, 224880151, 8, 1440x900 
0x37CA2318, 38092253920127024, 224880203, 224880210, 7, 1440x900 
0x37CA2318, 38092253920780752, 224880263, 224880271, 8, 1440x900 
0x37CA2318, 38092253921442896, 224880333, 224880342, 9, 1440x900 
0x37CA2318, 38092253922160000, 224880406, 224880415, 9, 1440x900 
0x37CA2318, 38092253922794664, 224880467, 224880474, 7, 1440x900 
0x37CA2318, 38092253923441240, 224880528, 224880536, 8, 1440x900 
0x37CA2318, 38092253924131864, 224880597, 224880605, 8, 1440x900 
0x37CA2318, 38092253924761120, 224880663, 224880669, 6, 1440x900 
0x37CA2318, 38092253925435848, 224880728, 224880736, 8, 1440x900 
0x37CA2318, 38092253926081200, 224880793, 224880801, 8, 1440x900 
0x37CA2318, 38092253926754328, 224880863, 224880871, 8, 1440x900 
0x37CA2318, 38092253927571024, 224880942, 224880950, 8, 1440x900 
0x37CA2318, 38092253928073592, 224880993, 224881001, 8, 1440x900 
0x37CA2318, 38092253928736112, 224881063, 224881070, 7, 1440x900 
0x37CA2318, 38092253929580608, 224881148, 224881158, 10, 1440x900 
0x37CA2318, 38092253930068568, 224881193, 224881201, 8, 1440x900 
0x37CA2318, 38092253930712240, 224881257, 224881265, 8, 1440x900 
0x37CA2318, 38092253931425552, 224881328, 224881336, 8, 1440x900 
0x37CA2318, 38092253932037904, 224881393, 224881400, 7, 1440x900 
0x37CA2318, 38092253932697736, 224881458, 224881465, 7, 1440x900 
0x37CA2318, 38092253933358096, 224881523, 224881531, 8, 1440x900 
0x37CA2318, 38092253934017840, 224881588, 224881596, 8, 1440x900 
0x37CA2318, 38092253934677776, 224881653, 224881661, 8, 1440x900 
0x37CA2318, 38092253935348592, 224881723, 224881732, 9, 1440x900 
0x37CA2318, 38092253936020080, 224881789, 224881797, 8, 1440x900 
0x37CA2318, 38092253936662384, 224881851, 224881859, 8, 1440x900 
0x37CA2318, 38092253937321632, 224881917, 224881925, 8, 1440x900 
0x37CA2318, 38092253937983136, 224881987, 224881994, 7, 1440x900 
0x37CA2318, 38092253938643392, 224882052, 224882059, 7, 1440x900 
0x37CA2318, 38092253939302504, 224882116, 224882123, 7, 1440x900 
0x37CA2318, 38092253939964472, 224882182, 224882189, 7, 1440x900 
0x37CA2318, 38092253940624576, 224882248, 224882256, 8, 1440x900 
0x37CA2318, 38092253941282984, 224882313, 224882321, 8, 1440x900 
0x37CA2318, 38092253941942992, 224882382, 224882390, 8, 1440x900 
0x37CA2318, 38092253942604624, 224882447, 224882454, 7, 1440x900 
0x37CA2318, 38092253943934904, 224882582, 224882590, 8, 1440x900 
0x37CA2318, 38092253944593296, 224882648, 224882656, 8, 1440x900 
0x37CA2318, 38092253945250008, 224882712, 224882722, 10, 1440x900 
0x37CA2318, 38092253945906096, 224882777, 224882785, 8, 1440x900 
0x37CA2318, 38092253946570096, 224882843, 224882851, 8, 1440x900 
0x37CA2318, 38092253947229912, 224882908, 224882916, 8, 1440x900 
0x37CA2318, 38092253947895664, 224882977, 224882984, 7, 1440x900 
0x37CA2318, 38092253948558432, 224883048, 224883057, 9, 1440x900 
0x37CA2318, 38092253949218016, 224883113, 224883121, 8, 1440x900 
0x37CA2318, 38092253949873576, 224883178, 224883185, 7, 1440x900 
0x37CA2318, 38092253950535184, 224883243, 224883251, 8, 1440x900 
0x37CA2318, 38092253951193168, 224883308, 224883315, 7, 1440x900 
0x37CA2318, 38092253951849952, 224883371, 224883379, 8, 1440x900 
0x37CA2318, 38092253952514000, 224883437, 224883445, 8, 1440x900 
0x37CA2318, 38092253953174968, 224883503, 224883512, 9, 1440x900 
0x37CA2318, 38092253953834480, 224883573, 224883581, 8, 1440x900 
0x37CA2318, 38092253954497176, 224883636, 224883644, 8, 1440x900 
0x37CA2318, 38092253955167064, 224883704, 224883712, 8, 1440x900 
0x37CA2318, 38092253955824064, 224883768, 224883777, 9, 1440x900 
0x37CA2318, 38092253956500816, 224883836, 224883844, 8, 1440x900 
0x37CA2318, 38092253957407904, 224883928, 224883936, 8, 1440x900 
0x37CA2318, 38092253958017096, 224883988, 224883995, 7, 1440x900 
0x37CA2318, 38092253958669912, 224884052, 224884072, 20, 1440x900 
0x37CA2318, 38092253959239728, 224884119, 224884143, 24, 1440x900 
0x37CA2318, 38092253959932568, 224884180, 224884199, 19, 1440x900 
0x37CA2318, 38092253960550584, 224884238, 224884246, 8, 1440x900 
0x37CA2318, 38092253961167048, 224884302, 224884322, 20, 1440x900 
0x37CA2318, 38092253961886472, 224884373, 224884383, 10, 1440x900 
0x37CA2318, 38092253962488392, 224884437, 224884455, 18, 1440x900 
0x37CA2318, 38092253963242816, 224884509, 224884526, 17, 1440x900 
0x37CA2318, 38092253963808256, 224884566, 224884573, 7, 1440x900 
0x37CA2318, 38092253964555064, 224884643, 224884649, 6, 1440x900 
0x37CA2318, 38092253965178296, 224884705, 224884726, 21, 1440x900 
0x37CA2318, 38092253965879632, 224884775, 224884785, 10, 1440x900 
0x37CA2318, 38092253966454696, 224884832, 224884839, 7, 1440x900 
0x37CA2318, 38092253967109608, 224884899, 224884908, 9, 1440x900 
0x37CA2318, 38092253967793840, 224884973, 224884992, 19, 1440x900 
0x37CA2318, 38092253968443504, 224885035, 224885045, 10, 1440x900 
0x37CA2318, 38092253969099400, 224885100, 224885111, 11, 1440x900 
0x37CA2318, 38092253969755744, 224885164, 224885179, 15, 1440x900 
0x37CA2318, 38092253970412640, 224885227, 224885234, 7, 1440x900 
0x37CA2318, 38092253971078176, 224885309, 224885316, 7, 1440x900 
0x37CA2318, 38092253971736216, 224885360, 224885370, 10, 1440x900 
0x37CA2318, 38092253972399808, 224885428, 224885437, 9, 1440x900 
0x37CA2318, 38092253973056096, 224885492, 224885502, 10, 1440x900 
0x37CA2318, 38092253973725608, 224885562, 224885578, 16, 1440x900 
0x37CA2318, 38092253974384656, 224885623, 224885642, 19, 1440x900 
0x37CA2318, 38092253975069440, 224885694, 224885702, 8, 1440x900 
0x37CA2318, 38092253975747528, 224885763, 224885773, 10, 1440x900 
0x37CA2318, 38092253976425272, 224885832, 224885842, 10, 1440x900 
0x37CA2318, 38092253977103168, 224885905, 224885913, 8, 1440x900 
0x37CA2318, 38092253977759352, 224885965, 224885982, 17, 1440x900 
0x37CA2318, 38092253978380760, 224886023, 224886042, 19, 1440x900 
0x37CA2318, 38092253979073272, 224886093, 224886101, 8, 1440x900 
0x37CA2318, 38092253979739104, 224886158, 224886166, 8, 1440x900 
0x37CA2318, 38092253980406080, 224886228, 224886236, 8, 1440x900 
0x37CA2318, 38092253981098000, 224886301, 224886312, 11, 1440x900 
0x37CA2318, 38092253981762432, 224886364, 224886380, 16, 1440x900 
0x37CA2318, 38092253982348272, 224886422, 224886440, 18, 1440x900 
0x37CA2318, 38092253983023024, 224886488, 224886509, 21, 1440x900 
0x37CA2318, 38092253983741712, 224886558, 224886566, 8, 1440x900 
0x37CA2318, 38092253984410728, 224886628, 224886637, 9, 1440x900 
0x37CA2318, 38092253985080168, 224886693, 224886702, 9, 1440x900 
0x37CA2318, 38092253985655416, 224886752, 224886759, 7, 1440x900 
0x37CA2318, 38092253986321936, 224886818, 224886826, 8, 1440x900 
0x37CA2318, 38092253987000400, 224886887, 224886896, 9, 1440x900 
0x37CA2318, 38092253987673936, 224886958, 224886967, 9, 1440x900 
0x37CA2318, 38092253988333992, 224887033, 224887038, 5, 1440x900 
0x37CA2318, 38092253988964704, 224887097, 224887105, 8, 1440x900 
0x37CA2318, 38092253989623552, 224887155, 224887164, 9, 1440x900 
0x37CA2318, 38092253990290408, 224887213, 224887221, 8, 1440x900 
0x37CA2318, 38092253990949208, 224887282, 224887290, 8, 1440x900 
0x37CA2318, 38092253991618400, 224887348, 224887355, 7, 1440x900 
0x37CA2318, 38092253992279968, 224887414, 224887430, 16, 1440x900 
0x37CA2318, 38092253992934376, 224887483, 224887491, 8, 1440x900 
0x37CA2318, 38092253993604544, 224887550, 224887565, 15, 1440x900 
0x37CA2318, 38092253994259848, 224887616, 224887630, 14, 1440x900 
0x37CA2318, 38092253994919832, 224887678, 224887685, 7, 1440x900 
0x37CA2318, 38092253995593792, 224887748, 224887755, 7, 1440x900 
0x37CA2318, 38092253996257144, 224887814, 224887823, 9, 1440x900 
0x37CA2318, 38092253996929368, 224887878, 224887899, 21, 1440x900 
0x37CA2318, 38092253997563184, 224887943, 224887951, 8, 1440x900 
0x37CA2318, 38092253998223088, 224888007, 224888025, 18, 1440x900 
0x37CA2318, 38092253998926600, 224888078, 224888087, 9, 1440x900 
0x37CA2318, 38092253999543416, 224888142, 224888161, 19, 1440x900 
0x37CA2318, 38092254000263352, 224888212, 224888220, 8, 1440x900 
0x37CA2318, 38092254000945232, 224888284, 224888297, 13, 1440x900 
0x37CA2318, 38092254001537584, 224888338, 224888346, 8, 1440x900 
0x37CA2318, 38092254002194424, 224888403, 224888411, 8, 1440x900 
0x37CA2318, 38092254002951480, 224888482, 224888490, 8, 1440x900 
0x37CA2318, 38092254003529536, 224888538, 224888548, 10, 1440x900 
0x37CA2318, 38092254004186880, 224888607, 224888616, 9, 1440x900 
0x37CA2318, 38092254004837648, 224888668, 224888675, 7, 1440x900 
0x37CA2318, 38092254005502128, 224888738, 224888745, 7, 1440x900 
0x37CA2318, 38092254006171336, 224888803, 224888810, 7, 1440x900 
0x37CA2318, 38092254006846176, 224888878, 224888885, 7, 1440x900 
0x37CA2318, 38092254007485016, 224888940, 224888951, 11, 1440x900 
0x37CA2318, 38092254008159336, 224889008, 224889039, 31, 1440x900 
0x37CA2318, 38092254008800800, 224889070, 224889083, 13, 1440x900 
0x37CA2318, 38092254009463944, 224889133, 224889139, 6, 1440x900 
0x37CA2318, 38092254010119832, 224889197, 224889205, 8, 1440x900 
0x37CA2318, 38092254010785408, 224889263, 224889271, 8, 1440x900 
0x37CA2318, 38092254011491144, 224889333, 224889341, 8, 1440x900 
0x37CA2318, 38092254012129264, 224889401, 224889415, 14, 1440x900 
0x37CA2318, 38092254012799224, 224889467, 224889483, 16, 1440x900 
0x37CA2318, 38092254013448552, 224889528, 224889536, 8, 1440x900 
0x37CA2318, 38092254014148040, 224889600, 224889608, 8, 1440x900 
0x37CA2318, 38092254014784792, 224889662, 224889672, 10, 1440x900 
0x37CA2318, 38092254015448640, 224889728, 224889737, 9, 1440x900 
0x37CA2318, 38092254016114264, 224889798, 224889807, 9, 1440x900 
0x37CA2318, 38092254016776360, 224889864, 224889873, 9, 1440x900 
0x37CA2318, 38092254017434608, 224889927, 224889947, 20, 1440x900 
0x37CA2318, 38092254018117664, 224889997, 224890005, 8, 1440x900 
0x37CA2318, 38092254018784784, 224890063, 224890072, 9, 1440x900 
0x37CA2318, 38092254019459856, 224890134, 224890142, 8, 1440x900 
0x37CA2318, 38092254020132792, 224890201, 224890209, 8, 1440x900 
0x37CA2318, 38092254021412096, 224890328, 224890345, 17, 1440x900 
0x37CA2318, 38092254022137504, 224890398, 224890418, 20, 1440x900 
0x37CA2318, 38092254022794912, 224890463, 224890471, 8, 1440x900 
0x37CA2318, 38092254023461064, 224890532, 224890541, 9, 1440x900 
0x37CA2318, 38092254024122840, 224890597, 224890605, 8, 1440x900 
0x37CA2318, 38092254024805024, 224890670, 224890684, 14, 1440x900 
0x37CA2318, 38092254025370672, 224890722, 224890729, 7, 1440x900 
0x37CA2318, 38092254026038184, 224890788, 224890796, 8, 1440x900 
0x37CA2318, 38092254026698112, 224890857, 224890866, 9, 1440x900 
0x37CA2318, 38092254027372248, 224890928, 224890937, 9, 1440x900 
0x37CA2318, 38092254028051768, 224891000, 224891008, 8, 1440x900 
0x37CA2318, 38092254028668368, 224891052, 224891060, 8, 1440x900 
0x37CA2318, 38092254029337136, 224891117, 224891125, 8, 1440x900 
0x37CA2318, 38092254029997312, 224891186, 224891193, 7, 1440x900 
0x37CA2318, 38092254030670272, 224891253, 224891260, 7, 1440x900 
0x37CA2318, 38092254031322624, 224891317, 224891326, 9, 1440x900 
0x37CA2318, 38092254031983936, 224891387, 224891394, 7, 1440x900 
0x37CA2318, 38092254032640280, 224891448, 224891468, 20, 1440x900 
0x37CA2318, 38092254033300912, 224891513, 224891521, 8, 1440x900 
0x37CA2318, 38092254033962736, 224891584, 224891602, 18, 1440x900 
0x37CA2318, 38092254034631912, 224891648, 224891657, 9, 1440x900 
0x37CA2318, 38092254035283072, 224891713, 224891732, 19, 1440x900 
0x37CA2318, 38092254035985440, 224891783, 224891801, 18, 1440x900 
0x37CA2318, 38092254036695296, 224891864, 224891873, 9, 1440x900 
0x37CA2318, 38092254037381400, 224891938, 224891946, 8, 1440x900 
0x37CA2318, 38092254038014112, 224891994, 224892004, 10, 1440x900 
0x37CA2318, 38092254038680464, 224892056, 224892063, 7, 1440x900 
0x37CA2318, 38092254039354744, 224892124, 224892132, 8, 1440x900 
0x37CA2318, 38092254040013704, 224892188, 224892196, 8, 1440x900 
0x37CA2318, 38092254040662880, 224892253, 224892261, 8, 1440x900 
0x37CA2318, 38092254041330512, 224892318, 224892327, 9, 1440x900 
0x37CA2318, 38092254042012744, 224892396, 224892414, 18, 1440x900 
0x37CA2318, 38092254042677672, 224892463, 224892473, 10, 1440x900 
0x37CA2318, 38092254043325056, 224892518, 224892525, 7, 1440x900 
0x37CA2318, 38092254043986800, 224892587, 224892595, 8, 1440x900 
0x37CA2318, 38092254044647976, 224892655, 224892664, 9, 1440x900 
0x37CA2318, 38092254045303384, 224892718, 224892735, 17, 1440x900 
0x37CA2318, 38092254046023912, 224892796, 224892808, 12, 1440x900 
0x37CA2318, 38092254046660088, 224892852, 224892859, 7, 1440x900 
0x37CA2318, 38092254047522240, 224892940, 224892950, 10, 1440x900 
0x37CA2318, 38092254048036656, 224892999, 224893008, 9, 1440x900 
0x37CA2318, 38092254048681528, 224893054, 224893061, 7, 1440x900 
0x37CA2318, 38092254049321792, 224893119, 224893126, 7, 1440x900 
0x37CA2318, 38092254049981072, 224893184, 224893192, 8, 1440x900 
0x37CA2318, 38092254050647200, 224893253, 224893261, 8, 1440x900 
0x37CA2318, 38092254051303016, 224893317, 224893324, 7, 1440x900 
0x37CA2318, 38092254051963648, 224893382, 224893390, 8, 1440x900 
0x37CA2318, 38092254052621208, 224893447, 224893455, 8, 1440x900 
0x37CA2318, 38092254053282392, 224893513, 224893521, 8, 1440x900 
0x37CA2318, 38092254053942056, 224893578, 224893586, 8, 1440x900 
0x37CA2318, 38092254054602168, 224893647, 224893654, 7, 1440x900 
0x37CA2318, 38092254055270856, 224893713, 224893725, 12, 1440x900 
0x37CA2318, 38092254056054192, 224893791, 224893799, 8, 1440x900 
0x37CA2318, 38092254056595568, 224893847, 224893854, 7, 1440x900 
0x37CA2318, 38092254057261816, 224893912, 224893920, 8, 1440x900 
0x37CA2318, 38092254058084832, 224893997, 224894007, 10, 1440x900 
0x37CA2318, 38092254058655920, 224894052, 224894059, 7, 1440x900 
0x37CA2318, 38092254059559376, 224894143, 224894151, 8, 1440x900 
0x37CA2318, 38092254060033440, 224894192, 224894208, 16, 1440x900 
0x37CA2318, 38092254060699664, 224894258, 224894268, 10, 1440x900 
0x37CA2318, 38092254061298800, 224894319, 224894336, 17, 1440x900 
0x37CA2318, 38092254061997480, 224894384, 224894393, 9, 1440x900 
0x37CA2318, 38092254062619656, 224894449, 224894457, 8, 1440x900 
0x37CA2318, 38092254063350008, 224894525, 224894539, 14, 1440x900 
0x37CA2318, 38092254064030768, 224894593, 224894605, 12, 1440x900 
0x37CA2318, 38092254064603936, 224894646, 224894655, 9, 1440x900 
0x37CA2318, 38092254065271360, 224894713, 224894721, 8, 1440x900 
0x37CA2318, 38092254065928704, 224894777, 224894786, 9, 1440x900 
0x37CA2318, 38092254066601560, 224894849, 224894866, 17, 1440x900 
0x37CA2318, 38092254067335944, 224894918, 224894926, 8, 1440x900 
0x37CA2318, 38092254067911008, 224894978, 224894985, 7, 1440x900 
0x37CA2318, 38092254068583232, 224895043, 224895051, 8, 1440x900 
0x37CA2318, 38092254069238128, 224895112, 224895120, 8, 1440x900 
0x37CA2318, 38092254069929192, 224895183, 224895192, 9, 1440x900 
0x37CA2318, 38092254070570752, 224895247, 224895257, 10, 1440x900 
0x37CA2318, 38092254071214744, 224895315, 224895325, 10, 1440x900 
0x37CA2318, 38092254071888464, 224895379, 224895387, 8, 1440x900 
0x37CA2318, 38092254072578136, 224895442, 224895450, 8, 1440x900 
0x37CA2318, 38092254073225136, 224895508, 224895516, 8, 1440x900 
0x37CA2318, 38092254073885976, 224895574, 224895582, 8, 1440x900 
0x37CA2318, 38092254074544416, 224895649, 224895660, 11, 1440x900 
0x37CA2318, 38092254075202304, 224895708, 224895715, 7, 1440x900 
0x37CA2318, 38092254075871800, 224895773, 224895780, 7, 1440x900 
0x37CA2318, 38092254076531496, 224895841, 224895849, 8, 1440x900 
0x37CA2318, 38092254077191568, 224895904, 224895912, 8, 1440x900 
0x37CA2318, 38092254077861040, 224895976, 224895983, 7, 1440x900 
0x37CA2318, 38092254078521832, 224896038, 224896048, 10, 1440x900 
0x37CA2318, 38092254079185144, 224896106, 224896114, 8, 1440x900 
0x37CA2318, 38092254079841240, 224896173, 224896199, 26, 1440x900 
0x37CA2318, 38092254080526568, 224896238, 224896247, 9, 1440x900 
0x37CA2318, 38092254081189848, 224896304, 224896312, 8, 1440x900 
0x37CA2318, 38092254081824688, 224896368, 224896376, 8, 1440x900 
0x37CA2318, 38092254082546512, 224896444, 224896457, 13, 1440x900 
0x37CA2318, 38092254083277568, 224896513, 224896523, 10, 1440x900 
0x37CA2318, 38092254083842352, 224896575, 224896591, 16, 1440x900 
0x37CA2318, 38092254084563536, 224896642, 224896650, 8, 1440x900 
0x37CA2318, 38092254085247288, 224896708, 224896719, 11, 1440x900 
0x37CA2318, 38092254085889776, 224896787, 224896795, 8, 1440x900 
0x37CA2318, 38092254086516240, 224896866, 224896878, 12, 1440x900 
0x37CA2318, 38092254087229640, 224896908, 224896916, 8, 1440x900 
0x37CA2318, 38092254087979344, 224896982, 224896992, 10, 1440x900 
0x37CA2318, 38092254088563800, 224897053, 224897061, 8, 1440x900 
0x37CA2318, 38092254089239184, 224897109, 224897116, 7, 1440x900 
0x37CA2318, 38092254089792600, 224897167, 224897176, 9, 1440x900 
0x37CA2318, 38092254090534856, 224897238, 224897247, 9, 1440x900 
0x37CA2318, 38092254091194960, 224897307, 224897314, 7, 1440x900 
0x37CA2318, 38092254091790056, 224897383, 224897391, 8, 1440x900 
0x37CA2318, 38092254092525216, 224897437, 224897447, 10, 1440x900 
0x37CA2318, 38092254093092448, 224897496, 224897503, 7, 1440x900 
0x37CA2318, 38092254093767736, 224897563, 224897572, 9, 1440x900 
0x37CA2318, 38092254094448248, 224897631, 224897638, 7, 1440x900 
0x37CA2318, 38092254095107096, 224897703, 224897711, 8, 1440x900 
0x37CA2318, 38092254095745976, 224897765, 224897776, 11, 1440x900 
0x37CA2318, 38092254096407792, 224897833, 224897845, 12, 1440x900 
0x37CA2318, 38092254097205824, 224897910, 224897921, 11, 1440x900 
0x37CA2318, 38092254097745088, 224897965, 224897978, 13, 1440x900 
0x37CA2318, 38092254098393736, 224898027, 224898034, 7, 1440x900 
0x37CA2318, 38092254099058320, 224898093, 224898101, 8, 1440x900 
0x37CA2318, 38092254099726424, 224898158, 224898166, 8, 1440x900 
0x37CA2318, 38092254100545968, 224898245, 224898252, 7, 1440x900 
0x37CA2318, 38092254101206464, 224898308, 224898314, 6, 1440x900 
0x37CA2318, 38092254101866400, 224898372, 224898380, 8, 1440x900 
0x37CA2318, 38092254102518224, 224898440, 224898451, 11, 1440x900 
0x37CA2318, 38092254103199184, 224898507, 224898514, 7, 1440x900 
0x37CA2318, 38092254103855136, 224898574, 224898581, 7, 1440x900 
0x37CA2318, 38092254104524336, 224898637, 224898647, 10, 1440x900 
0x37CA2318, 38092254104996184, 224898683, 224898693, 10, 1440x900 
0x37CA2318, 38092254105659824, 224898752, 224898759, 7, 1440x900 
0x37CA2318, 38092254106455344, 224898833, 224898843, 10, 1440x900 
0x37CA2318, 38092254107013600, 224898887, 224898897, 10, 1440x900 
0x37CA2318, 38092254107773072, 224898963, 224898970, 7, 1440x900 
0x37CA2318, 38092254108498104, 224899033, 224899044, 11, 1440x900 
0x37CA2318, 38092254109154128, 224899102, 224899109, 7, 1440x900 
0x37CA2318, 38092254109816144, 224899168, 224899176, 8, 1440x900 
0x37CA2318, 38092254110477080, 224899237, 224899245, 8, 1440x900 
0x37CA2318, 38092254111148488, 224899303, 224899312, 9, 1440x900 
0x37CA2318, 38092254111797512, 224899367, 224899374, 7, 1440x900 
0x37CA2318, 38092254112518768, 224899443, 224899451, 8, 1440x900 
0x37CA2318, 38092254113187992, 224899503, 224899515, 12, 1440x900 
0x37CA2318, 38092254113848544, 224899573, 224899581, 8, 1440x900 
0x37CA2318, 38092254114512456, 224899636, 224899645, 9, 1440x900 
0x37CA2318, 38092254115160672, 224899702, 224899709, 7, 1440x900 
0x37CA2318, 38092254115830936, 224899772, 224899780, 8, 1440x900 
0x37CA2318, 38092254116491720, 224899838, 224899847, 9, 1440x900 
0x37CA2318, 38092254117152896, 224899903, 224899912, 9, 1440x900 
0x37CA2318, 38092254117621896, 224899949, 224899957, 8, 1440x900 
0x37CA2318, 38092254118273776, 224900013, 224900020, 7, 1440x900 
0x37CA2318, 38092254118946952, 224900082, 224900089, 7, 1440x900 
0x37CA2318, 38092254119597264, 224900147, 224900155, 8, 1440x900 
0x37CA2318, 38092254120257128, 224900213, 224900225, 12, 1440x900 
0x37CA2318, 38092254120921416, 224900278, 224900287, 9, 1440x900 
0x37CA2318, 38092254121577792, 224900342, 224900350, 8, 1440x900 
0x37CA2318, 38092254122433248, 224900428, 224900436, 8, 1440x900 
0x37CA2318, 38092254122893568, 224900473, 224900481, 8, 1440x900 
0x37CA2318, 38092254124215912, 224900607, 224900616, 9, 1440x900 
0x37CA2318, 38092254124887440, 224900672, 224900680, 8, 1440x900 
0x37CA2318, 38092254125729760, 224900758, 224900766, 8, 1440x900 
0x37CA2318, 38092254126204880, 224900808, 224900814, 6, 1440x900 
0x37CA2318, 38092254126867424, 224900872, 224900880, 8, 1440x900 
0x37CA2318, 38092254127729368, 224900962, 224900970, 8, 1440x900 
0x37CA2318, 38092254128330760, 224901023, 224901030, 7, 1440x900 
0x37CA2318, 38092254128948880, 224901082, 224901089, 7, 1440x900 
0x37CA2318, 38092254129519368, 224901139, 224901150, 11, 1440x900 
0x37CA2318, 38092254130175080, 224901203, 224901210, 7, 1440x900 
0x37CA2318, 38092254131028160, 224901288, 224901297, 9, 1440x900 
0x37CA2318, 38092254131507712, 224901339, 224901346, 7, 1440x900 
0x37CA2318, 38092254132346032, 224901422, 224901430, 8, 1440x900 
0x37CA2318, 38092254133005920, 224901487, 224901494, 7, 1440x900 
0x37CA2318, 38092254133665848, 224901553, 224901561, 8, 1440x900 
0x37CA2318, 38092254134328752, 224901622, 224901629, 7, 1440x900 
0x37CA2318, 38092254134992760, 224901687, 224901696, 9, 1440x900 
0x37CA2318, 38092254135476144, 224901733, 224901741, 8, 1440x900 
0x37CA2318, 38092254136314280, 224901818, 224901825, 7, 1440x900 
0x37CA2318, 38092254136973592, 224901883, 224901890, 7, 1440x900 
0x37CA2318, 38092254137642568, 224901947, 224901956, 9, 1440x900 
0x37CA2318, 38092254138312352, 224902014, 224902022, 8, 1440x900 
0x37CA2318, 38092254138972160, 224902082, 224902089, 7, 1440x900 
0x37CA2318, 38092254139623176, 224902147, 224902155, 8, 1440x900 
0x37CA2318, 38092254140293160, 224902218, 224902226, 8, 1440x900 
0x37CA2318, 38092254140763672, 224902263, 224902271, 8, 1440x900 
0x37CA2318, 38092254141613272, 224902348, 224902355, 7, 1440x900 
0x37CA2318, 38092254142267928, 224902417, 224902425, 8, 1440x900 
0x37CA2318, 38092254142925264, 224902482, 224902490, 8, 1440x900 
0x37CA2318, 38092254143589576, 224902543, 224902551, 8, 1440x900 
0x37CA2318, 38092254144247680, 224902611, 224902618, 7, 1440x900 
0x37CA2318, 38092254144849904, 224902673, 224902680, 7, 1440x900 
0x37CA2318, 38092254145385392, 224902728, 224902738, 10, 1440x900 
0x37CA2318, 38092254146043272, 224902788, 224902796, 8, 1440x900 
0x37CA2318, 38092254146691776, 224902857, 224902864, 7, 1440x900 
0x37CA2318, 38092254147544592, 224902942, 224902950, 8, 1440x900 
0x37CA2318, 38092254148011904, 224902988, 224902995, 7, 1440x900 
0x37CA2318, 38092254148694336, 224903056, 224903063, 7, 1440x900 
0x37CA2318, 38092254149330256, 224903118, 224903126, 8, 1440x900 
0x37CA2318, 38092254150180440, 224903203, 224903211, 8, 1440x900 
0x37CA2318, 38092254150865184, 224903274, 224903284, 10, 1440x900 
0x37CA2318, 38092254151504856, 224903339, 224903346, 7, 1440x900 
0x37CA2318, 38092254151982304, 224903383, 224903392, 9, 1440x900 
0x37CA2318, 38092254152662120, 224903452, 224903460, 8, 1440x900 
0x37CA2318, 38092254153302616, 224903518, 224903525, 7, 1440x900 
0x37CA2318, 38092254153974712, 224903582, 224903589, 7, 1440x900 
0x37CA2318, 38092254154620720, 224903648, 224903655, 7, 1440x900 
0x37CA2318, 38092254155287600, 224903717, 224903726, 9, 1440x900 
0x37CA2318, 38092254155951632, 224903783, 224903791, 8, 1440x900 
0x37CA2318, 38092254156619528, 224903852, 224903860, 8, 1440x900 
0x37CA2318, 38092254157373008, 224903923, 224903931, 8, 1440x900 
0x37CA2318, 38092254157943824, 224903978, 224903990, 12, 1440x900 
0x37CA2318, 38092254158605712, 224904049, 224904058, 9, 1440x900 
0x37CA2318, 38092254159261160, 224904112, 224904123, 11, 1440x900 
0x37CA2318, 38092254159925480, 224904178, 224904186, 8, 1440x900 
0x37CA2318, 38092254160773520, 224904265, 224904273, 8, 1440x900 
0x37CA2318, 38092254161432728, 224904327, 224904335, 8, 1440x900 
0x37CA2318, 38092254162094664, 224904398, 224904405, 7, 1440x900 
0x37CA2318, 38092254162756136, 224904463, 224904473, 10, 1440x900 
0x37CA2318, 38092254163234776, 224904512, 224904520, 8, 1440x900 
0x37CA2318, 38092254164085584, 224904597, 224904606, 9, 1440x900 
0x37CA2318, 38092254164740072, 224904663, 224904671, 8, 1440x900 
0x37CA2318, 38092254165420392, 224904732, 224904739, 7, 1440x900 
0x37CA2318, 38092254166057728, 224904793, 224904800, 7, 1440x900 
0x37CA2318, 38092254166717528, 224904861, 224904869, 8, 1440x900 
0x37CA2318, 38092254167376312, 224904922, 224904929, 7, 1440x900 
0x37CA2318, 38092254168048024, 224904992, 224904999, 7, 1440x900 
0x37CA2318, 38092254168518328, 224905038, 224905046, 8, 1440x900 
0x37CA2318, 38092254169367688, 224905127, 224905142, 15, 1440x900 
0x37CA2318, 38092254170020256, 224905197, 224905206, 9, 1440x900 
0x37CA2318, 38092254170678016, 224905253, 224905261, 8, 1440x900 
0x37CA2318, 38092254171340160, 224905322, 224905330, 8, 1440x900 
0x37CA2318, 38092254172000640, 224905386, 224905394, 8, 1440x900 
0x37CA2318, 38092254172662672, 224905453, 224905462, 9, 1440x900 
0x37CA2318, 38092254173329896, 224905522, 224905530, 8, 1440x900 
0x37CA2318, 38092254173799416, 224905567, 224905574, 7, 1440x900 
0x37CA2318, 38092254174652192, 224905652, 224905659, 7, 1440x900 
0x37CA2318, 38092254175304856, 224905717, 224905724, 7, 1440x900 
0x37CA2318, 38092254175959872, 224905787, 224905795, 8, 1440x900 
0x37CA2318, 38092254176620536, 224905848, 224905855, 7, 1440x900 
0x37CA2318, 38092254177292336, 224905917, 224905925, 8, 1440x900 
0x37CA2318, 38092254177953720, 224905988, 224905997, 9, 1440x900 
0x37CA2318, 38092254178609632, 224906047, 224906054, 7, 1440x900 
0x37CA2318, 38092254179086400, 224906097, 224906104, 7, 1440x900 
0x37CA2318, 38092254179931384, 224906178, 224906187, 9, 1440x900 
0x37CA2318, 38092254180588240, 224906248, 224906256, 8, 1440x900 
0x37CA2318, 38092254181259496, 224906314, 224906323, 9, 1440x900 
0x37CA2318, 38092254181909472, 224906377, 224906396, 19, 1440x900 
0x37CA2318, 38092254182578848, 224906443, 224906450, 7, 1440x900 
0x37CA2318, 38092254183239592, 224906511, 224906518, 7, 1440x900 
0x37CA2318, 38092254183899992, 224906577, 224906584, 7, 1440x900 
0x37CA2318, 38092254185214968, 224906712, 224906720, 8, 1440x900 
0x37CA2318, 38092254185876664, 224906777, 224906785, 8, 1440x900 
0x37CA2318, 38092254186555704, 224906849, 224906857, 8, 1440x900 
0x37CA2318, 38092254187214664, 224906907, 224906915, 8, 1440x900 
0x37CA2318, 38092254187721040, 224906957, 224906965, 8, 1440x900 
0x37CA2318, 38092254188543920, 224907043, 224907050, 7, 1440x900 
0x37CA2318, 38092254189018464, 224907089, 224907095, 6, 1440x900 
0x37CA2318, 38092254189866888, 224907173, 224907181, 8, 1440x900 
0x37CA2318, 38092254190570296, 224907249, 224907257, 8, 1440x900 
0x37CA2318, 38092254191187512, 224907303, 224907311, 8, 1440x900 
0x37CA2318, 38092254191847760, 224907377, 224907385, 8, 1440x900 
0x37CA2318, 38092254192518656, 224907438, 224907447, 9, 1440x900 
0x37CA2318, 38092254193177912, 224907507, 224907515, 8, 1440x900 
0x37CA2318, 38092254193839568, 224907584, 224907593, 9, 1440x900 
0x37CA2318, 38092254194304688, 224907617, 224907624, 7, 1440x900 
0x37CA2318, 38092254195158136, 224907702, 224907709, 7, 1440x900 
0x37CA2318, 38092254195826304, 224907768, 224907776, 8, 1440x900 
0x37CA2318, 38092254196479584, 224907839, 224907848, 9, 1440x900 
0x37CA2318, 38092254197044296, 224907891, 224907898, 7, 1440x900 
0x37CA2318, 38092254197792528, 224907968, 224907977, 9, 1440x900 
0x37CA2318, 38092254198267936, 224908013, 224908021, 8, 1440x900 
0x37CA2318, 38092254198938360, 224908078, 224908086, 8, 1440x900 
0x37CA2318, 38092254199598112, 224908148, 224908155, 7, 1440x900 
0x37CA2318, 38092254200268128, 224908214, 224908223, 9, 1440x900 
0x37CA2318, 38092254201106000, 224908298, 224908305, 7, 1440x900 
0x37CA2318, 38092254201589984, 224908348, 224908356, 8, 1440x900 
0x37CA2318, 38092254202428120, 224908433, 224908441, 8, 1440x900 
0x37CA2318, 38092254202905848, 224908477, 224908485, 8, 1440x900 
0x37CA2318, 38092254203747568, 224908562, 224908570, 8, 1440x900 
0x37CA2318, 38092254204409296, 224908633, 224908641, 8, 1440x900 
0x37CA2318, 38092254204889928, 224908678, 224908686, 8, 1440x900 
0x37CA2318, 38092254205549912, 224908743, 224908750, 7, 1440x900 
0x37CA2318, 38092254206382576, 224908828, 224908837, 9, 1440x900 
0x37CA2318, 38092254206866288, 224908872, 224908879, 7, 1440x900 
0x37CA2318, 38092254207713544, 224908958, 224908966, 8, 1440x900 
0x37CA2318, 38092254208374096, 224909024, 224909032, 8, 1440x900 
0x37CA2318, 38092254209034560, 224909092, 224909100, 8, 1440x900 
0x37CA2318, 38092254209506304, 224909138, 224909145, 7, 1440x900 
0x37CA2318, 38092254210348688, 224909223, 224909231, 8, 1440x900 
0x37CA2318, 38092254211008496, 224909288, 224909296, 8, 1440x900 
0x37CA2318, 38092254211671056, 224909358, 224909367, 9, 1440x900 
0x37CA2318, 38092254212154536, 224909407, 224909415, 8, 1440x900 
0x37CA2318, 38092254213000128, 224909490, 224909498, 8, 1440x900 
0x37CA2318, 38092254213658216, 224909554, 224909562, 8, 1440x900 
0x37CA2318, 38092254214134920, 224909602, 224909610, 8, 1440x900 
0x37CA2318, 38092254214971144, 224909683, 224909691, 8, 1440x900 
0x37CA2318, 38092254215603656, 224909748, 224909757, 9, 1440x900 
0x37CA2318, 38092254216300360, 224909819, 224909828, 9, 1440x900 
0x37CA2318, 38092254216771064, 224909862, 224909871, 9, 1440x900 
0x37CA2318, 38092254217613160, 224909953, 224909961, 8, 1440x900 
0x37CA2318, 38092254218273832, 224910017, 224910025, 8, 1440x900 
0x37CA2318, 38092254218943952, 224910084, 224910093, 9, 1440x900 
0x37CA2318, 38092254219593808, 224910143, 224910152, 9, 1440x900 
0x37CA2318, 38092254220253976, 224910213, 224910220, 7, 1440x900 
0x37CA2318, 38092254220914736, 224910278, 224910285, 7, 1440x900 
0x37CA2318, 38092254221574160, 224910343, 224910350, 7, 1440x900 
0x37CA2318, 38092254222106728, 224910397, 224910404, 7, 1440x900 
0x37CA2318, 38092254222888880, 224910473, 224910481, 8, 1440x900 
0x37CA2318, 38092254223559296, 224910542, 224910549, 7, 1440x900 
0x37CA2318, 38092254224222256, 224910607, 224910616, 9, 1440x900 
0x37CA2318, 38092254224694704, 224910653, 224910661, 8, 1440x900 
0x37CA2318, 38092254225534248, 224910738, 224910746, 8, 1440x900 
0x37CA2318, 38092254226196096, 224910812, 224910820, 8, 1440x900 
0x37CA2318, 38092254226866840, 224910878, 224910886, 8, 1440x900 
0x37CA2318, 38092254227352176, 224910928, 224910937, 9, 1440x900 
0x37CA2318, 38092254228185736, 224911007, 224911014, 7, 1440x900 
0x37CA2318, 38092254228855736, 224911070, 224911081, 11, 1440x900 
0x37CA2318, 38092254229324448, 224911118, 224911126, 8, 1440x900 
0x37CA2318, 38092254230103456, 224911196, 224911204, 8, 1440x900 
0x37CA2318, 38092254230822000, 224911268, 224911275, 7, 1440x900 
0x37CA2318, 38092254231496648, 224911338, 224911348, 10, 1440x900 
0x37CA2318, 38092254231965008, 224911383, 224911390, 7, 1440x900 
0x37CA2318, 38092254232814128, 224911467, 224911475, 8, 1440x900 
0x37CA2318, 38092254233475272, 224911538, 224911546, 8, 1440x900 
0x37CA2318, 38092254234128720, 224911603, 224911611, 8, 1440x900 
0x37CA2318, 38092254234790736, 224911667, 224911675, 8, 1440x900 
0x37CA2318, 38092254235470120, 224911733, 224911740, 7, 1440x900 
0x37CA2318, 38092254236131112, 224911803, 224911811, 8, 1440x900 
0x37CA2318, 38092254236800816, 224911868, 224911876, 8, 1440x900 
0x37CA2318, 38092254237266552, 224911913, 224911919, 6, 1440x900 
0x37CA2318, 38092254238119360, 224911997, 224912005, 8, 1440x900 
0x37CA2318, 38092254238788760, 224912068, 224912075, 7, 1440x900 
0x37CA2318, 38092254239246232, 224912112, 224912119, 7, 1440x900 
0x37CA2318, 38092254240108160, 224912197, 224912204, 7, 1440x900 
0x37CA2318, 38092254240759512, 224912262, 224912269, 7, 1440x900 
0x37CA2318, 38092254241429664, 224912333, 224912342, 9, 1440x900 
0x37CA2318, 38092254242089760, 224912396, 224912404, 8, 1440x900 
0x37CA2318, 38092254242740688, 224912461, 224912468, 7, 1440x900 
0x37CA2318, 38092254243411104, 224912527, 224912534, 7, 1440x900 
0x37CA2318, 38092254243993696, 224912586, 224912594, 8, 1440x900 
0x37CA2318, 38092254244752360, 224912666, 224912675, 9, 1440x900 
0x37CA2318, 38092254245877104, 224912773, 224912781, 8, 1440x900 
0x37CA2318, 38092254246526472, 224912838, 224912846, 8, 1440x900 
0x37CA2318, 38092254247192496, 224912917, 224912925, 8, 1440x900 
0x37CA2318, 38092254247849400, 224912973, 224912981, 8, 1440x900 
0x37CA2318, 38092254248506560, 224913037, 224913045, 8, 1440x900 
0x37CA2318, 38092254249169064, 224913102, 224913110, 8, 1440x900 
0x37CA2318, 38092254249830176, 224913167, 224913175, 8, 1440x900 
0x37CA2318, 38092254250498152, 224913237, 224913247, 10, 1440x900 
0x37CA2318, 38092254251154480, 224913303, 224913311, 8, 1440x900 
0x37CA2318, 38092254251815656, 224913368, 224913376, 8, 1440x900 
0x37CA2318, 38092254252474752, 224913433, 224913441, 8, 1440x900 
0x37CA2318, 38092254253138448, 224913501, 224913509, 8, 1440x900 
0x37CA2318, 38092254253795368, 224913567, 224913575, 8, 1440x900 
0x37CA2318, 38092254254454952, 224913633, 224913641, 8, 1440x900 
0x37CA2318, 38092254255157128, 224913708, 224913716, 8, 1440x900 
0x37CA2318, 38092254255852888, 224913773, 224913780, 7, 1440x900 
0x37CA2318, 38092254256436632, 224913831, 224913838, 7, 1440x900 
0x37CA2318, 38092254257104512, 224913897, 224913905, 8, 1440x900 
0x37CA2318, 38092254257820424, 224913968, 224913976, 8, 1440x900 
0x37CA2318, 38092254258440920, 224914028, 224914036, 8, 1440x900 
0x37CA2318, 38092254259090408, 224914093, 224914101, 8, 1440x900 
0x37CA2318, 38092254259751088, 224914162, 224914169, 7, 1440x900 
0x37CA2318, 38092254260410920, 224914225, 224914234, 9, 1440x900 
0x37CA2318, 38092254261077344, 224914298, 224914307, 9, 1440x900 
0x37CA2318, 38092254261735568, 224914358, 224914366, 8, 1440x900 
0x37CA2318, 38092254262403176, 224914426, 224914435, 9, 1440x900 
0x37CA2318, 38092254263064184, 224914493, 224914500, 7, 1440x900 
0x37CA2318, 38092254263724792, 224914557, 224914565, 8, 1440x900 
0x37CA2318, 38092254264383976, 224914623, 224914631, 8, 1440x900 
0x37CA2318, 38092254265044288, 224914688, 224914696, 8, 1440x900 
0x37CA2318, 38092254265704064, 224914757, 224914766, 9, 1440x900 
0x37CA2318, 38092254266370784, 224914828, 224914836, 8, 1440x900 
0x37CA2318, 38092254267030360, 224914893, 224914901, 8, 1440x900 
0x37CA2318, 38092254267690352, 224914958, 224914966, 8, 1440x900 
0x37CA2318, 38092254268364184, 224915027, 224915035, 8, 1440x900 
0x37CA2318, 38092254269014944, 224915088, 224915096, 8, 1440x900 
0x37CA2318, 38092254269676424, 224915152, 224915160, 8, 1440x900 
0x37CA2318, 38092254270334536, 224915218, 224915226, 8, 1440x900 
0x37CA2318, 38092254270997104, 224915283, 224915290, 7, 1440x900 
0x37CA2318, 38092254271663344, 224915352, 224915360, 8, 1440x900 
0x37CA2318, 38092254272335888, 224915418, 224915426, 8, 1440x900 
0x37CA2318, 38092254272992064, 224915499, 224915507, 8, 1440x900 
0x37CA2318, 38092254273649680, 224915552, 224915559, 7, 1440x900 
0x37CA2318, 38092254274311928, 224915617, 224915624, 7, 1440x900 
0x37CA2318, 38092254274969432, 224915683, 224915690, 7, 1440x900 
0x37CA2318, 38092254275638072, 224915748, 224915755, 7, 1440x900 
0x37CA2318, 38092254276298616, 224915814, 224915822, 8, 1440x900 
0x37CA2318, 38092254276961400, 224915882, 224915889, 7, 1440x900 
0x37CA2318, 38092254277623280, 224915947, 224915955, 8, 1440x900 
0x37CA2318, 38092254278281288, 224916014, 224916022, 8, 1440x900 
0x37CA2318, 38092254278940392, 224916078, 224916086, 8, 1440x900 
0x37CA2318, 38092254279601472, 224916145, 224916155, 10, 1440x900 
0x37CA2318, 38092254280260984, 224916212, 224916220, 8, 1440x900 
0x37CA2318, 38092254280920064, 224916278, 224916286, 8, 1440x900 
0x37CA2318, 38092254281588656, 224916343, 224916351, 8, 1440x900 
0x37CA2318, 38092254282248384, 224916412, 224916419, 7, 1440x900 
0x37CA2318, 38092254282909072, 224916478, 224916485, 7, 1440x900 
0x37CA2318, 38092254283570120, 224916544, 224916552, 8, 1440x900 
0x37CA2318, 38092254284239904, 224916609, 224916617, 8, 1440x900 
0x37CA2318, 38092254284900808, 224916677, 224916685, 8, 1440x900 
0x37CA2318, 38092254285561856, 224916745, 224916752, 7, 1440x900 
0x37CA2318, 38092254286222216, 224916808, 224916816, 8, 1440x900 
0x37CA2318, 38092254286885752, 224916873, 224916887, 14, 1440x900 
0x37CA2318, 38092254287735448, 224916967, 224916977, 10, 1440x900 
0x37CA2318, 38092254288219960, 224917008, 224917021, 13, 1440x900 
0x37CA2318, 38092254288877144, 224917073, 224917083, 10, 1440x900 
0x37CA2318, 38092254289558504, 224917141, 224917155, 14, 1440x900 
0x37CA2318, 38092254290217816, 224917207, 224917217, 10, 1440x900 
0x37CA2318, 38092254290881384, 224917273, 224917286, 13, 1440x900 
0x37CA2318, 38092254291537128, 224917337, 224917348, 11, 1440x900 
0x37CA2318, 38092254292198384, 224917407, 224917415, 8, 1440x900 
0x37CA2318, 38092254292867544, 224917473, 224917481, 8, 1440x900 
0x37CA2318, 38092254293537248, 224917538, 224917550, 12, 1440x900 
0x37CA2318, 38092254294180528, 224917603, 224917612, 9, 1440x900 
0x37CA2318, 38092254294841216, 224917672, 224917682, 10, 1440x900 
0x37CA2318, 38092254295537840, 224917738, 224917747, 9, 1440x900 
0x37CA2318, 38092254296200960, 224917806, 224917815, 9, 1440x900 
0x37CA2318, 38092254296866664, 224917872, 224917880, 8, 1440x900 
0x37CA2318, 38092254297504592, 224917938, 224917946, 8, 1440x900 
0x37CA2318, 38092254298168248, 224918003, 224918014, 11, 1440x900 
0x37CA2318, 38092254298837216, 224918068, 224918082, 14, 1440x900 
0x37CA2318, 38092254299490344, 224918135, 224918146, 11, 1440x900 
0x37CA2318, 38092254300154784, 224918203, 224918214, 11, 1440x900 
0x37CA2318, 38092254300806568, 224918273, 224918288, 15, 1440x900 
0x37CA2318, 38092254301462184, 224918335, 224918355, 20, 1440x900 
0x37CA2318, 38092254302132208, 224918398, 224918407, 9, 1440x900 
0x37CA2318, 38092254302780184, 224918463, 224918473, 10, 1440x900 
0x37CA2318, 38092254303441120, 224918529, 224918539, 10, 1440x900 
0x37CA2318, 38092254304099848, 224918601, 224918610, 9, 1440x900 
0x37CA2318, 38092254304757968, 224918662, 224918676, 14, 1440x900 
0x37CA2318, 38092254305422000, 224918729, 224918741, 12, 1440x900 
0x37CA2318, 38092254306087808, 224918793, 224918802, 9, 1440x900 
0x37CA2318, 38092254306748096, 224918859, 224918872, 13, 1440x900 
0x37CA2318, 38092254307408200, 224918928, 224918940, 12, 1440x900 
0x37CA2318, 38092254308069800, 224918993, 224919008, 15, 1440x900 
0x37CA2318, 38092254308731544, 224919062, 224919073, 11, 1440x900 
0x37CA2318, 38092254309398048, 224919127, 224919139, 12, 1440x900 
0x37CA2318, 38092254310055424, 224919191, 224919201, 10, 1440x900 
0x37CA2318, 38092254310718672, 224919257, 224919265, 8, 1440x900 
0x37CA2318, 38092254311387456, 224919323, 224919333, 10, 1440x900 
0x37CA2318, 38092254312075912, 224919393, 224919407, 14, 1440x900 
0x37CA2318, 38092254312698200, 224919456, 224919465, 9, 1440x900 
0x37CA2318, 38092254313360656, 224919522, 224919530, 8, 1440x900 
0x37CA2318, 38092254314019064, 224919588, 224919596, 8, 1440x900 
0x37CA2318, 38092254314725024, 224919658, 224919666, 8, 1440x900 
0x37CA2318, 38092254315358208, 224919723, 224919732, 9, 1440x900 
0x37CA2318, 38092254316026368, 224919789, 224919797, 8, 1440x900 
0x37CA2318, 38092254316690128, 224919856, 224919865, 9, 1440x900 
0x37CA2318, 38092254317332512, 224919918, 224919926, 8, 1440x900 
0x37CA2318, 38092254318012304, 224919987, 224919995, 8, 1440x900 
0x37CA2318, 38092254318663888, 224920058, 224920065, 7, 1440x900 
0x37CA2318, 38092254319315704, 224920122, 224920130, 8, 1440x900 
0x37CA2318, 38092254319974416, 224920184, 224920195, 11, 1440x900 
0x37CA2318, 38092254320636488, 224920248, 224920257, 9, 1440x900 
0x37CA2318, 38092254321296040, 224920314, 224920322, 8, 1440x900 
0x37CA2318, 38092254321967032, 224920386, 224920394, 8, 1440x900 
0x37CA2318, 38092254322627720, 224920449, 224920462, 13, 1440x900 
0x37CA2318, 38092254323282208, 224920514, 224920526, 12, 1440x900 
0x37CA2318, 38092254323950936, 224920584, 224920593, 9, 1440x900 
0x37CA2318, 38092254324611000, 224920649, 224920656, 7, 1440x900 
0x37CA2318, 38092254325270552, 224920713, 224920726, 13, 1440x900 
0x37CA2318, 38092254325930424, 224920778, 224920791, 13, 1440x900 
0x37CA2318, 38092254326596872, 224920848, 224920859, 11, 1440x900 
0x37CA2318, 38092254327267048, 224920913, 224920920, 7, 1440x900 
0x37CA2318, 38092254327926584, 224920977, 224920986, 9, 1440x900 
0x37CA2318, 38092254328596592, 224921047, 224921056, 9, 1440x900 
0x37CA2318, 38092254329258424, 224921112, 224921124, 12, 1440x900 
0x37CA2318, 38092254329918512, 224921178, 224921190, 12, 1440x900 
0x37CA2318, 38092254330591472, 224921248, 224921261, 13, 1440x900 
0x37CA2318, 38092254331244352, 224921311, 224921319, 8, 1440x900 
0x37CA2318, 38092254331914560, 224921378, 224921386, 8, 1440x900 
0x37CA2318, 38092254333244872, 224921508, 224921518, 10, 1440x900 
0x37CA2318, 38092254333910568, 224921577, 224921584, 7, 1440x900 
0x37CA2318, 38092254334576056, 224921642, 224921652, 10, 1440x900 
0x37CA2318, 38092254335243480, 224921708, 224921717, 9, 1440x900 
0x37CA2318, 38092254335907144, 224921779, 224921788, 9, 1440x900 
0x37CA2318, 38092254336541352, 224921838, 224921847, 9, 1440x900 
0x37CA2318, 38092254337227176, 224921909, 224921918, 9, 1440x900 
0x37CA2318, 38092254337927464, 224921978, 224921987, 9, 1440x900 
0x37CA2318, 38092254338594920, 224922043, 224922052, 9, 1440x900 
0x37CA2318, 38092254339217008, 224922107, 224922114, 7, 1440x900 
0x37CA2318, 38092254339882080, 224922173, 224922182, 9, 1440x900 
0x37CA2318, 38092254340547480, 224922243, 224922252, 9, 1440x900 
0x37CA2318, 38092254341213376, 224922308, 224922316, 8, 1440x900 
0x37CA2318, 38092254341888984, 224922377, 224922385, 8, 1440x900 
0x37CA2318, 38092254342554512, 224922443, 224922452, 9, 1440x900 
0x37CA2318, 38092254343189344, 224922508, 224922516, 8, 1440x900 
0x37CA2318, 38092254343861616, 224922573, 224922581, 8, 1440x900 
0x37CA2318, 38092254344525240, 224922643, 224922652, 9, 1440x900 
0x37CA2318, 38092254345180048, 224922708, 224922717, 9, 1440x900 
0x37CA2318, 38092254345837160, 224922775, 224922783, 8, 1440x900 
0x37CA2318, 38092254346498320, 224922838, 224922846, 8, 1440x900 
0x37CA2318, 38092254347158192, 224922903, 224922911, 8, 1440x900 
0x37CA2318, 38092254347816528, 224922967, 224922976, 9, 1440x900 
0x37CA2318, 38092254348477896, 224923033, 224923046, 13, 1440x900 
0x37CA2318, 38092254349140200, 224923098, 224923111, 13, 1440x900 
0x37CA2318, 38092254349800880, 224923167, 224923179, 12, 1440x900 
0x37CA2318, 38092254350461288, 224923232, 224923240, 8, 1440x900 
0x37CA2318, 38092254351123584, 224923298, 224923307, 9, 1440x900 
0x37CA2318, 38092254351782744, 224923363, 224923372, 9, 1440x900 
0x37CA2318, 38092254352456736, 224923433, 224923445, 12, 1440x900 
0x37CA2318, 38092254353120592, 224923498, 224923512, 14, 1440x900 
0x37CA2318, 38092254353779968, 224923564, 224923577, 13, 1440x900 
0x37CA2318, 38092254354443536, 224923631, 224923639, 8, 1440x900 
0x37CA2318, 38092254355109248, 224923697, 224923706, 9, 1440x900 
0x37CA2318, 38092254355780016, 224923763, 224923772, 9, 1440x900 
0x37CA2318, 38092254356444640, 224923832, 224923845, 13, 1440x900 
0x37CA2318, 38092254357104208, 224923897, 224923906, 9, 1440x900 
0x37CA2318, 38092254357738968, 224923962, 224923971, 9, 1440x900 
0x37CA2318, 38092254358443376, 224924032, 224924040, 8, 1440x900 
0x37CA2318, 38092254359102192, 224924097, 224924106, 9, 1440x900 
0x37CA2318, 38092254359744024, 224924162, 224924171, 9, 1440x900 
0x37CA2318, 38092254360398144, 224924226, 224924234, 8, 1440x900 
0x37CA2318, 38092254361065640, 224924292, 224924299, 7, 1440x900 
0x37CA2318, 38092254361727336, 224924357, 224924365, 8, 1440x900 
0x37CA2318, 38092254362361880, 224924426, 224924435, 9, 1440x900 
0x37CA2318, 38092254363022168, 224924496, 224924504, 8, 1440x900 
0x37CA2318, 38092254363682768, 224924553, 224924566, 13, 1440x900 
0x37CA2318, 38092254364343376, 224924619, 224924632, 13, 1440x900 
0x37CA2318, 38092254365002008, 224924688, 224924695, 7, 1440x900 
0x37CA2318, 38092254365661800, 224924754, 224924761, 7, 1440x900 
0x37CA2318, 38092254366321712, 224924819, 224924832, 13, 1440x900 
0x37CA2318, 38092254366984144, 224924883, 224924896, 13, 1440x900 
0x37CA2318, 38092254367641400, 224924955, 224924964, 9, 1440x900 
0x37CA2318, 38092254368302144, 224925014, 224925024, 10, 1440x900 
0x37CA2318, 38092254368968080, 224925083, 224925091, 8, 1440x900 
0x37CA2318, 38092254369630336, 224925148, 224925157, 9, 1440x900 
0x37CA2318, 38092254370295568, 224925217, 224925230, 13, 1440x900 
0x37CA2318, 38092254370963680, 224925282, 224925292, 10, 1440x900 
0x37CA2318, 38092254371609904, 224925348, 224925358, 10, 1440x900 
0x37CA2318, 38092254372293528, 224925416, 224925424, 8, 1440x900 
0x37CA2318, 38092254372953936, 224925482, 224925490, 8, 1440x900 
0x37CA2318, 38092254373643008, 224925555, 224925563, 8, 1440x900 
0x37CA2318, 38092254374270592, 224925613, 224925621, 8, 1440x900 
0x37CA2318, 38092254374931232, 224925678, 224925686, 8, 1440x900 
0x37CA2318, 38092254375724288, 224925757, 224925765, 8, 1440x900 
0x37CA2318, 38092254376446008, 224925832, 224925839, 7, 1440x900 
0x37CA2318, 38092254377148904, 224925903, 224925914, 11, 1440x900 
0x37CA2318, 38092254377647072, 224925950, 224925959, 9, 1440x900 
0x37CA2318, 38092254378425248, 224926029, 224926059, 30, 1440x900 
0x37CA2318, 38092254379073168, 224926100, 224926125, 25, 1440x900 
0x37CA2318, 38092254379756432, 224926177, 224926197, 20, 1440x900 
0x37CA2318, 38092254380563664, 224926243, 224926250, 7, 1440x900 
0x37CA2318, 38092254381126624, 224926303, 224926331, 28, 1440x900 
0x37CA2318, 38092254381769440, 224926376, 224926393, 17, 1440x900 
0x37CA2318, 38092254382413456, 224926436, 224926457, 21, 1440x900 
0x37CA2318, 38092254383036968, 224926495, 224926524, 29, 1440x900 
0x37CA2318, 38092254383726832, 224926566, 224926592, 26, 1440x900 
0x37CA2318, 38092254384378296, 224926630, 224926658, 28, 1440x900 
0x37CA2318, 38092254384948912, 224926686, 224926712, 26, 1440x900 
0x37CA2318, 38092254385665280, 224926762, 224926816, 54, 1440x900 
0x37CA2318, 38092254386457624, 224926832, 224926843, 11, 1440x900 
0x37CA2318, 38092254387093056, 224926900, 224926914, 14, 1440x900 
0x37CA2318, 38092254387736648, 224926963, 224926991, 28, 1440x900 
0x37CA2318, 38092254388388776, 224927027, 224927052, 25, 1440x900 
0x37CA2318, 38092254389058008, 224927101, 224927115, 14, 1440x900 
0x37CA2318, 38092254389837640, 224927172, 224927213, 41, 1440x900 
0x37CA2318, 38092254390482744, 224927237, 224927260, 23, 1440x900 
0x37CA2318, 38092254391100240, 224927304, 224927332, 28, 1440x900 
0x37CA2318, 38092254391815600, 224927371, 224927394, 23, 1440x900 
0x37CA2318, 38092254392425088, 224927436, 224927459, 23, 1440x900 
0x37CA2318, 38092254393064240, 224927499, 224927513, 14, 1440x900 
0x37CA2318, 38092254393865888, 224927574, 224927595, 21, 1440x900 
0x37CA2318, 38092254394441480, 224927637, 224927663, 26, 1440x900 
0x37CA2318, 38092254395106968, 224927704, 224927725, 21, 1440x900 
0x37CA2318, 38092254395748824, 224927780, 224927799, 19, 1440x900 
0x37CA2318, 38092254396541304, 224927841, 224927866, 25, 1440x900 
0x37CA2318, 38092254397135152, 224927903, 224927926, 23, 1440x900 
0x37CA2318, 38092254397729712, 224927963, 224927980, 17, 1440x900 
0x37CA2318, 38092254398392512, 224928032, 224928048, 16, 1440x900 
0x37CA2318, 38092254399047184, 224928099, 224928124, 25, 1440x900 
0x37CA2318, 38092254399722864, 224928158, 224928190, 32, 1440x900 
0x37CA2318, 38092254400380440, 224928223, 224928244, 21, 1440x900 
0x37CA2318, 38092254401048760, 224928291, 224928312, 21, 1440x900 
0x37CA2318, 38092254401899424, 224928405, 224928416, 11, 1440x900 
0x37CA2318, 38092254402467008, 224928439, 224928448, 9, 1440x900 
0x37CA2318, 38092254403071704, 224928500, 224928513, 13, 1440x900 
0x37CA2318, 38092254403723168, 224928559, 224928582, 23, 1440x900 
0x37CA2318, 38092254404399160, 224928626, 224928662, 36, 1440x900 
0x37CA2318, 38092254405219192, 224928709, 224928731, 22, 1440x900 
0x37CA2318, 38092254405672944, 224928752, 224928760, 8, 1440x900 
0x37CA2318, 38092254406400416, 224928831, 224928847, 16, 1440x900 
0x37CA2318, 38092254407059280, 224928892, 224928924, 32, 1440x900 
0x37CA2318, 38092254407727936, 224928960, 224928983, 23, 1440x900 
0x37CA2318, 38092254408406128, 224929033, 224929049, 16, 1440x900 
0x37CA2318, 38092254409071640, 224929093, 224929113, 20, 1440x900 
0x37CA2318, 38092254409734432, 224929170, 224929180, 10, 1440x900 
0x37CA2318, 38092254410350400, 224929225, 224929258, 33, 1440x900 
0x37CA2318, 38092254411040104, 224929293, 224929313, 20, 1440x900 
0x37CA2318, 38092254411678176, 224929358, 224929380, 22, 1440x900 
0x37CA2318, 38092254412348712, 224929431, 224929448, 17, 1440x900 
0x37CA2318, 38092254412978112, 224929499, 224929537, 38, 1440x900 
0x37CA2318, 38092254413890072, 224929593, 224929615, 22, 1440x900 
0x37CA2318, 38092254414481272, 224929632, 224929639, 7, 1440x900 
0x37CA2318, 38092254415083104, 224929701, 224929719, 18, 1440x900 
0x37CA2318, 38092254415744624, 224929761, 224929793, 32, 1440x900 
0x37CA2318, 38092254416414144, 224929840, 224929876, 36, 1440x900 
0x37CA2318, 38092254417082176, 224929904, 224929938, 34, 1440x900 
0x37CA2318, 38092254417730408, 224929966, 224929981, 15, 1440x900 
0x37CA2318, 38092254418401104, 224930031, 224930044, 13, 1440x900 
0x37CA2318, 38092254419079536, 224930093, 224930109, 16, 1440x900 
0x37CA2318, 38092254419751568, 224930166, 224930182, 16, 1440x900 
0x37CA2318, 38092254420429536, 224930229, 224930236, 7, 1440x900 
0x37CA2318, 38092254421070816, 224930294, 224930301, 7, 1440x900 
0x37CA2318, 38092254421660856, 224930353, 224930361, 8, 1440x900 
0x37CA2318, 38092254422322256, 224930418, 224930424, 6, 1440x900 
0x37CA2318, 38092254422985520, 224930484, 224930489, 5, 1440x900 
0x37CA2318, 38092254423655160, 224930552, 224930558, 6, 1440x900 
0x37CA2318, 38092254424311248, 224930621, 224930630, 9, 1440x900 
0x37CA2318, 38092254424969672, 224930687, 224930695, 8, 1440x900 
0x37CA2318, 38092254425649600, 224930766, 224930776, 10, 1440x900 
0x37CA2318, 38092254426312848, 224930824, 224930834, 10, 1440x900 
0x37CA2318, 38092254426954400, 224930879, 224930887, 8, 1440x900 
0x37CA2318, 38092254427614736, 224930947, 224930954, 7, 1440x900 
0x37CA2318, 38092254428304608, 224931018, 224931023, 5, 1440x900 
0x37CA2318, 38092254428932168, 224931081, 224931088, 7, 1440x900 
0x37CA2318, 38092254429590536, 224931143, 224931153, 10, 1440x900 
0x37CA2318, 38092254430264752, 224931212, 224931221, 9, 1440x900 
0x37CA2318, 38092254430983712, 224931284, 224931291, 7, 1440x900 
0x37CA2318, 38092254431654216, 224931349, 224931356, 7, 1440x900 
0x37CA2318, 38092254432277528, 224931413, 224931422, 9, 1440x900 
0x37CA2318, 38092254432934688, 224931479, 224931487, 8, 1440x900 
0x37CA2318, 38092254433594792, 224931549, 224931566, 17, 1440x900 
0x37CA2318, 38092254434255440, 224931613, 224931619, 6, 1440x900 
0x37CA2318, 38092254434918864, 224931680, 224931697, 17, 1440x900 
0x37CA2318, 38092254435584024, 224931747, 224931753, 6, 1440x900 
0x37CA2318, 38092254436253672, 224931812, 224931819, 7, 1440x900 
0x37CA2318, 38092254436923184, 224931878, 224931885, 7, 1440x900 
0x37CA2318, 38092254437593920, 224931944, 224931951, 7, 1440x900 
0x37CA2318, 38092254438271120, 224932017, 224932023, 6, 1440x900 
0x37CA2318, 38092254438951992, 224932079, 224932088, 9, 1440x900 
0x37CA2318, 38092254439564048, 224932142, 224932149, 7, 1440x900 
0x37CA2318, 38092254440225408, 224932208, 224932216, 8, 1440x900 
0x37CA2318, 38092254440928136, 224932278, 224932285, 7, 1440x900 
0x37CA2318, 38092254441591464, 224932343, 224932351, 8, 1440x900 
0x37CA2318, 38092254442260352, 224932413, 224932421, 8, 1440x900 
0x37CA2318, 38092254442963816, 224932481, 224932490, 9, 1440x900 
0x37CA2318, 38092254443600912, 224932547, 224932553, 6, 1440x900 
0x37CA2318, 38092254444265368, 224932614, 224932622, 8, 1440x900 
0x37CA2318, 38092254444867368, 224932672, 224932679, 7, 1440x900 
0x37CA2318, 38092254445539232, 224932739, 224932753, 14, 1440x900 
0x37CA2318, 38092254446288496, 224932815, 224932832, 17, 1440x900 
0x37CA2318, 38092254446937872, 224932878, 224932886, 8, 1440x900 
0x37CA2318, 38092254447609232, 224932947, 224932956, 9, 1440x900 
0x37CA2318, 38092254448197328, 224933007, 224933028, 21, 1440x900 
0x37CA2318, 38092254448935448, 224933079, 224933097, 18, 1440x900 
0x37CA2318, 38092254449615360, 224933149, 224933164, 15, 1440x900 
0x37CA2318, 38092254450166864, 224933202, 224933209, 7, 1440x900 
0x37CA2318, 38092254450858680, 224933278, 224933286, 8, 1440x900 
0x37CA2318, 38092254451531088, 224933343, 224933352, 9, 1440x900 
0x37CA2318, 38092254452186776, 224933407, 224933417, 10, 1440x900 
0x37CA2318, 38092254452836736, 224933473, 224933484, 11, 1440x900 
0x37CA2318, 38092254453484608, 224933537, 224933544, 7, 1440x900 
0x37CA2318, 38092254454140720, 224933611, 224933619, 8, 1440x900 
0x37CA2318, 38092254454811840, 224933670, 224933683, 13, 1440x900 
0x37CA2318, 38092254455467064, 224933736, 224933749, 13, 1440x900 
0x37CA2318, 38092254456126936, 224933801, 224933817, 16, 1440x900 
0x37CA2318, 38092254456792304, 224933869, 224933879, 10, 1440x900 
0x37CA2318, 38092254457546888, 224933938, 224933948, 10, 1440x900 
0x37CA2318, 38092254458132184, 224933999, 224934007, 8, 1440x900 
0x37CA2318, 38092254458786256, 224934063, 224934072, 9, 1440x900 
0x37CA2318, 38092254459450152, 224934130, 224934139, 9, 1440x900 
0x37CA2318, 38092254460107712, 224934198, 224934207, 9, 1440x900 
0x37CA2318, 38092254460782816, 224934263, 224934271, 8, 1440x900 
0x37CA2318, 38092254461446808, 224934332, 224934340, 8, 1440x900 
0x37CA2318, 38092254462090728, 224934393, 224934403, 10, 1440x900 
0x37CA2318, 38092254462790272, 224934471, 224934484, 13, 1440x900 
0x37CA2318, 38092254463489696, 224934541, 224934552, 11, 1440x900 
0x37CA2318, 38092254464142360, 224934604, 224934617, 13, 1440x900 
0x37CA2318, 38092254464812072, 224934669, 224934675, 6, 1440x900 
0x37CA2318, 38092254465409256, 224934727, 224934745, 18, 1440x900 
0x37CA2318, 38092254466124728, 224934800, 224934808, 8, 1440x900 
0x37CA2318, 38092254466737752, 224934858, 224934867, 9, 1440x900 
0x37CA2318, 38092254467389008, 224934923, 224934932, 9, 1440x900 
0x37CA2318, 38092254468057464, 224934993, 224935001, 8, 1440x900 
0x37CA2318, 38092254468795872, 224935067, 224935074, 7, 1440x900 
0x37CA2318, 38092254469484584, 224935134, 224935143, 9, 1440x900 
0x37CA2318, 38092254470126424, 224935199, 224935208, 9, 1440x900 
0x37CA2318, 38092254470814720, 224935268, 224935276, 8, 1440x900 
0x37CA2318, 38092254471390472, 224935328, 224935339, 11, 1440x900 
0x37CA2318, 38092254472149512, 224935404, 224935412, 8, 1440x900 
0x37CA2318, 38092254472704480, 224935457, 224935466, 9, 1440x900 
0x37CA2318, 38092254473525616, 224935554, 224935568, 14, 1440x900 
0x37CA2318, 38092254474027312, 224935588, 224935598, 10, 1440x900 
0x37CA2318, 38092254474741568, 224935669, 224935677, 8, 1440x900 
0x37CA2318, 38092254475350792, 224935719, 224935727, 8, 1440x900 
0x37CA2318, 38092254476014320, 224935787, 224935794, 7, 1440x900 
0x37CA2318, 38092254476675184, 224935852, 224935859, 7, 1440x900 
0x37CA2318, 38092254477335776, 224935923, 224935929, 6, 1440x900 
0x37CA2318, 38092254477994320, 224935988, 224935995, 7, 1440x900 
0x37CA2318, 38092254478648096, 224936054, 224936069, 15, 1440x900 
0x37CA2318, 38092254479332432, 224936120, 224936136, 16, 1440x900 
0x37CA2318, 38092254479989280, 224936187, 224936203, 16, 1440x900 
0x37CA2318, 38092254480650248, 224936253, 224936260, 7, 1440x900 
0x37CA2318, 38092254481334112, 224936320, 224936328, 8, 1440x900 
0x37CA2318, 38092254482064840, 224936392, 224936403, 11, 1440x900 
0x37CA2318, 38092254482740608, 224936462, 224936472, 10, 1440x900 
0x37CA2318, 38092254483411968, 224936533, 224936541, 8, 1440x900 
0x37CA2318, 38092254484059416, 224936592, 224936601, 9, 1440x900 
0x37CA2318, 38092254484718680, 224936658, 224936665, 7, 1440x900 
0x37CA2318, 38092254485385880, 224936723, 224936732, 9, 1440x900 
0x37CA2318, 38092254486077056, 224936801, 224936808, 7, 1440x900 
0x37CA2318, 38092254486703216, 224936854, 224936865, 11, 1440x900 
0x37CA2318, 38092254487405416, 224936925, 224936938, 13, 1440x900 
0x37CA2318, 38092254488109440, 224936997, 224937007, 10, 1440x900 
0x37CA2318, 38092254488768096, 224937064, 224937074, 10, 1440x900 
0x37CA2318, 38092254489391560, 224937124, 224937149, 25, 1440x900 
0x37CA2318, 38092254490335552, 224937222, 224937230, 8, 1440x900 
0x37CA2318, 38092254490953136, 224937279, 224937290, 11, 1440x900 
0x37CA2318, 38092254491616160, 224937345, 224937355, 10, 1440x900 
0x37CA2318, 38092254492275376, 224937414, 224937423, 9, 1440x900 
0x37CA2318, 38092254492935504, 224937486, 224937493, 7, 1440x900 
0x37CA2318, 38092254493591192, 224937547, 224937555, 8, 1440x900 
0x37CA2318, 38092254494250864, 224937613, 224937621, 8, 1440x900 
0x37CA2318, 38092254494911216, 224937677, 224937685, 8, 1440x900 
0x37CA2318, 38092254495572448, 224937742, 224937751, 9, 1440x900 
0x37CA2318, 38092254496233024, 224937808, 224937818, 10, 1440x900 
0x37CA2318, 38092254497041752, 224937889, 224937898, 9, 1440x900 
0x37CA2318, 38092254497676760, 224937952, 224937962, 10, 1440x900 
0x37CA2318, 38092254498320728, 224938018, 224938027, 9, 1440x900 
0x37CA2318, 38092254498979136, 224938083, 224938093, 10, 1440x900 
0x37CA2318, 38092254499636952, 224938148, 224938159, 11, 1440x900 
0x37CA2318, 38092254500302376, 224938217, 224938224, 7, 1440x900 
0x37CA2318, 38092254500963688, 224938285, 224938292, 7, 1440x900 
0x37CA2318, 38092254501622792, 224938347, 224938356, 9, 1440x900 
0x37CA2318, 38092254502291528, 224938413, 224938421, 8, 1440x900 
0x37CA2318, 38092254502993144, 224938487, 224938494, 7, 1440x900 
0x37CA2318, 38092254503612512, 224938547, 224938556, 9, 1440x900 
0x37CA2318, 38092254504273808, 224938613, 224938621, 8, 1440x900 
0x37CA2318, 38092254504931080, 224938678, 224938686, 8, 1440x900 
0x37CA2318, 38092254505592000, 224938746, 224938753, 7, 1440x900 
0x37CA2318, 38092254506251848, 224938812, 224938819, 7, 1440x900 
0x37CA2318, 38092254506913584, 224938877, 224938884, 7, 1440x900 
0x37CA2318, 38092254507571720, 224938942, 224938949, 7, 1440x900 
0x37CA2318, 38092254508232704, 224939008, 224939015, 7, 1440x900 
0x37CA2318, 38092254508896936, 224939077, 224939086, 9, 1440x900 
0x37CA2318, 38092254509563816, 224939145, 224939154, 9, 1440x900 
0x37CA2318, 38092254510233984, 224939208, 224939216, 8, 1440x900 
0x37CA2318, 38092254510890024, 224939273, 224939281, 8, 1440x900 
0x37CA2318, 38092254511539512, 224939342, 224939349, 7, 1440x900 
0x37CA2318, 38092254512195088, 224939405, 224939413, 8, 1440x900 
0x37CA2318, 38092254512853712, 224939471, 224939479, 8, 1440x900 
0x37CA2318, 38092254513514416, 224939540, 224939547, 7, 1440x900 
0x37CA2318, 38092254514176160, 224939605, 224939614, 9, 1440x900 
0x37CA2318, 38092254514844128, 224939674, 224939683, 9, 1440x900 
0x37CA2318, 38092254515496240, 224939734, 224939744, 10, 1440x900 
0x37CA2318, 38092254516155520, 224939804, 224939811, 7, 1440x900 
0x37CA2318, 38092254516814480, 224939867, 224939877, 10, 1440x900 
0x37CA2318, 38092254517482928, 224939932, 224939940, 8, 1440x900 
0x37CA2318, 38092254518146456, 224940002, 224940009, 7, 1440x900 
0x37CA2318, 38092254518803504, 224940066, 224940074, 8, 1440x900 
0x37CA2318, 38092254519462904, 224940133, 224940143, 10, 1440x900 
0x37CA2318, 38092254520126888, 224940198, 224940206, 8, 1440x900 
0x37CA2318, 38092254520789856, 224940269, 224940276, 7, 1440x900 
0x37CA2318, 38092254521446208, 224940333, 224940341, 8, 1440x900 
0x37CA2318, 38092254522105200, 224940398, 224940406, 8, 1440x900 
0x37CA2318, 38092254522765704, 224940462, 224940470, 8, 1440x900 
0x37CA2318, 38092254523435824, 224940532, 224940540, 8, 1440x900 
0x37CA2318, 38092254524086752, 224940596, 224940604, 8, 1440x900 
0x37CA2318, 38092254524749016, 224940661, 224940668, 7, 1440x900 
0x37CA2318, 38092254525419712, 224940727, 224940734, 7, 1440x900 
0x37CA2318, 38092254526087456, 224940793, 224940805, 12, 1440x900 
0x37CA2318, 38092254526733904, 224940858, 224940866, 8, 1440x900 
0x37CA2318, 38092254527401328, 224940927, 224940934, 7, 1440x900 
0x37CA2318, 38092254528056352, 224940993, 224941000, 7, 1440x900 
0x37CA2318, 38092254528715456, 224941057, 224941065, 8, 1440x900 
0x37CA2318, 38092254529372592, 224941124, 224941132, 8, 1440x900 
0x37CA2318, 38092254530032488, 224941189, 224941198, 9, 1440x900 
0x37CA2318, 38092254530693592, 224941258, 224941265, 7, 1440x900 
0x37CA2318, 38092254531353400, 224941326, 224941332, 6, 1440x900 
0x37CA2318, 38092254532015376, 224941385, 224941396, 11, 1440x900 
0x37CA2318, 38092254532677120, 224941453, 224941463, 10, 1440x900 
0x37CA2318, 38092254533340576, 224941525, 224941532, 7, 1440x900 
0x37CA2318, 38092254534000704, 224941587, 224941595, 8, 1440x900 
0x37CA2318, 38092254534659744, 224941653, 224941661, 8, 1440x900 
0x37CA2318, 38092254535325472, 224941725, 224941735, 10, 1440x900 
0x37CA2318, 38092254535983072, 224941783, 224941793, 10, 1440x900 
0x37CA2318, 38092254536641696, 224941855, 224941864, 9, 1440x900 
0x37CA2318, 38092254537323592, 224941925, 224941935, 10, 1440x900 
0x37CA2318, 38092254537968544, 224941985, 224941994, 9, 1440x900 
0x37CA2318, 38092254538629344, 224942048, 224942056, 8, 1440x900 
0x37CA2318, 38092254539286952, 224942113, 224942121, 8, 1440x900 
0x37CA2318, 38092254539947648, 224942182, 224942189, 7, 1440x900 
0x37CA2318, 38092254540607664, 224942247, 224942254, 7, 1440x900 
0x37CA2318, 38092254541269760, 224942312, 224942319, 7, 1440x900 
0x37CA2318, 38092254541929072, 224942378, 224942385, 7, 1440x900 
0x37CA2318, 38092254542604344, 224942447, 224942455, 8, 1440x900 
0x37CA2318, 38092254543357952, 224942527, 224942535, 8, 1440x900 
0x37CA2318, 38092254543960024, 224942580, 224942588, 8, 1440x900 
0x37CA2318, 38092254544621392, 224942648, 224942659, 11, 1440x900 
0x37CA2318, 38092254545287792, 224942718, 224942727, 9, 1440x900 
0x37CA2318, 38092254545940256, 224942778, 224942789, 11, 1440x900 
0x37CA2318, 38092254546625872, 224942848, 224942856, 8, 1440x900 
0x37CA2318, 38092254547365504, 224942923, 224942947, 24, 1440x900 
0x37CA2318, 38092254547929136, 224942977, 224942985, 8, 1440x900 
0x37CA2318, 38092254548794400, 224943067, 224943074, 7, 1440x900 
0x37CA2318, 38092254549454128, 224943130, 224943139, 9, 1440x900 
0x37CA2318, 38092254550114136, 224943198, 224943205, 7, 1440x900 
0x37CA2318, 38092254550813352, 224943268, 224943275, 7, 1440x900 
0x37CA2318, 38092254551378088, 224943323, 224943332, 9, 1440x900 
0x37CA2318, 38092254552559352, 224943442, 224943450, 8, 1440x900 
0x37CA2318, 38092254553218104, 224943508, 224943516, 8, 1440x900 
0x37CA2318, 38092254553887312, 224943574, 224943583, 9, 1440x900 
0x37CA2318, 38092254554536328, 224943638, 224943646, 8, 1440x900 
0x37CA2318, 38092254555198848, 224943703, 224943712, 9, 1440x900 
0x37CA2318, 38092254555859648, 224943772, 224943780, 8, 1440x900 
0x37CA2318, 38092254556524360, 224943840, 224943847, 7, 1440x900 
0x37CA2318, 38092254557183872, 224943902, 224943910, 8, 1440x900 
0x37CA2318, 38092254557843768, 224943972, 224943979, 7, 1440x900 
0x37CA2318, 38092254558503632, 224944037, 224944044, 7, 1440x900 
0x37CA2318, 38092254559163688, 224944102, 224944109, 7, 1440x900 
0x37CA2318, 38092254559823704, 224944167, 224944175, 8, 1440x900 
0x37CA2318, 38092254560484200, 224944234, 224944241, 7, 1440x900 
0x37CA2318, 38092254561144312, 224944299, 224944307, 8, 1440x900 
0x37CA2318, 38092254561804600, 224944367, 224944374, 7, 1440x900 
0x37CA2318, 38092254562466592, 224944432, 224944440, 8, 1440x900 
0x37CA2318, 38092254563129112, 224944502, 224944510, 8, 1440x900 
0x37CA2318, 38092254563786880, 224944566, 224944573, 7, 1440x900 
0x37CA2318, 38092254564448600, 224944631, 224944639, 8, 1440x900 
0x37CA2318, 38092254565107056, 224944697, 224944705, 8, 1440x900 
0x37CA2318, 38092254565768208, 224944767, 224944774, 7, 1440x900 
0x37CA2318, 38092254566426088, 224944828, 224944836, 8, 1440x900 
0x37CA2318, 38092254567095688, 224944897, 224944904, 7, 1440x900 
0x37CA2318, 38092254567755080, 224944960, 224944968, 8, 1440x900 
0x37CA2318, 38092254568416552, 224945028, 224945036, 8, 1440x900 
0x37CA2318, 38092254569075248, 224945096, 224945119, 23, 1440x900 
0x37CA2318, 38092254569768792, 224945163, 224945171, 8, 1440x900 
0x37CA2318, 38092254570397968, 224945223, 224945232, 9, 1440x900 
0x37CA2318, 38092254571057016, 224945292, 224945300, 8, 1440x900 
0x37CA2318, 38092254571730848, 224945358, 224945366, 8, 1440x900 
0x37CA2318, 38092254572581624, 224945442, 224945450, 8, 1440x900 
0x37CA2318, 38092254573232296, 224945508, 224945516, 8, 1440x900 
0x37CA2318, 38092254573883400, 224945573, 224945581, 8, 1440x900 
0x37CA2318, 38092254574543720, 224945642, 224945649, 7, 1440x900 
0x37CA2318, 38092254575205832, 224945707, 224945715, 8, 1440x900 
0x37CA2318, 38092254575883552, 224945780, 224945787, 7, 1440x900 
0x37CA2318, 38092254576347192, 224945818, 224945826, 8, 1440x900 
0x37CA2318, 38092254577212512, 224945908, 224945915, 7, 1440x900 
0x37CA2318, 38092254577882168, 224945973, 224945981, 8, 1440x900 
0x37CA2318, 38092254578540904, 224946038, 224946046, 8, 1440x900 
0x37CA2318, 38092254579214896, 224946107, 224946114, 7, 1440x900 
0x37CA2318, 38092254579857992, 224946182, 224946190, 8, 1440x900 
0x37CA2318, 38092254580527224, 224946238, 224946246, 8, 1440x900 
0x37CA2318, 38092254581151848, 224946302, 224946309, 7, 1440x900 
0x37CA2318, 38092254581760040, 224946364, 224946374, 10, 1440x900 
0x37CA2318, 38092254582507800, 224946437, 224946446, 9, 1440x900 
0x37CA2318, 38092254583187296, 224946504, 224946516, 12, 1440x900 
0x37CA2318, 38092254583846864, 224946572, 224946579, 7, 1440x900 
0x37CA2318, 38092254584642144, 224946650, 224946659, 9, 1440x900 
0x37CA2318, 38092254585082752, 224946700, 224946724, 24, 1440x900 
0x37CA2318, 38092254585756160, 224946764, 224946773, 9, 1440x900 
0x37CA2318, 38092254586391840, 224946831, 224946845, 14, 1440x900 
0x37CA2318, 38092254587078640, 224946893, 224946902, 9, 1440x900 
0x37CA2318, 38092254587710720, 224946957, 224946966, 9, 1440x900 
0x37CA2318, 38092254588378184, 224947025, 224947033, 8, 1440x900 
0x37CA2318, 38092254589036240, 224947088, 224947099, 11, 1440x900 
0x37CA2318, 38092254589709928, 224947164, 224947173, 9, 1440x900 
0x37CA2318, 38092254590425544, 224947228, 224947236, 8, 1440x900 
0x37CA2318, 38092254591035048, 224947287, 224947295, 8, 1440x900 
0x37CA2318, 38092254591885928, 224947373, 224947381, 8, 1440x900 
0x37CA2318, 38092254592380440, 224947423, 224947431, 8, 1440x900 
0x37CA2318, 38092254593016792, 224947487, 224947494, 7, 1440x900 
0x37CA2318, 38092254593688176, 224947553, 224947561, 8, 1440x900 
0x37CA2318, 38092254594347328, 224947622, 224947630, 8, 1440x900 
0x37CA2318, 38092254595107976, 224947697, 224947706, 9, 1440x900 
0x37CA2318, 38092254595671920, 224947752, 224947759, 7, 1440x900 
0x37CA2318, 38092254596331248, 224947817, 224947825, 8, 1440x900 
0x37CA2318, 38092254596999360, 224947886, 224947896, 10, 1440x900 
0x37CA2318, 38092254597660608, 224947952, 224947959, 7, 1440x900 
0x37CA2318, 38092254598326112, 224948017, 224948025, 8, 1440x900 
0x37CA2318, 38092254598990520, 224948086, 224948093, 7, 1440x900 
0x37CA2318, 38092254599667224, 224948152, 224948159, 7, 1440x900 
0x37CA2318, 38092254600337856, 224948222, 224948231, 9, 1440x900 
0x37CA2318, 38092254600976224, 224948287, 224948294, 7, 1440x900 
0x37CA2318, 38092254601632520, 224948348, 224948356, 8, 1440x900 
0x37CA2318, 38092254602567008, 224948447, 224948454, 7, 1440x900 
0x37CA2318, 38092254602945312, 224948478, 224948486, 8, 1440x900 
0x37CA2318, 38092254603605064, 224948547, 224948555, 8, 1440x900 
0x37CA2318, 38092254604265152, 224948613, 224948619, 6, 1440x900 
0x37CA2318, 38092254604927032, 224948677, 224948684, 7, 1440x900 
0x37CA2318, 38092254605586984, 224948743, 224948751, 8, 1440x900 
0x37CA2318, 38092254606260064, 224948816, 224948826, 10, 1440x900 
0x37CA2318, 38092254606912968, 224948877, 224948885, 8, 1440x900 
0x37CA2318, 38092254607573448, 224948943, 224948950, 7, 1440x900 
0x37CA2318, 38092254608232832, 224949007, 224949015, 8, 1440x900 
0x37CA2318, 38092254608895032, 224949079, 224949086, 7, 1440x900 
0x37CA2318, 38092254609554520, 224949142, 224949148, 6, 1440x900 
0x37CA2318, 38092254610215360, 224949208, 224949215, 7, 1440x900 
0x37CA2318, 38092254610874856, 224949272, 224949280, 8, 1440x900 
0x37CA2318, 38092254611535032, 224949342, 224949349, 7, 1440x900 
0x37CA2318, 38092254612194936, 224949403, 224949411, 8, 1440x900 
0x37CA2318, 38092254612855336, 224949469, 224949478, 9, 1440x900 
0x37CA2318, 38092254613515408, 224949538, 224949545, 7, 1440x900 
0x37CA2318, 38092254614176096, 224949602, 224949610, 8, 1440x900 
0x37CA2318, 38092254614834464, 224949672, 224949679, 7, 1440x900 
0x37CA2318, 38092254615543616, 224949739, 224949748, 9, 1440x900 
0x37CA2318, 38092254616161688, 224949800, 224949808, 8, 1440x900 
0x37CA2318, 38092254616816464, 224949868, 224949876, 8, 1440x900 
0x37CA2318, 38092254617481064, 224949937, 224949945, 8, 1440x900 
0x37CA2318, 38092254618140960, 224949998, 224950007, 9, 1440x900 
0x37CA2318, 38092254618955440, 224950092, 224950105, 13, 1440x900 
0x37CA2318, 38092254619488656, 224950138, 224950145, 7, 1440x900 
0x37CA2318, 38092254620130648, 224950204, 224950210, 6, 1440x900 
0x37CA2318, 38092254620790448, 224950263, 224950272, 9, 1440x900 
0x37CA2318, 38092254621454624, 224950328, 224950339, 11, 1440x900 
0x37CA2318, 38092254622128888, 224950410, 224950421, 11, 1440x900 
0x37CA2318, 38092254622804144, 224950469, 224950477, 8, 1440x900 
0x37CA2318, 38092254623476808, 224950539, 224950551, 12, 1440x900 
0x37CA2318, 38092254624135200, 224950603, 224950612, 9, 1440x900 
0x37CA2318, 38092254624790656, 224950663, 224950676, 13, 1440x900 
0x37CA2318, 38092254625449048, 224950737, 224950745, 8, 1440x900 
0x37CA2318, 38092254626111832, 224950802, 224950810, 8, 1440x900 
0x37CA2318, 38092254626751032, 224950862, 224950871, 9, 1440x900 
0x37CA2318, 38092254627428784, 224950929, 224950940, 11, 1440x900 
0x37CA2318, 38092254628077584, 224950992, 224951002, 10, 1440x900 
0x37CA2318, 38092254628736552, 224951058, 224951069, 11, 1440x900 
0x37CA2318, 38092254629413048, 224951127, 224951138, 11, 1440x900 
0x37CA2318, 38092254630058944, 224951190, 224951202, 12, 1440x900 
0x37CA2318, 38092254630784472, 224951262, 224951274, 12, 1440x900 
0x37CA2318, 38092254631394896, 224951326, 224951337, 11, 1440x900 
0x37CA2318, 38092254632074832, 224951393, 224951403, 10, 1440x900 
0x37CA2318, 38092254632723560, 224951458, 224951468, 10, 1440x900 
0x37CA2318, 38092254633383032, 224951523, 224951531, 8, 1440x900 
0x37CA2318, 38092254634040640, 224951588, 224951596, 8, 1440x900 
0x37CA2318, 38092254634709240, 224951657, 224951664, 7, 1440x900 
0x37CA2318, 38092254635371024, 224951723, 224951731, 8, 1440x900 
0x37CA2318, 38092254636029128, 224951791, 224951798, 7, 1440x900 
0x37CA2318, 38092254636689824, 224951858, 224951864, 6, 1440x900 
0x37CA2318, 38092254637359064, 224951922, 224951930, 8, 1440x900 
0x37CA2318, 38092254638004000, 224951988, 224951996, 8, 1440x900 
0x37CA2318, 38092254638664896, 224952052, 224952060, 8, 1440x900 
0x37CA2318, 38092254639323416, 224952122, 224952128, 6, 1440x900 
0x37CA2318, 38092254639990104, 224952182, 224952191, 9, 1440x900 
0x37CA2318, 38092254640653784, 224952254, 224952261, 7, 1440x900 
0x37CA2318, 38092254641315184, 224952317, 224952326, 9, 1440x900 
0x37CA2318, 38092254642640248, 224952453, 224952461, 8, 1440x900 
0x37CA2318, 38092254643302616, 224952519, 224952527, 8, 1440x900 
0x37CA2318, 38092254643959784, 224952583, 224952592, 9, 1440x900 
0x37CA2318, 38092254644621472, 224952647, 224952657, 10, 1440x900 
0x37CA2318, 38092254645277440, 224952713, 224952722, 9, 1440x900 
0x37CA2318, 38092254645937192, 224952778, 224952786, 8, 1440x900 
0x37CA2318, 38092254646597264, 224952847, 224952856, 9, 1440x900 
0x37CA2318, 38092254647257272, 224952912, 224952920, 8, 1440x900 
0x37CA2318, 38092254647919808, 224952977, 224952985, 8, 1440x900 
0x37CA2318, 38092254648578552, 224953043, 224953051, 8, 1440x900 
0x37CA2318, 38092254649238984, 224953107, 224953115, 8, 1440x900 
0x37CA2318, 38092254649900328, 224953176, 224953184, 8, 1440x900 
0x37CA2318, 38092254650560400, 224953243, 224953251, 8, 1440x900 
0x37CA2318, 38092254651299312, 224953318, 224953326, 8, 1440x900 
0x37CA2318, 38092254651891104, 224953374, 224953382, 8, 1440x900 
0x37CA2318, 38092254652539592, 224953442, 224953454, 12, 1440x900 
0x37CA2318, 38092254653231936, 224953508, 224953516, 8, 1440x900 
0x37CA2318, 38092254653859032, 224953575, 224953587, 12, 1440x900 
0x37CA2318, 38092254654537792, 224953642, 224953649, 7, 1440x900 
0x37CA2318, 38092254655179784, 224953704, 224953712, 8, 1440x900 
0x37CA2318, 38092254655858304, 224953773, 224953787, 14, 1440x900 
0x37CA2318, 38092254656517664, 224953843, 224953851, 8, 1440x900 
0x37CA2318, 38092254657161400, 224953902, 224953909, 7, 1440x900 
0x37CA2318, 38092254657815472, 224953967, 224953974, 7, 1440x900 
0x37CA2318, 38092254658683096, 224954053, 224954061, 8, 1440x900 
0x37CA2318, 38092254659142416, 224954098, 224954105, 7, 1440x900 
0x37CA2318, 38092254659804200, 224954167, 224954174, 7, 1440x900 
0x37CA2318, 38092254660464240, 224954233, 224954240, 7, 1440x900 
0x37CA2318, 38092254661321304, 224954318, 224954325, 7, 1440x900 
0x37CA2318, 38092254661846720, 224954374, 224954384, 10, 1440x900 
0x37CA2318, 38092254662478016, 224954432, 224954442, 10, 1440x900 
0x37CA2318, 38092254663117288, 224954498, 224954505, 7, 1440x900 
0x37CA2318, 38092254663776608, 224954562, 224954573, 11, 1440x900 
0x37CA2318, 38092254664460640, 224954632, 224954639, 7, 1440x900 
0x37CA2318, 38092254665287840, 224954719, 224954727, 8, 1440x900 
0x37CA2318, 38092254665810408, 224954773, 224954781, 8, 1440x900 
0x37CA2318, 38092254666417536, 224954833, 224954842, 9, 1440x900 
0x37CA2318, 38092254667071456, 224954892, 224954900, 8, 1440x900 
0x37CA2318, 38092254667729824, 224954959, 224954967, 8, 1440x900 
0x37CA2318, 38092254668445624, 224955033, 224955050, 17, 1440x900 
0x37CA2318, 38092254669094928, 224955096, 224955105, 9, 1440x900 
0x37CA2318, 38092254669751400, 224955162, 224955170, 8, 1440x900 
0x37CA2318, 38092254670396480, 224955224, 224955233, 9, 1440x900 
0x37CA2318, 38092254671043776, 224955292, 224955299, 7, 1440x900 
0x37CA2318, 38092254671706472, 224955359, 224955367, 8, 1440x900 
0x37CA2318, 38092254672374544, 224955423, 224955431, 8, 1440x900 
0x37CA2318, 38092254673020984, 224955488, 224955498, 10, 1440x900 
0x37CA2318, 38092254673762480, 224955563, 224955573, 10, 1440x900 
0x37CA2318, 38092254674372920, 224955624, 224955635, 11, 1440x900 
0x37CA2318, 38092254675014096, 224955688, 224955696, 8, 1440x900 
0x37CA2318, 38092254675672696, 224955755, 224955764, 9, 1440x900 
0x37CA2318, 38092254676362920, 224955824, 224955831, 7, 1440x900 
0x37CA2318, 38092254677011888, 224955888, 224955896, 8, 1440x900 
0x37CA2318, 38092254677671000, 224955953, 224955961, 8, 1440x900 
0x37CA2318, 38092254678311392, 224956017, 224956031, 14, 1440x900 
0x37CA2318, 38092254678998536, 224956088, 224956095, 7, 1440x900 
0x37CA2318, 38092254679632952, 224956149, 224956157, 8, 1440x900 
0x37CA2318, 38092254680322128, 224956219, 224956227, 8, 1440x900 
0x37CA2318, 38092254680969296, 224956283, 224956290, 7, 1440x900 
0x37CA2318, 38092254681629552, 224956348, 224956356, 8, 1440x900 
0x37CA2318, 38092254682289528, 224956414, 224956423, 9, 1440x900 
0x37CA2318, 38092254682949560, 224956479, 224956486, 7, 1440x900 
0x37CA2318, 38092254683609544, 224956548, 224956554, 6, 1440x900 
0x37CA2318, 38092254684269384, 224956612, 224956619, 7, 1440x900 
0x37CA2318, 38092254684930688, 224956678, 224956686, 8, 1440x900 
0x37CA2318, 38092254685593160, 224956747, 224956754, 7, 1440x900 
0x37CA2318, 38092254686253768, 224956812, 224956819, 7, 1440x900 
0x37CA2318, 38092254686916920, 224956878, 224956885, 7, 1440x900 
0x37CA2318, 38092254687650624, 224956953, 224956966, 13, 1440x900 
0x37CA2318, 38092254688295992, 224957017, 224957025, 8, 1440x900 
0x37CA2318, 38092254688924784, 224957078, 224957087, 9, 1440x900 
0x37CA2318, 38092254689584496, 224957142, 224957150, 8, 1440x900 
0x37CA2318, 38092254690273792, 224957212, 224957228, 16, 1440x900 
0x37CA2318, 38092254690931784, 224957277, 224957285, 8, 1440x900 
0x37CA2318, 38092254691699856, 224957363, 224957379, 16, 1440x900 
0x37CA2318, 38092254692330128, 224957426, 224957433, 7, 1440x900 
0x37CA2318, 38092254692946592, 224957482, 224957489, 7, 1440x900 
0x37CA2318, 38092254693581320, 224957542, 224957550, 8, 1440x900 
0x37CA2318, 38092254694241888, 224957613, 224957620, 7, 1440x900 
0x37CA2318, 38092254694928608, 224957678, 224957686, 8, 1440x900 
0x37CA2318, 38092254695560936, 224957742, 224957749, 7, 1440x900 
0x37CA2318, 38092254696217600, 224957808, 224957815, 7, 1440x900 
0x37CA2318, 38092254696878296, 224957873, 224957881, 8, 1440x900 
0x37CA2318, 38092254697538080, 224957938, 224957946, 8, 1440x900 
0x37CA2318, 38092254698221200, 224958013, 224958026, 13, 1440x900 
0x37CA2318, 38092254698891024, 224958073, 224958081, 8, 1440x900 
0x37CA2318, 38092254699519120, 224958137, 224958145, 8, 1440x900 
0x37CA2318, 38092254700265240, 224958213, 224958221, 8, 1440x900 
0x37CA2318, 38092254700879096, 224958276, 224958284, 8, 1440x900 
0x37CA2318, 38092254701521472, 224958338, 224958346, 8, 1440x900 
0x37CA2318, 38092254702172424, 224958405, 224958412, 7, 1440x900 
0x37CA2318, 38092254702835360, 224958467, 224958476, 9, 1440x900 
0x37CA2318, 38092254703699336, 224958555, 224958563, 8, 1440x900 
0x37CA2318, 38092254704368880, 224958623, 224958632, 9, 1440x900 
0x37CA2318, 38092254705028512, 224958687, 224958696, 9, 1440x900 
0x37CA2318, 38092254705698088, 224958758, 224958766, 8, 1440x900 
0x37CA2318, 38092254706357688, 224958822, 224958829, 7, 1440x900 
0x37CA2318, 38092254707120192, 224958898, 224958907, 9, 1440x900 
0x37CA2318, 38092254707716832, 224958961, 224958968, 7, 1440x900 
0x37CA2318, 38092254708192624, 224959011, 224959018, 7, 1440x900 
0x37CA2318, 38092254709026488, 224959088, 224959096, 8, 1440x900 
0x37CA2318, 38092254709705808, 224959157, 224959164, 7, 1440x900 
0x37CA2318, 38092254710346776, 224959222, 224959229, 7, 1440x900 
0x37CA2318, 38092254711016784, 224959287, 224959295, 8, 1440x900 
0x37CA2318, 38092254711679352, 224959353, 224959360, 7, 1440x900 
0x37CA2318, 38092254712339648, 224959424, 224959436, 12, 1440x900 
0x37CA2318, 38092254712838048, 224959474, 224959486, 12, 1440x900 
0x37CA2318, 38092254713473744, 224959532, 224959540, 8, 1440x900 
0x37CA2318, 38092254714331344, 224959618, 224959629, 11, 1440x900 
0x37CA2318, 38092254714889112, 224959679, 224959691, 12, 1440x900 
0x37CA2318, 38092254715491760, 224959736, 224959745, 9, 1440x900 
0x37CA2318, 38092254716127776, 224959802, 224959810, 8, 1440x900 
0x37CA2318, 38092254716787304, 224959866, 224959874, 8, 1440x900 
0x37CA2318, 38092254717444272, 224959932, 224959939, 7, 1440x900 
0x37CA2318, 38092254718107816, 224959995, 224960003, 8, 1440x900 
0x37CA2318, 38092254718763224, 224960062, 224960069, 7, 1440x900 
0x37CA2318, 38092254719428912, 224960134, 224960142, 8, 1440x900 
0x37CA2318, 38092254720090672, 224960198, 224960206, 8, 1440x900 
0x37CA2318, 38092254720746656, 224960263, 224960271, 8, 1440x900 
0x37CA2318, 38092254721406864, 224960328, 224960336, 8, 1440x900 
0x37CA2318, 38092254722067120, 224960393, 224960402, 9, 1440x900 
0x37CA2318, 38092254722727024, 224960458, 224960467, 9, 1440x900 
0x37CA2318, 38092254723386672, 224960523, 224960536, 13, 1440x900 
0x37CA2318, 38092254724061200, 224960594, 224960602, 8, 1440x900 
0x37CA2318, 38092254724708096, 224960657, 224960666, 9, 1440x900 
0x37CA2318, 38092254725368088, 224960723, 224960731, 8, 1440x900 
0x37CA2318, 38092254726028056, 224960788, 224960796, 8, 1440x900 
0x37CA2318, 38092254726687968, 224960856, 224960864, 8, 1440x900 
0x37CA2318, 38092254728008192, 224960987, 224960995, 8, 1440x900 
0x37CA2318, 38092254728666216, 224961052, 224961061, 9, 1440x900 
0x37CA2318, 38092254729344384, 224961122, 224961130, 8, 1440x900 
0x37CA2318, 38092254730009968, 224961187, 224961196, 9, 1440x900 
0x37CA2318, 38092254730679344, 224961253, 224961262, 9, 1440x900 
0x37CA2318, 38092254731505312, 224961338, 224961345, 7, 1440x900 
0x37CA2318, 38092254732159112, 224961403, 224961410, 7, 1440x900 
0x37CA2318, 38092254732833880, 224961468, 224961476, 8, 1440x900 
0x37CA2318, 38092254733494056, 224961539, 224961546, 7, 1440x900 
0x37CA2318, 38092254734155672, 224961602, 224961609, 7, 1440x900 
0x37CA2318, 38092254734817888, 224961668, 224961675, 7, 1440x900 
0x37CA2318, 38092254735485768, 224961738, 224961746, 8, 1440x900 
0x37CA2318, 38092254736137648, 224961802, 224961810, 8, 1440x900 
0x37CA2318, 38092254736800128, 224961872, 224961880, 8, 1440x900 
0x37CA2318, 38092254737469384, 224961938, 224961946, 8, 1440x900 
0x37CA2318, 38092254738127408, 224961997, 224962005, 8, 1440x900 
0x37CA2318, 38092254738797232, 224962066, 224962073, 7, 1440x900 
0x37CA2318, 38092254739456800, 224962132, 224962139, 7, 1440x900 
0x37CA2318, 38092254740107040, 224962197, 224962205, 8, 1440x900 
0x37CA2318, 38092254740776152, 224962263, 224962271, 8, 1440x900 
0x37CA2318, 38092254741444904, 224962334, 224962342, 8, 1440x900 
0x37CA2318, 38092254742094696, 224962397, 224962406, 9, 1440x900 
0x37CA2318, 38092254742767048, 224962467, 224962476, 9, 1440x900 
0x37CA2318, 38092254743426520, 224962532, 224962539, 7, 1440x900 
0x37CA2318, 38092254744068816, 224962597, 224962606, 9, 1440x900 
0x37CA2318, 38092254744734528, 224962664, 224962672, 8, 1440x900 
0x37CA2318, 38092254745405992, 224962732, 224962740, 8, 1440x900 
0x37CA2318, 38092254746063824, 224962797, 224962806, 9, 1440x900 
0x37CA2318, 38092254746723328, 224962859, 224962868, 9, 1440x900 
0x37CA2318, 38092254747383832, 224962928, 224962936, 8, 1440x900 
0x37CA2318, 38092254748043176, 224962993, 224963001, 8, 1440x900 
0x37CA2318, 38092254748703944, 224963058, 224963066, 8, 1440x900 
0x37CA2318, 38092254749372520, 224963128, 224963137, 9, 1440x900 
0x37CA2318, 38092254750022824, 224963192, 224963200, 8, 1440x900 
0x37CA2318, 38092254750683592, 224963257, 224963265, 8, 1440x900 
0x37CA2318, 38092254751344568, 224963323, 224963332, 9, 1440x900 
0x37CA2318, 38092254751814560, 224963373, 224963381, 8, 1440x900 
0x37CA2318, 38092254752467848, 224963433, 224963441, 8, 1440x900 
0x37CA2318, 38092254753138296, 224963500, 224963508, 8, 1440x900 
0x37CA2318, 38092254753798768, 224963568, 224963576, 8, 1440x900 
0x37CA2318, 38092254754457872, 224963633, 224963641, 8, 1440x900 
0x37CA2318, 38092254755123560, 224963698, 224963707, 9, 1440x900 
0x37CA2318, 38092254755785712, 224963768, 224963777, 9, 1440x900 
0x37CA2318, 38092254756455680, 224963836, 224963844, 8, 1440x900 
0x37CA2318, 38092254757124080, 224963897, 224963908, 11, 1440x900 
0x37CA2318, 38092254757782584, 224963963, 224963971, 8, 1440x900 
0x37CA2318, 38092254758430656, 224964028, 224964036, 8, 1440x900 
0x37CA2318, 38092254759090816, 224964093, 224964101, 8, 1440x900 
0x37CA2318, 38092254759750752, 224964163, 224964170, 7, 1440x900 
0x37CA2318, 38092254760424992, 224964228, 224964235, 7, 1440x900 
0x37CA2318, 38092254761074736, 224964293, 224964301, 8, 1440x900 
0x37CA2318, 38092254761734072, 224964358, 224964366, 8, 1440x900 
0x37CA2318, 38092254762393728, 224964428, 224964436, 8, 1440x900 
0x37CA2318, 38092254763054024, 224964492, 224964500, 8, 1440x900 
0x37CA2318, 38092254763722256, 224964558, 224964566, 8, 1440x900 
0x37CA2318, 38092254764580800, 224964643, 224964651, 8, 1440x900 
0x37CA2318, 38092254765232008, 224964713, 224964723, 10, 1440x900 
0x37CA2318, 38092254765904776, 224964779, 224964787, 8, 1440x900 
0x37CA2318, 38092254766363136, 224964827, 224964835, 8, 1440x900 
0x37CA2318, 38092254767037016, 224964893, 224964900, 7, 1440x900 
0x37CA2318, 38092254767681328, 224964953, 224964962, 9, 1440x900 
0x37CA2318, 38092254768343280, 224965022, 224965030, 8, 1440x900 
0x37CA2318, 38092254769199616, 224965106, 224965114, 8, 1440x900 
0x37CA2318, 38092254769860856, 224965172, 224965180, 8, 1440x900 
0x37CA2318, 38092254770522336, 224965238, 224965246, 8, 1440x900 
0x37CA2318, 38092254771182632, 224965306, 224965314, 8, 1440x900 
0x37CA2318, 38092254771845824, 224965374, 224965382, 8, 1440x900 
0x37CA2318, 38092254772503888, 224965438, 224965445, 7, 1440x900 
0x37CA2318, 38092254773167496, 224965507, 224965515, 8, 1440x900 
0x37CA2318, 38092254773829568, 224965573, 224965581, 8, 1440x900 
0x37CA2318, 38092254774488976, 224965638, 224965646, 8, 1440x900 
0x37CA2318, 38092254775089808, 224965699, 224965708, 9, 1440x900 
0x37CA2318, 38092254775615032, 224965748, 224965757, 9, 1440x900 
0x37CA2318, 38092254776275088, 224965818, 224965826, 8, 1440x900 
0x37CA2318, 38092254776936768, 224965883, 224965892, 9, 1440x900 
0x37CA2318, 38092254777599008, 224965947, 224965958, 11, 1440x900 
0x37CA2318, 38092254778277024, 224966018, 224966026, 8, 1440x900 
0x37CA2318, 38092254778920464, 224966084, 224966091, 7, 1440x900 
0x37CA2318, 38092254779580496, 224966147, 224966156, 9, 1440x900 
0x37CA2318, 38092254780253288, 224966211, 224966220, 9, 1440x900 
0x37CA2318, 38092254780913960, 224966277, 224966284, 7, 1440x900 
0x37CA2318, 38092254781571088, 224966342, 224966350, 8, 1440x900 
0x37CA2318, 38092254782230696, 224966407, 224966416, 9, 1440x900 
0x37CA2318, 38092254782894560, 224966477, 224966484, 7, 1440x900 
0x37CA2318, 38092254783539152, 224966542, 224966549, 7, 1440x900 
0x37CA2318, 38092254784211448, 224966607, 224966614, 7, 1440x900 
0x37CA2318, 38092254785051216, 224966691, 224966699, 8, 1440x900 
0x37CA2318, 38092254785644640, 224966752, 224966760, 8, 1440x900 
0x37CA2318, 38092254786197824, 224966807, 224966815, 8, 1440x900 
0x37CA2318, 38092254786844928, 224966874, 224966882, 8, 1440x900 
0x37CA2318, 38092254787516480, 224966938, 224966945, 7, 1440x900 
0x37CA2318, 38092254788176072, 224967003, 224967011, 8, 1440x900 
0x37CA2318, 38092254789483128, 224967133, 224967142, 9, 1440x900 
0x37CA2318, 38092254790144848, 224967202, 224967210, 8, 1440x900 
0x37CA2318, 38092254790809768, 224967268, 224967276, 8, 1440x900 
0x37CA2318, 38092254791476344, 224967333, 224967341, 8, 1440x900 
0x37CA2318, 38092254792124608, 224967398, 224967406, 8, 1440x900 
0x37CA2318, 38092254792792768, 224967463, 224967471, 8, 1440x900 
0x37CA2318, 38092254793452824, 224967532, 224967540, 8, 1440x900 
0x37CA2318, 38092254794126072, 224967597, 224967605, 8, 1440x900 
0x37CA2318, 38092254794773768, 224967662, 224967670, 8, 1440x900 
0x37CA2318, 38092254795482048, 224967733, 224967742, 9, 1440x900 
0x37CA2318, 38092254796094352, 224967796, 224967805, 9, 1440x900 
0x37CA2318, 38092254796769520, 224967862, 224967870, 8, 1440x900 
0x37CA2318, 38092254797418232, 224967928, 224967936, 8, 1440x900 
0x37CA2318, 38092254798077424, 224967993, 224968001, 8, 1440x900 
0x37CA2318, 38092254798737480, 224968061, 224968069, 8, 1440x900 
0x37CA2318, 38092254799405328, 224968127, 224968138, 11, 1440x900 
0x37CA2318, 38092254800080184, 224968193, 224968201, 8, 1440x900 
0x37CA2318, 38092254800726032, 224968261, 224968269, 8, 1440x900 
0x37CA2318, 38092254801385456, 224968322, 224968331, 9, 1440x900 
0x37CA2318, 38092254802045520, 224968392, 224968400, 8, 1440x900 
0x37CA2318, 38092254802705520, 224968457, 224968465, 8, 1440x900 
0x37CA2318, 38092254803569520, 224968548, 224968556, 8, 1440x900 
0x37CA2318, 38092254804229728, 224968613, 224968621, 8, 1440x900 
0x37CA2318, 38092254804891544, 224968677, 224968685, 8, 1440x900 
0x37CA2318, 38092254805553064, 224968743, 224968752, 9, 1440x900 
0x37CA2318, 38092254806221744, 224968813, 224968821, 8, 1440x900 
0x37CA2318, 38092254806677344, 224968858, 224968866, 8, 1440x900 
0x37CA2318, 38092254807342392, 224968927, 224968935, 8, 1440x900 
0x37CA2318, 38092254808002264, 224968991, 224968999, 8, 1440x900 
0x37CA2318, 38092254808659904, 224969052, 224969061, 9, 1440x900 
0x37CA2318, 38092254809319016, 224969117, 224969125, 8, 1440x900 
0x37CA2318, 38092254809992760, 224969188, 224969197, 9, 1440x900 
0x37CA2318, 38092254810668992, 224969253, 224969261, 8, 1440x900 
0x37CA2318, 38092254811298648, 224969317, 224969324, 7, 1440x900 
0x37CA2318, 38092254811969176, 224969383, 224969391, 8, 1440x900 
0x37CA2318, 38092254812826592, 224969472, 224969481, 9, 1440x900 
0x37CA2318, 38092254813489528, 224969537, 224969545, 8, 1440x900 
0x37CA2318, 38092254814157024, 224969603, 224969612, 9, 1440x900 
0x37CA2318, 38092254814810408, 224969667, 224969676, 9, 1440x900 
0x37CA2318, 38092254815471600, 224969738, 224969746, 8, 1440x900 
0x37CA2318, 38092254816123504, 224969802, 224969810, 8, 1440x900 
0x37CA2318, 38092254816793616, 224969867, 224969875, 8, 1440x900 
0x37CA2318, 38092254817453056, 224969933, 224969942, 9, 1440x900 
0x37CA2318, 38092254818114368, 224970004, 224970011, 7, 1440x900 
0x37CA2318, 38092254818774272, 224970067, 224970075, 8, 1440x900 
0x37CA2318, 38092254819435736, 224970133, 224970142, 9, 1440x900 
0x37CA2318, 38092254820054280, 224970198, 224970206, 8, 1440x900 
0x37CA2318, 38092254820560184, 224970248, 224970256, 8, 1440x900 
0x37CA2318, 38092254821222960, 224970314, 224970323, 9, 1440x900 
0x37CA2318, 38092254821879328, 224970378, 224970386, 8, 1440x900 
0x37CA2318, 38092254822538720, 224970439, 224970447, 8, 1440x900 
0x37CA2318, 38092254823396512, 224970527, 224970535, 8, 1440x900 
0x37CA2318, 38092254824062680, 224970592, 224970599, 7, 1440x900 
0x37CA2318, 38092254824604008, 224970647, 224970655, 8, 1440x900 
0x37CA2318, 38092254825181352, 224970706, 224970714, 8, 1440x900 
0x37CA2318, 38092254825841408, 224970773, 224970780, 7, 1440x900 
0x37CA2318, 38092254826502072, 224970838, 224970846, 8, 1440x900 
0x37CA2318, 38092254827164128, 224970908, 224970916, 8, 1440x900 
0x37CA2318, 38092254828020400, 224970993, 224971001, 8, 1440x900 
0x37CA2318, 38092254828689688, 224971057, 224971066, 9, 1440x900 
0x37CA2318, 38092254829145712, 224971102, 224971111, 9, 1440x900 
0x37CA2318, 38092254829806224, 224971172, 224971180, 8, 1440x900 
0x37CA2318, 38092254830466128, 224971234, 224971243, 9, 1440x900 
0x37CA2318, 38092254831124448, 224971298, 224971305, 7, 1440x900 
0x37CA2318, 38092254831981928, 224971383, 224971391, 8, 1440x900 
0x37CA2318, 38092254832644456, 224971452, 224971460, 8, 1440x900 
0x37CA2318, 38092254833305960, 224971520, 224971529, 9, 1440x900 
0x37CA2318, 38092254833966632, 224971588, 224971596, 8, 1440x900 
0x37CA2318, 38092254834619104, 224971653, 224971661, 8, 1440x900 
0x37CA2318, 38092254835289976, 224971718, 224971726, 8, 1440x900 
0x37CA2318, 38092254835775904, 224971767, 224971776, 9, 1440x900 
0x37CA2318, 38092254836464040, 224971833, 224971840, 7, 1440x900 
0x37CA2318, 38092254837098696, 224971894, 224971903, 9, 1440x900 
0x37CA2318, 38092254837788112, 224971963, 224971972, 9, 1440x900 
0x37CA2318, 38092254838490416, 224972035, 224972046, 11, 1440x900 
0x37CA2318, 38092254839113960, 224972098, 224972108, 10, 1440x900 
0x37CA2318, 38092254839746048, 224972160, 224972169, 9, 1440x900 
0x37CA2318, 38092254840439128, 224972232, 224972239, 7, 1440x900 
0x37CA2318, 38092254841068240, 224972292, 224972300, 8, 1440x900 
0x37CA2318, 38092254841719008, 224972357, 224972366, 9, 1440x900 
0x37CA2318, 38092254842390632, 224972425, 224972434, 9, 1440x900 
0x37CA2318, 38092254843048736, 224972494, 224972502, 8, 1440x900 
0x37CA2318, 38092254843721336, 224972560, 224972570, 10, 1440x900 
0x37CA2318, 38092254844395624, 224972624, 224972633, 9, 1440x900 
0x37CA2318, 38092254845021760, 224972687, 224972696, 9, 1440x900 
0x37CA2318, 38092254845681072, 224972753, 224972761, 8, 1440x900 
0x37CA2318, 38092254846341488, 224972818, 224972826, 8, 1440x900 
0x37CA2318, 38092254846998792, 224972887, 224972894, 7, 1440x900 
0x37CA2318, 38092254847658280, 224972953, 224972960, 7, 1440x900 
0x37CA2318, 38092254848328040, 224973024, 224973032, 8, 1440x900 
0x37CA2318, 38092254848989968, 224973089, 224973098, 9, 1440x900 
0x37CA2318, 38092254849645664, 224973152, 224973160, 8, 1440x900 
0x37CA2318, 38092254850302416, 224973217, 224973225, 8, 1440x900 
0x37CA2318, 38092254850994488, 224973283, 224973292, 9, 1440x900 
0x37CA2318, 38092254851627072, 224973348, 224973357, 9, 1440x900 
0x37CA2318, 38092254852296208, 224973415, 224973424, 9, 1440x900 
0x37CA2318, 38092254852952696, 224973482, 224973489, 7, 1440x900 
0x37CA2318, 38092254853612400, 224973547, 224973554, 7, 1440x900 
0x37CA2318, 38092254854280016, 224973613, 224973621, 8, 1440x900 
0x37CA2318, 38092254854973184, 224973684, 224973695, 11, 1440x900 
0x37CA2318, 38092254855631504, 224973748, 224973756, 8, 1440x900 
0x37CA2318, 38092254856276048, 224973812, 224973820, 8, 1440x900 
0x37CA2318, 38092254856983816, 224973883, 224973891, 8, 1440x900 
0x37CA2318, 38092254857617176, 224973947, 224973955, 8, 1440x900 
0x37CA2318, 38092254858269128, 224974013, 224974020, 7, 1440x900 
0x37CA2318, 38092254858926016, 224974077, 224974085, 8, 1440x900 
0x37CA2318, 38092254859587864, 224974143, 224974151, 8, 1440x900 
0x37CA2318, 38092254860261472, 224974218, 224974227, 9, 1440x900 
0x37CA2318, 38092254860925072, 224974283, 224974292, 9, 1440x900 
0x37CA2318, 38092254861581824, 224974343, 224974354, 11, 1440x900 
0x37CA2318, 38092254862243712, 224974415, 224974433, 18, 1440x900 
0x37CA2318, 38092254862925872, 224974480, 224974488, 8, 1440x900 
0x37CA2318, 38092254863572032, 224974547, 224974555, 8, 1440x900 
0x37CA2318, 38092254864889704, 224974673, 224974686, 13, 1440x900 
0x37CA2318, 38092254865550088, 224974744, 224974752, 8, 1440x900 
0x37CA2318, 38092254866210560, 224974807, 224974815, 8, 1440x900 
0x37CA2318, 38092254866870976, 224974872, 224974883, 11, 1440x900 
0x37CA2318, 38092254867531032, 224974938, 224974948, 10, 1440x900 
0x37CA2318, 38092254868206384, 224975008, 224975022, 14, 1440x900 
0x37CA2318, 38092254868863584, 224975072, 224975080, 8, 1440x900 
0x37CA2318, 38092254869524560, 224975139, 224975153, 14, 1440x900 
0x37CA2318, 38092254870184264, 224975206, 224975217, 11, 1440x900 
0x37CA2318, 38092254870834120, 224975268, 224975276, 8, 1440x900 
0x37CA2318, 38092254871683352, 224975353, 224975365, 12, 1440x900 
0x37CA2318, 38092254872334816, 224975418, 224975426, 8, 1440x900 
0x37CA2318, 38092254873000152, 224975487, 224975496, 9, 1440x900 
0x37CA2318, 38092254873659968, 224975552, 224975559, 7, 1440x900 
0x37CA2318, 38092254874320160, 224975617, 224975624, 7, 1440x900 
0x37CA2318, 38092254874982816, 224975688, 224975696, 8, 1440x900 
0x37CA2318, 38092254875645872, 224975752, 224975760, 8, 1440x900 
0x37CA2318, 38092254876308536, 224975817, 224975827, 10, 1440x900 
0x37CA2318, 38092254876975176, 224975888, 224975896, 8, 1440x900 
0x37CA2318, 38092254877636592, 224975952, 224975960, 8, 1440x900 
0x37CA2318, 38092254878297200, 224976017, 224976026, 9, 1440x900 
0x37CA2318, 38092254878958608, 224976087, 224976095, 8, 1440x900 
0x37CA2318, 38092254879619296, 224976153, 224976161, 8, 1440x900 
0x37CA2318, 38092254880280840, 224976217, 224976225, 8, 1440x900 
0x37CA2318, 38092254880941200, 224976283, 224976292, 9, 1440x900 
0x37CA2318, 38092254881607576, 224976352, 224976360, 8, 1440x900 
0x37CA2318, 38092254882256832, 224976413, 224976422, 9, 1440x900 
0x37CA2318, 38092254882928416, 224976483, 224976491, 8, 1440x900 
0x37CA2318, 38092254883586936, 224976549, 224976558, 9, 1440x900 
0x37CA2318, 38092254884238456, 224976611, 224976619, 8, 1440x900 
0x37CA2318, 38092254884902032, 224976678, 224976686, 8, 1440x900 
0x37CA2318, 38092254885561832, 224976744, 224976752, 8, 1440x900 
0x37CA2318, 38092254886213808, 224976808, 224976817, 9, 1440x900 
0x37CA2318, 38092254886893464, 224976878, 224976886, 8, 1440x900 
0x37CA2318, 38092254887551816, 224976942, 224976949, 7, 1440x900 
0x37CA2318, 38092254888221168, 224977007, 224977015, 8, 1440x900 
0x37CA2318, 38092254888880704, 224977072, 224977080, 8, 1440x900 
0x37CA2318, 38092254889550576, 224977142, 224977149, 7, 1440x900 
0x37CA2318, 38092254890201304, 224977206, 224977214, 8, 1440x900 
0x37CA2318, 38092254890857688, 224977273, 224977281, 8, 1440x900 
0x37CA2318, 38092254891537240, 224977343, 224977351, 8, 1440x900 
0x37CA2318, 38092254892187648, 224977407, 224977414, 7, 1440x900 
0x37CA2318, 38092254892847872, 224977473, 224977482, 9, 1440x900 
0x37CA2318, 38092254893509096, 224977543, 224977551, 8, 1440x900 
0x37CA2318, 38092254894168632, 224977603, 224977611, 8, 1440x900 
0x37CA2318, 38092254894846944, 224977672, 224977679, 7, 1440x900 
0x37CA2318, 38092254895506584, 224977737, 224977744, 7, 1440x900 
0x37CA2318, 38092254896176272, 224977802, 224977810, 8, 1440x900 
0x37CA2318, 38092254896845808, 224977868, 224977876, 8, 1440x900 
0x37CA2318, 38092254897505472, 224977937, 224977944, 7, 1440x900 
0x37CA2318, 38092254898172288, 224978002, 224978010, 8, 1440x900 
0x37CA2318, 38092254898834688, 224978072, 224978080, 8, 1440x900 
0x37CA2318, 38092254899491400, 224978136, 224978144, 8, 1440x900 
0x37CA2318, 38092254900146080, 224978202, 224978210, 8, 1440x900 
0x37CA2318, 38092254900826120, 224978273, 224978281, 8, 1440x900 
0x37CA2318, 38092254901479184, 224978338, 224978346, 8, 1440x900 
0x37CA2318, 38092254902140304, 224978402, 224978410, 8, 1440x900 
0x37CA2318, 38092254902809144, 224978468, 224978477, 9, 1440x900 
0x37CA2318, 38092254903461344, 224978538, 224978546, 8, 1440x900 
0x37CA2318, 38092254904120512, 224978601, 224978610, 9, 1440x900 
0x37CA2318, 38092254904780624, 224978663, 224978671, 8, 1440x900 
0x37CA2318, 38092254905450168, 224978732, 224978740, 8, 1440x900 
0x37CA2318, 38092254905967176, 224978788, 224978796, 8, 1440x900 
0x37CA2318, 38092254906570184, 224978847, 224978856, 9, 1440x900 
0x37CA2318, 38092254907230456, 224978914, 224978922, 8, 1440x900 
0x37CA2318, 38092254907914680, 224978978, 224978993, 15, 1440x900 
0x37CA2318, 38092254908583920, 224979043, 224979057, 14, 1440x900 
0x37CA2318, 38092254909233760, 224979108, 224979116, 8, 1440x900 
0x37CA2318, 38092254909905328, 224979178, 224979192, 14, 1440x900 
0x37CA2318, 38092254910568720, 224979244, 224979259, 15, 1440x900 
0x37CA2318, 38092254911236736, 224979312, 224979326, 14, 1440x900 
0x37CA2318, 38092254911889496, 224979376, 224979386, 10, 1440x900 
0x37CA2318, 38092254912530792, 224979437, 224979445, 8, 1440x900 
0x37CA2318, 38092254913389240, 224979526, 224979534, 8, 1440x900 
0x37CA2318, 38092254914048656, 224979592, 224979601, 9, 1440x900 
0x37CA2318, 38092254914698584, 224979657, 224979665, 8, 1440x900 
0x37CA2318, 38092254915358920, 224979727, 224979735, 8, 1440x900 
0x37CA2318, 38092254916021088, 224979793, 224979801, 8, 1440x900 
0x37CA2318, 38092254916682288, 224979857, 224979865, 8, 1440x900 
0x37CA2318, 38092254917352304, 224979923, 224979932, 9, 1440x900 
0x37CA2318, 38092254918003360, 224979987, 224979996, 9, 1440x900 
0x37CA2318, 38092254918667520, 224980057, 224980065, 8, 1440x900 
0x37CA2318, 38092254919327152, 224980122, 224980130, 8, 1440x900 
0x37CA2318, 38092254919988744, 224980187, 224980196, 9, 1440x900 
0x37CA2318, 38092254920657696, 224980253, 224980262, 9, 1440x900 
0x37CA2318, 38092254921308784, 224980317, 224980325, 8, 1440x900 
0x37CA2318, 38092254921961968, 224980383, 224980390, 7, 1440x900 
0x37CA2318, 38092254922639456, 224980453, 224980460, 7, 1440x900 
0x37CA2318, 38092254923294368, 224980516, 224980524, 8, 1440x900 
0x37CA2318, 38092254923954944, 224980584, 224980592, 8, 1440x900 
0x37CA2318, 38092254924631912, 224980652, 224980662, 10, 1440x900 
0x37CA2318, 38092254925283384, 224980714, 224980722, 8, 1440x900 
0x37CA2318, 38092254925945248, 224980782, 224980789, 7, 1440x900 
0x37CA2318, 38092254926596752, 224980847, 224980856, 9, 1440x900 
0x37CA2318, 38092254927267920, 224980917, 224980925, 8, 1440x900 
0x37CA2318, 38092254927927672, 224980983, 224980991, 8, 1440x900 
0x37CA2318, 38092254928589664, 224981048, 224981056, 8, 1440x900 
0x37CA2318, 38092254929250000, 224981112, 224981121, 9, 1440x900 
0x37CA2318, 38092254929914592, 224981183, 224981191, 8, 1440x900 
0x37CA2318, 38092254930566992, 224981247, 224981255, 8, 1440x900 
0x37CA2318, 38092254931240848, 224981313, 224981321, 8, 1440x900 
0x37CA2318, 38092254931894688, 224981378, 224981387, 9, 1440x900 
0x37CA2318, 38092254932356208, 224981424, 224981433, 9, 1440x900 
0x37CA2318, 38092254933026208, 224981488, 224981497, 9, 1440x900 
0x37CA2318, 38092254933685560, 224981554, 224981563, 9, 1440x900 
0x37CA2318, 38092254935018008, 224981688, 224981697, 9, 1440x900 
0x37CA2318, 38092254935681656, 224981754, 224981763, 9, 1440x900 
0x37CA2318, 38092254936340592, 224981818, 224981826, 8, 1440x900 
0x37CA2318, 38092254937189968, 224981903, 224981911, 8, 1440x900 
0x37CA2318, 38092254937841048, 224981968, 224981976, 8, 1440x900 
0x37CA2318, 38092254938505568, 224982036, 224982043, 7, 1440x900 
0x37CA2318, 38092254939177904, 224982104, 224982112, 8, 1440x900 
0x37CA2318, 38092254939834344, 224982172, 224982182, 10, 1440x900 
0x37CA2318, 38092254940487960, 224982237, 224982245, 8, 1440x900 
0x37CA2318, 38092254941148688, 224982307, 224982315, 8, 1440x900 
0x37CA2318, 38092254941809440, 224982369, 224982377, 8, 1440x900 
0x37CA2318, 38092254942478120, 224982438, 224982446, 8, 1440x900 
0x37CA2318, 38092254943139016, 224982503, 224982511, 8, 1440x900 
0x37CA2318, 38092254943789776, 224982568, 224982576, 8, 1440x900 
0x37CA2318, 38092254944450272, 224982632, 224982641, 9, 1440x900 
0x37CA2318, 38092254945120176, 224982701, 224982709, 8, 1440x900 
0x37CA2318, 38092254945771208, 224982768, 224982777, 9, 1440x900 
0x37CA2318, 38092254946426816, 224982832, 224982840, 8, 1440x900 
0x37CA2318, 38092254947099712, 224982898, 224982906, 8, 1440x900 
0x37CA2318, 38092254947750416, 224982963, 224982972, 9, 1440x900 
0x37CA2318, 38092254948420664, 224983032, 224983040, 8, 1440x900 
0x37CA2318, 38092254949071664, 224983098, 224983106, 8, 1440x900 
0x37CA2318, 38092254949732408, 224983163, 224983171, 8, 1440x900 
0x37CA2318, 38092254950393296, 224983227, 224983236, 9, 1440x900 
0x37CA2318, 38092254951058792, 224983292, 224983299, 7, 1440x900 
0x37CA2318, 38092254951714480, 224983363, 224983371, 8, 1440x900 
0x37CA2318, 38092254952374432, 224983428, 224983435, 7, 1440x900 
0x37CA2318, 38092254953038320, 224983493, 224983501, 8, 1440x900 
0x37CA2318, 38092254953699584, 224983558, 224983566, 8, 1440x900 
0x37CA2318, 38092254954351032, 224983622, 224983631, 9, 1440x900 
0x37CA2318, 38092254955013008, 224983692, 224983700, 8, 1440x900 
0x37CA2318, 38092254955692696, 224983758, 224983766, 8, 1440x900 
0x37CA2318, 38092254956345496, 224983822, 224983830, 8, 1440x900 
0x37CA2318, 38092254956922704, 224983878, 224983886, 8, 1440x900 
0x37CA2318, 38092254957466400, 224983932, 224983940, 8, 1440x900 
0x37CA2318, 38092254958132656, 224984004, 224984013, 9, 1440x900 
0x37CA2318, 38092254958790400, 224984068, 224984077, 9, 1440x900 
0x37CA2318, 38092254959454896, 224984138, 224984147, 9, 1440x900 
0x37CA2318, 38092254960114960, 224984203, 224984213, 10, 1440x900 
0x37CA2318, 38092254960776632, 224984268, 224984276, 8, 1440x900 
0x37CA2318, 38092254961446400, 224984333, 224984342, 9, 1440x900 
0x37CA2318, 38092254962116208, 224984397, 224984406, 9, 1440x900 
0x37CA2318, 38092254962782744, 224984463, 224984473, 10, 1440x900 
0x37CA2318, 38092254963442360, 224984528, 224984536, 8, 1440x900 
0x37CA2318, 38092254964100016, 224984597, 224984605, 8, 1440x900 
0x37CA2318, 38092254964762560, 224984662, 224984672, 10, 1440x900 
0x37CA2318, 38092254965424336, 224984729, 224984738, 9, 1440x900 
0x37CA2318, 38092254966082680, 224984797, 224984806, 9, 1440x900 
0x37CA2318, 38092254966742272, 224984861, 224984869, 8, 1440x900 
0x37CA2318, 38092254967585016, 224984943, 224984952, 9, 1440x900 
0x37CA2318, 38092254968203936, 224985007, 224985015, 8, 1440x900 
0x37CA2318, 38092254968711872, 224985058, 224985066, 8, 1440x900 
0x37CA2318, 38092254969495912, 224985172, 224985183, 11, 1440x900 
0x37CA2318, 38092254970151416, 224985202, 224985217, 15, 1440x900 
0x37CA2318, 38092254970803504, 224985267, 224985274, 7, 1440x900 
0x37CA2318, 38092254971566064, 224985342, 224985351, 9, 1440x900 
0x37CA2318, 38092254972156512, 224985402, 224985411, 9, 1440x900 
0x37CA2318, 38092254972796488, 224985466, 224985473, 7, 1440x900 
0x37CA2318, 38092254973456864, 224985532, 224985540, 8, 1440x900 
0x37CA2318, 38092254974125504, 224985598, 224985607, 9, 1440x900 
0x37CA2318, 38092254974807768, 224985667, 224985675, 8, 1440x900 
0x37CA2318, 38092254975469056, 224985732, 224985739, 7, 1440x900 
0x37CA2318, 38092254976291224, 224985813, 224985821, 8, 1440x900 
0x37CA2318, 38092254977014960, 224985904, 224985912, 8, 1440x900 
0x37CA2318, 38092254977683368, 224985957, 224985965, 8, 1440x900 
0x37CA2318, 38092254978388288, 224986023, 224986031, 8, 1440x900 
0x37CA2318, 38092254979006296, 224986087, 224986095, 8, 1440x900 
0x37CA2318, 38092254979662968, 224986151, 224986159, 8, 1440x900 
0x37CA2318, 38092254980322808, 224986218, 224986225, 7, 1440x900 
0x37CA2318, 38092254981123424, 224986297, 224986311, 14, 1440x900 
0x37CA2318, 38092254981665704, 224986352, 224986360, 8, 1440x900 
0x37CA2318, 38092254982317312, 224986417, 224986424, 7, 1440x900 
0x37CA2318, 38092254983037664, 224986488, 224986497, 9, 1440x900 
0x37CA2318, 38092254983650544, 224986552, 224986565, 13, 1440x900 
0x37CA2318, 38092254984307368, 224986617, 224986626, 9, 1440x900 
0x37CA2318, 38092254984968944, 224986682, 224986689, 7, 1440x900 
0x37CA2318, 38092254985654576, 224986752, 224986761, 9, 1440x900 
0x37CA2318, 38092254986314328, 224986817, 224986824, 7, 1440x900 
0x37CA2318, 38092254986960864, 224986881, 224986946, 65, 1440x900 
0x37CA2318, 38092254987672272, 224986962, 224986973, 11, 1440x900 
0x37CA2318, 38092254988301896, 224987017, 224987024, 7, 1440x900 
0x37CA2318, 38092254988933568, 224987077, 224987084, 7, 1440x900 
0x37CA2318, 38092254989593272, 224987142, 224987150, 8, 1440x900 
0x37CA2318, 38092254990739120, 224987287, 224987351, 64, 1440x900 
0x37CA2318, 38092254991820448, 224987368, 224987380, 12, 1440x900 
0x37CA2318, 38092254992051352, 224987390, 224987411, 21, 1440x900 
0x37CA2318, 38092254992548048, 224987446, 224987455, 9, 1440x900 
0x37CA2318, 38092254993408208, 224987537, 224987554, 17, 1440x900 
0x37CA2318, 38092254993884528, 224987583, 224987590, 7, 1440x900 
0x37CA2318, 38092254994621968, 224987652, 224987662, 10, 1440x900 
0x37CA2318, 38092254995234736, 224987708, 224987716, 8, 1440x900 
0x37CA2318, 38092254995900584, 224987777, 224987783, 6, 1440x900 
0x37CA2318, 38092254996532568, 224987838, 224987846, 8, 1440x900 
0x37CA2318, 38092254997320216, 224987917, 224987923, 6, 1440x900 
0x37CA2318, 38092254997854232, 224987972, 224987979, 7, 1440x900 
0x37CA2318, 38092254998513872, 224988037, 224988043, 6, 1440x900 
0x37CA2318, 38092254999276144, 224988113, 224988120, 7, 1440x900 
0x37CA2318, 38092254999844824, 224988173, 224988177, 4, 1440x900 
0x37CA2318, 38092255000497808, 224988242, 224988252, 10, 1440x900 
0x37CA2318, 38092255001187552, 224988303, 224988312, 9, 1440x900 
0x37CA2318, 38092255001822800, 224988368, 224988376, 8, 1440x900 
0x37CA2318, 38092255003170336, 224988502, 224988509, 7, 1440x900 
0x37CA2318, 38092255003818512, 224988580, 224988593, 13, 1440x900 
0x37CA2318, 38092255004469016, 224988632, 224988639, 7, 1440x900 
0x37CA2318, 38092255005131072, 224988697, 224988704, 7, 1440x900 
0x37CA2318, 38092255005809464, 224988767, 224988773, 6, 1440x900 
0x37CA2318, 38092255006454776, 224988832, 224988839, 7, 1440x900 
0x37CA2318, 38092255007108952, 224988897, 224988903, 6, 1440x900 
0x37CA2318, 38092255007765368, 224988962, 224988969, 7, 1440x900 
0x37CA2318, 38092255008432376, 224989032, 224989038, 6, 1440x900 
0x37CA2318, 38092255009091600, 224989094, 224989105, 11, 1440x900 
0x37CA2318, 38092255009758488, 224989164, 224989170, 6, 1440x900 
0x37CA2318, 38092255010486272, 224989233, 224989242, 9, 1440x900 
0x37CA2318, 38092255011102528, 224989302, 224989315, 13, 1440x900 
0x37CA2318, 38092255011757104, 224989363, 224989370, 7, 1440x900 
0x37CA2318, 38092255012413032, 224989428, 224989434, 6, 1440x900 
0x37CA2318, 38092255013054968, 224989493, 224989499, 6, 1440x900 
0x37CA2318, 38092255013714888, 224989558, 224989564, 6, 1440x900 
0x37CA2318, 38092255014390048, 224989623, 224989630, 7, 1440x900 
0x37CA2318, 38092255015034720, 224989688, 224989695, 7, 1440x900 
0x37CA2318, 38092255015695208, 224989753, 224989760, 7, 1440x900 
0x37CA2318, 38092255016354824, 224989821, 224989827, 6, 1440x900 
0x37CA2318, 38092255017023568, 224989888, 224989895, 7, 1440x900 
0x37CA2318, 38092255017899728, 224989994, 224990002, 8, 1440x900 
0x37CA2318, 38092255018355856, 224990023, 224990044, 21, 1440x900 
0x37CA2318, 38092255019096288, 224990097, 224990106, 9, 1440x900 
0x37CA2318, 38092255019746560, 224990158, 224990166, 8, 1440x900 
0x37CA2318, 38092255020327368, 224990219, 224990226, 7, 1440x900 
0x37CA2318, 38092255020987560, 224990287, 224990294, 7, 1440x900 
0x37CA2318, 38092255021646920, 224990353, 224990360, 7, 1440x900 
0x37CA2318, 38092255022343856, 224990419, 224990427, 8, 1440x900 
0x37CA2318, 38092255022976648, 224990483, 224990490, 7, 1440x900 
0x37CA2318, 38092255023827864, 224990568, 224990577, 9, 1440x900 
0x37CA2318, 38092255024507576, 224990642, 224990650, 8, 1440x900 
0x37CA2318, 38092255025166592, 224990704, 224990713, 9, 1440x900 
0x37CA2318, 38092255025625288, 224990752, 224990759, 7, 1440x900 
0x37CA2318, 38092255026284832, 224990817, 224990825, 8, 1440x900 
0x37CA2318, 38092255026942952, 224990882, 224990890, 8, 1440x900 
0x37CA2318, 38092255027603048, 224990947, 224990955, 8, 1440x900 
0x37CA2318, 38092255028264608, 224991014, 224991021, 7, 1440x900 
0x37CA2318, 38092255029124640, 224991102, 224991111, 9, 1440x900 
0x37CA2318, 38092255029785248, 224991168, 224991176, 8, 1440x900 
0x37CA2318, 38092255030445472, 224991238, 224991247, 9, 1440x900 
0x37CA2318, 38092255031096816, 224991296, 224991304, 8, 1440x900 
0x37CA2318, 38092255031775696, 224991367, 224991375, 8, 1440x900 
0x37CA2318, 38092255032234336, 224991408, 224991416, 8, 1440x900 
0x37CA2318, 38092255033084848, 224991498, 224991505, 7, 1440x900 
0x37CA2318, 38092255033554032, 224991542, 224991550, 8, 1440x900 
0x37CA2318, 38092255034413688, 224991627, 224991636, 9, 1440x900 
0x37CA2318, 38092255035065088, 224991693, 224991700, 7, 1440x900 
0x37CA2318, 38092255035735408, 224991761, 224991769, 8, 1440x900 
0x37CA2318, 38092255036395992, 224991827, 224991835, 8, 1440x900 
0x37CA2318, 38092255037058576, 224991893, 224991900, 7, 1440x900 
0x37CA2318, 38092255037717712, 224991958, 224991966, 8, 1440x900 
0x37CA2318, 38092255038386936, 224992023, 224992032, 9, 1440x900 
0x37CA2318, 38092255039035112, 224992088, 224992096, 8, 1440x900 
0x37CA2318, 38092255039705320, 224992157, 224992165, 8, 1440x900 
0x37CA2318, 38092255040366064, 224992223, 224992232, 9, 1440x900 
0x37CA2318, 38092255041033824, 224992289, 224992297, 8, 1440x900 
0x37CA2318, 38092255041683528, 224992353, 224992362, 9, 1440x900 
0x37CA2318, 38092255042356576, 224992423, 224992431, 8, 1440x900 
0x37CA2318, 38092255043015848, 224992487, 224992495, 8, 1440x900 
0x37CA2318, 38092255043685168, 224992553, 224992562, 9, 1440x900 
0x37CA2318, 38092255044337040, 224992618, 224992626, 8, 1440x900 
0x37CA2318, 38092255045006560, 224992687, 224992695, 8, 1440x900 
0x37CA2318, 38092255045668176, 224992753, 224992760, 7, 1440x900 
0x37CA2318, 38092255046319544, 224992823, 224992832, 9, 1440x900 
0x37CA2318, 38092255046782104, 224992867, 224992875, 8, 1440x900 
0x37CA2318, 38092255047446320, 224992932, 224992940, 8, 1440x900 
0x37CA2318, 38092255048108264, 224992998, 224993008, 10, 1440x900 
0x37CA2318, 38092255048781648, 224993068, 224993076, 8, 1440x900 
0x37CA2318, 38092255049441720, 224993132, 224993139, 7, 1440x900 
0x37CA2318, 38092255050089880, 224993193, 224993202, 9, 1440x900 
0x37CA2318, 38092255050749880, 224993258, 224993266, 8, 1440x900 
0x37CA2318, 38092255051563496, 224993344, 224993351, 7, 1440x900 
0x37CA2318, 38092255052073080, 224993393, 224993402, 9, 1440x900 
0x37CA2318, 38092255052731832, 224993458, 224993467, 9, 1440x900 
0x37CA2318, 38092255053407312, 224993527, 224993535, 8, 1440x900 
0x37CA2318, 38092255054052920, 224993592, 224993600, 8, 1440x900 
0x37CA2318, 38092255054726352, 224993658, 224993666, 8, 1440x900 
0x37CA2318, 38092255055570752, 224993743, 224993752, 9, 1440x900 
0x37CA2318, 38092255056232904, 224993808, 224993816, 8, 1440x900 
0x37CA2318, 38092255056762336, 224993863, 224993871, 8, 1440x900 
0x37CA2318, 38092255057365024, 224993922, 224993930, 8, 1440x900 
0x37CA2318, 38092255058033728, 224993987, 224993996, 9, 1440x900 
0x37CA2318, 38092255058674136, 224994053, 224994061, 8, 1440x900 
0x37CA2318, 38092255059371424, 224994123, 224994131, 8, 1440x900 
0x37CA2318, 38092255060010128, 224994188, 224994195, 7, 1440x900 
0x37CA2318, 38092255060684712, 224994253, 224994262, 9, 1440x900 
0x37CA2318, 38092255061362664, 224994323, 224994331, 8, 1440x900 
0x37CA2318, 38092255061997376, 224994387, 224994395, 8, 1440x900 
0x37CA2318, 38092255062639336, 224994448, 224994457, 9, 1440x900 
0x37CA2318, 38092255063317160, 224994515, 224994524, 9, 1440x900 
0x37CA2318, 38092255063975208, 224994583, 224994591, 8, 1440x900 
0x37CA2318, 38092255064635184, 224994647, 224994656, 9, 1440x900 
0x37CA2318, 38092255065298672, 224994713, 224994722, 9, 1440x900 
0x37CA2318, 38092255065968952, 224994782, 224994790, 8, 1440x900 
0x37CA2318, 38092255066627784, 224994848, 224994856, 8, 1440x900 
0x37CA2318, 38092255067299032, 224994917, 224994925, 8, 1440x900 
0x37CA2318, 38092255067935600, 224994981, 224994988, 7, 1440x900 
0x37CA2318, 38092255068625072, 224995047, 224995056, 9, 1440x900 
0x37CA2318, 38092255069272048, 224995113, 224995121, 8, 1440x900 
0x37CA2318, 38092255069936392, 224995181, 224995189, 8, 1440x900 
0x37CA2318, 38092255070592816, 224995247, 224995255, 8, 1440x900 
0x37CA2318, 38092255071270888, 224995317, 224995325, 8, 1440x900 
0x37CA2318, 38092255071915776, 224995378, 224995387, 9, 1440x900 
0x37CA2318, 38092255072575864, 224995448, 224995456, 8, 1440x900 
0x37CA2318, 38092255073245440, 224995513, 224995521, 8, 1440x900 
0x37CA2318, 38092255074555728, 224995648, 224995656, 8, 1440x900 
0x37CA2318, 38092255075411120, 224995729, 224995737, 8, 1440x900 
0x37CA2318, 38092255075876168, 224995777, 224995785, 8, 1440x900 
0x37CA2318, 38092255076547712, 224995847, 224995856, 9, 1440x900 
0x37CA2318, 38092255077196568, 224995907, 224995914, 7, 1440x900 
0x37CA2318, 38092255077853600, 224995972, 224995979, 7, 1440x900 
0x37CA2318, 38092255078514688, 224996037, 224996044, 7, 1440x900 
0x37CA2318, 38092255079374248, 224996123, 224996130, 7, 1440x900 
0x37CA2318, 38092255079962104, 224996187, 224996195, 8, 1440x900 
0x37CA2318, 38092255080496456, 224996237, 224996244, 7, 1440x900 
0x37CA2318, 38092255081157072, 224996302, 224996310, 8, 1440x900 
0x37CA2318, 38092255081817072, 224996367, 224996375, 8, 1440x900 
0x37CA2318, 38092255082476512, 224996433, 224996441, 8, 1440x900 
0x37CA2318, 38092255083137168, 224996498, 224996506, 8, 1440x900 
0x37CA2318, 38092255083881296, 224996573, 224996581, 8, 1440x900 
0x37CA2318, 38092255084462336, 224996632, 224996640, 8, 1440x900 
0x37CA2318, 38092255085121976, 224996697, 224996705, 8, 1440x900 
0x37CA2318, 38092255085781920, 224996763, 224996771, 8, 1440x900 
0x37CA2318, 38092255086443344, 224996833, 224996841, 8, 1440x900 
0x37CA2318, 38092255087117736, 224996898, 224996906, 8, 1440x900 
0x37CA2318, 38092255087785416, 224996966, 224996974, 8, 1440x900 
0x37CA2318, 38092255088446792, 224997031, 224997039, 8, 1440x900 
0x37CA2318, 38092255089092112, 224997093, 224997101, 8, 1440x900 
0x37CA2318, 38092255089751856, 224997162, 224997170, 8, 1440x900 
0x37CA2318, 38092255090434384, 224997228, 224997236, 8, 1440x900 
0x37CA2318, 38092255091103808, 224997297, 224997304, 7, 1440x900 
0x37CA2318, 38092255091750640, 224997362, 224997370, 8, 1440x900 
0x37CA2318, 38092255092410672, 224997427, 224997435, 8, 1440x900 
0x37CA2318, 38092255093073328, 224997497, 224997505, 8, 1440x900 
0x37CA2318, 38092255093733184, 224997561, 224997569, 8, 1440x900 
0x37CA2318, 38092255094394896, 224997627, 224997635, 8, 1440x900 
0x37CA2318, 38092255095077440, 224997693, 224997701, 8, 1440x900 
0x37CA2318, 38092255095744776, 224997761, 224997768, 7, 1440x900 
0x37CA2318, 38092255096375224, 224997822, 224997830, 8, 1440x900 
0x37CA2318, 38092255097080352, 224997892, 224997901, 9, 1440x900 
0x37CA2318, 38092255097745136, 224997958, 224997966, 8, 1440x900 
0x37CA2318, 38092255098370448, 224998022, 224998030, 8, 1440x900 
0x37CA2318, 38092255099030872, 224998093, 224998100, 7, 1440x900 
0x37CA2318, 38092255099689416, 224998157, 224998165, 8, 1440x900 
0x37CA2318, 38092255100356272, 224998227, 224998234, 7, 1440x900 
0x37CA2318, 38092255101007272, 224998290, 224998298, 8, 1440x900 
0x37CA2318, 38092255101680144, 224998353, 224998361, 8, 1440x900 
0x37CA2318, 38092255102340672, 224998418, 224998427, 9, 1440x900 
0x37CA2318, 38092255102987576, 224998483, 224998491, 8, 1440x900 
0x37CA2318, 38092255103656456, 224998552, 224998560, 8, 1440x900 
0x37CA2318, 38092255104329608, 224998618, 224998626, 8, 1440x900 
0x37CA2318, 38092255104989224, 224998683, 224998695, 12, 1440x900 
0x37CA2318, 38092255105658240, 224998752, 224998759, 7, 1440x900 
0x37CA2318, 38092255106316352, 224998817, 224998825, 8, 1440x900 
0x37CA2318, 38092255106965088, 224998882, 224998890, 8, 1440x900 
0x37CA2318, 38092255107637792, 224998948, 224998956, 8, 1440x900 
0x37CA2318, 38092255108297744, 224999017, 224999027, 10, 1440x900 
0x37CA2318, 38092255108956832, 224999082, 224999089, 7, 1440x900 
0x37CA2318, 38092255109618888, 224999148, 224999156, 8, 1440x900 
0x37CA2318, 38092255110266360, 224999213, 224999220, 7, 1440x900 
0x37CA2318, 38092255110926624, 224999278, 224999286, 8, 1440x900 
0x37CA2318, 38092255111607560, 224999347, 224999355, 8, 1440x900 
0x37CA2318, 38092255112263376, 224999412, 224999419, 7, 1440x900 
0x37CA2318, 38092255112927072, 224999477, 224999486, 9, 1440x900 
0x37CA2318, 38092255113572664, 224999543, 224999550, 7, 1440x900 
0x37CA2318, 38092255114231664, 224999607, 224999616, 9, 1440x900 
0x37CA2318, 38092255114905616, 224999677, 224999684, 7, 1440x900 
0x37CA2318, 38092255115575232, 224999743, 224999751, 8, 1440x900 
0x37CA2318, 38092255116238648, 224999808, 224999816, 8, 1440x900 
0x37CA2318, 38092255116893352, 224999873, 224999881, 8, 1440x900 
0x37CA2318, 38092255117541552, 224999941, 224999948, 7, 1440x900 
0x37CA2318, 38092255118215840, 225000007, 225000015, 8, 1440x900 
0x37CA2318, 38092255118861968, 225000073, 225000081, 8, 1440x900 
0x37CA2318, 38092255119538504, 225000142, 225000151, 9, 1440x900 
0x37CA2318, 38092255120192384, 225000203, 225000215, 12, 1440x900 
0x37CA2318, 38092255120862328, 225000273, 225000280, 7, 1440x900 
0x37CA2318, 38092255121510584, 225000337, 225000345, 8, 1440x900 
0x37CA2318, 38092255122170760, 225000403, 225000411, 8, 1440x900 
0x37CA2318, 38092255122831200, 225000468, 225000476, 8, 1440x900 
0x37CA2318, 38092255123503456, 225000537, 225000545, 8, 1440x900 
0x37CA2318, 38092255124163072, 225000602, 225000609, 7, 1440x900 
0x37CA2318, 38092255124832536, 225000668, 225000676, 8, 1440x900 
0x37CA2318, 38092255125491616, 225000733, 225000741, 8, 1440x900 
0x37CA2318, 38092255126139704, 225000798, 225000806, 8, 1440x900 
0x37CA2318, 38092255126799920, 225000866, 225000873, 7, 1440x900 
0x37CA2318, 38092255127469696, 225000933, 225000940, 7, 1440x900 
0x37CA2318, 38092255128138608, 225000998, 225001006, 8, 1440x900 
0x37CA2318, 38092255128799416, 225001067, 225001075, 8, 1440x900 
0x37CA2318, 38092255129459456, 225001133, 225001140, 7, 1440x900 
0x37CA2318, 38092255130119576, 225001198, 225001205, 7, 1440x900 
0x37CA2318, 38092255130781448, 225001263, 225001271, 8, 1440x900 
0x37CA2318, 38092255131428608, 225001328, 225001336, 8, 1440x900 
0x37CA2318, 38092255132089072, 225001393, 225001401, 8, 1440x900 
0x37CA2318, 38092255132753968, 225001462, 225001469, 7, 1440x900 
0x37CA2318, 38092255133413352, 225001528, 225001536, 8, 1440x900 
0x37CA2318, 38092255134082528, 225001598, 225001606, 8, 1440x900 
0x37CA2318, 38092255134753528, 225001661, 225001669, 8, 1440x900 
0x37CA2318, 38092255135418448, 225001727, 225001735, 8, 1440x900 
0x37CA2318, 38092255136725104, 225001863, 225001872, 9, 1440x900 
0x37CA2318, 38092255137384656, 225001935, 225001945, 10, 1440x900 
0x37CA2318, 38092255138055192, 225001993, 225002000, 7, 1440x900 
0x37CA2318, 38092255138721160, 225002057, 225002065, 8, 1440x900 
0x37CA2318, 38092255139556280, 225002142, 225002149, 7, 1440x900 
0x37CA2318, 38092255140227312, 225002208, 225002216, 8, 1440x900 
0x37CA2318, 38092255140879344, 225002278, 225002286, 8, 1440x900 
0x37CA2318, 38092255141540440, 225002343, 225002351, 8, 1440x900 
0x37CA2318, 38092255142130912, 225002402, 225002411, 9, 1440x900 
0x37CA2318, 38092255142671528, 225002458, 225002466, 8, 1440x900 
0x37CA2318, 38092255143329184, 225002522, 225002529, 7, 1440x900 
0x37CA2318, 38092255144185672, 225002608, 225002617, 9, 1440x900 
0x37CA2318, 38092255144847216, 225002677, 225002685, 8, 1440x900 
0x37CA2318, 38092255145506536, 225002744, 225002752, 8, 1440x900 
0x37CA2318, 38092255146167416, 225002803, 225002811, 8, 1440x900 
0x37CA2318, 38092255146835776, 225002873, 225002881, 8, 1440x900 
0x37CA2318, 38092255147321184, 225002918, 225002926, 8, 1440x900 
0x37CA2318, 38092255147949160, 225002981, 225002988, 7, 1440x900 
0x37CA2318, 38092255148609472, 225003047, 225003054, 7, 1440x900 
0x37CA2318, 38092255149272464, 225003112, 225003120, 8, 1440x900 
0x37CA2318, 38092255149929512, 225003178, 225003186, 8, 1440x900 
0x37CA2318, 38092255150589528, 225003243, 225003251, 8, 1440x900 
0x37CA2318, 38092255151249520, 225003311, 225003319, 8, 1440x900 
0x37CA2318, 38092255151910464, 225003377, 225003385, 8, 1440x900 
0x37CA2318, 38092255152569848, 225003442, 225003450, 8, 1440x900 
0x37CA2318, 38092255153425696, 225003532, 225003540, 8, 1440x900 
0x37CA2318, 38092255154096024, 225003597, 225003605, 8, 1440x900 
0x37CA2318, 38092255154748624, 225003662, 225003671, 9, 1440x900 
0x37CA2318, 38092255155423472, 225003735, 225003745, 10, 1440x900 
0x37CA2318, 38092255155881096, 225003777, 225003785, 8, 1440x900 
0x37CA2318, 38092255156723920, 225003858, 225003866, 8, 1440x900 
0x37CA2318, 38092255157397696, 225003927, 225003934, 7, 1440x900 
0x37CA2318, 38092255158057728, 225003992, 225004000, 8, 1440x900 
0x37CA2318, 38092255158549328, 225004043, 225004051, 8, 1440x900 
0x37CA2318, 38092255159182552, 225004103, 225004111, 8, 1440x900 
0x37CA2318, 38092255159842432, 225004168, 225004176, 8, 1440x900 
0x37CA2318, 38092255160502760, 225004237, 225004244, 7, 1440x900 
0x37CA2318, 38092255161162608, 225004302, 225004309, 7, 1440x900 
0x37CA2318, 38092255161822816, 225004368, 225004375, 7, 1440x900 
0x37CA2318, 38092255162486080, 225004433, 225004441, 8, 1440x900 
0x37CA2318, 38092255163146112, 225004502, 225004509, 7, 1440x900 
0x37CA2318, 38092255163806176, 225004567, 225004574, 7, 1440x900 
0x37CA2318, 38092255164466640, 225004632, 225004639, 7, 1440x900 
0x37CA2318, 38092255165134544, 225004697, 225004705, 8, 1440x900 
0x37CA2318, 38092255165906176, 225004778, 225004785, 7, 1440x900 
0x37CA2318, 38092255166453952, 225004832, 225004839, 7, 1440x900 
0x37CA2318, 38092255167113784, 225004897, 225004905, 8, 1440x900 
0x37CA2318, 38092255167774728, 225004962, 225004970, 8, 1440x900 
0x37CA2318, 38092255168474712, 225005033, 225005041, 8, 1440x900 
0x37CA2318, 38092255169094632, 225005093, 225005102, 9, 1440x900 
0x37CA2318, 38092255169754560, 225005162, 225005170, 8, 1440x900 
0x37CA2318, 38092255170414688, 225005229, 225005236, 7, 1440x900 
0x37CA2318, 38092255171074968, 225005293, 225005301, 8, 1440x900 
0x37CA2318, 38092255171734768, 225005358, 225005366, 8, 1440x900 
0x37CA2318, 38092255172394800, 225005427, 225005434, 7, 1440x900 
0x37CA2318, 38092255173058160, 225005493, 225005501, 8, 1440x900 
0x37CA2318, 38092255173722768, 225005557, 225005575, 18, 1440x900 
0x37CA2318, 38092255174406168, 225005628, 225005635, 7, 1440x900 
0x37CA2318, 38092255175044064, 225005691, 225005700, 9, 1440x900 
0x37CA2318, 38092255175701616, 225005757, 225005765, 8, 1440x900 
0x37CA2318, 38092255176363184, 225005822, 225005830, 8, 1440x900 
0x37CA2318, 38092255177021624, 225005888, 225005901, 13, 1440x900 
0x37CA2318, 38092255177692816, 225005957, 225005965, 8, 1440x900 
0x37CA2318, 38092255178447872, 225006031, 225006048, 17, 1440x900 
0x37CA2318, 38092255179031520, 225006087, 225006096, 9, 1440x900 
0x37CA2318, 38092255179664816, 225006152, 225006161, 9, 1440x900 
0x37CA2318, 38092255180378496, 225006224, 225006235, 11, 1440x900 
0x37CA2318, 38092255181034840, 225006289, 225006298, 9, 1440x900 
0x37CA2318, 38092255181690608, 225006357, 225006364, 7, 1440x900 
0x37CA2318, 38092255182340376, 225006419, 225006427, 8, 1440x900 
0x37CA2318, 38092255183000600, 225006484, 225006492, 8, 1440x900 
0x37CA2318, 38092255183688312, 225006553, 225006563, 10, 1440x900 
0x37CA2318, 38092255184393744, 225006623, 225006631, 8, 1440x900 
0x37CA2318, 38092255184995984, 225006687, 225006694, 7, 1440x900 
0x37CA2318, 38092255185659840, 225006752, 225006759, 7, 1440x900 
0x37CA2318, 38092255186408584, 225006825, 225006834, 9, 1440x900 
0x37CA2318, 38092255187070184, 225006893, 225006901, 8, 1440x900 
0x37CA2318, 38092255187680352, 225006953, 225006962, 9, 1440x900 
0x37CA2318, 38092255188320600, 225007017, 225007025, 8, 1440x900 
0x37CA2318, 38092255189054344, 225007102, 225007112, 10, 1440x900 
0x37CA2318, 38092255189694752, 225007154, 225007163, 9, 1440x900 
0x37CA2318, 38092255190394864, 225007227, 225007235, 8, 1440x900 
0x37CA2318, 38092255190991424, 225007284, 225007292, 8, 1440x900 
0x37CA2318, 38092255191740632, 225007363, 225007370, 7, 1440x900 
0x37CA2318, 38092255192361872, 225007422, 225007433, 11, 1440x900 
0x37CA2318, 38092255193019584, 225007488, 225007496, 8, 1440x900 
0x37CA2318, 38092255193661352, 225007553, 225007560, 7, 1440x900 
0x37CA2318, 38092255194431824, 225007628, 225007649, 21, 1440x900 
0x37CA2318, 38092255195019880, 225007688, 225007696, 8, 1440x900 
0x37CA2318, 38092255195666072, 225007757, 225007767, 10, 1440x900 
0x37CA2318, 38092255196342624, 225007818, 225007826, 8, 1440x900 
0x37CA2318, 38092255197046360, 225007892, 225007910, 18, 1440x900 
0x37CA2318, 38092255197662240, 225007952, 225007960, 8, 1440x900 
0x37CA2318, 38092255198289120, 225008014, 225008030, 16, 1440x900 
0x37CA2318, 38092255198969360, 225008082, 225008089, 7, 1440x900 
0x37CA2318, 38092255199610864, 225008147, 225008154, 7, 1440x900 
0x37CA2318, 38092255200289104, 225008214, 225008229, 15, 1440x900 
0x37CA2318, 38092255200949880, 225008282, 225008289, 7, 1440x900 
0x37CA2318, 38092255201594592, 225008348, 225008356, 8, 1440x900 
0x37CA2318, 38092255202254616, 225008413, 225008421, 8, 1440x900 
0x37CA2318, 38092255202914640, 225008478, 225008486, 8, 1440x900 
0x37CA2318, 38092255203574672, 225008543, 225008551, 8, 1440x900 
0x37CA2318, 38092255204234512, 225008608, 225008616, 8, 1440x900 
0x37CA2318, 38092255204894904, 225008677, 225008686, 9, 1440x900 
0x37CA2318, 38092255206215080, 225008807, 225008815, 8, 1440x900 
0x37CA2318, 38092255206875584, 225008876, 225008884, 8, 1440x900 
0x37CA2318, 38092255207535488, 225008937, 225008945, 8, 1440x900 
0x37CA2318, 38092255208196312, 225009003, 225009011, 8, 1440x900 
0x37CA2318, 38092255208855680, 225009072, 225009079, 7, 1440x900 
0x37CA2318, 38092255209517160, 225009138, 225009145, 7, 1440x900 
0x37CA2318, 38092255210176008, 225009203, 225009211, 8, 1440x900 
0x37CA2318, 38092255210856328, 225009274, 225009283, 9, 1440x900 
0x37CA2318, 38092255211547712, 225009339, 225009350, 11, 1440x900 
0x37CA2318, 38092255212207696, 225009408, 225009416, 8, 1440x900 
0x37CA2318, 38092255212847536, 225009472, 225009479, 7, 1440x900 
0x37CA2318, 38092255213506104, 225009534, 225009542, 8, 1440x900 
0x37CA2318, 38092255214163912, 225009601, 225009609, 8, 1440x900 
0x37CA2318, 38092255214822792, 225009669, 225009677, 8, 1440x900 
0x37CA2318, 38092255215482872, 225009733, 225009741, 8, 1440x900 
0x37CA2318, 38092255216143016, 225009803, 225009809, 6, 1440x900 
0x37CA2318, 38092255216804272, 225009868, 225009875, 7, 1440x900 
0x37CA2318, 38092255217462696, 225009934, 225009941, 7, 1440x900 
0x37CA2318, 38092255218142832, 225010003, 225010010, 7, 1440x900 
0x37CA2318, 38092255218801992, 225010068, 225010075, 7, 1440x900 
0x37CA2318, 38092255219442760, 225010129, 225010137, 8, 1440x900 
0x37CA2318, 38092255220102360, 225010197, 225010205, 8, 1440x900 
0x37CA2318, 38092255220769344, 225010263, 225010270, 7, 1440x900 
0x37CA2318, 38092255221429384, 225010328, 225010336, 8, 1440x900 
0x37CA2318, 38092255222089248, 225010393, 225010402, 9, 1440x900 
0x37CA2318, 38092255222770040, 225010464, 225010474, 10, 1440x900 
0x37CA2318, 38092255223428656, 225010527, 225010535, 8, 1440x900 
0x37CA2318, 38092255224070144, 225010592, 225010599, 7, 1440x900 
0x37CA2318, 38092255224730176, 225010658, 225010666, 8, 1440x900 
0x37CA2318, 38092255225412400, 225010727, 225010735, 8, 1440x900 
0x37CA2318, 38092255226093248, 225010794, 225010802, 8, 1440x900 
0x37CA2318, 38092255226710640, 225010857, 225010864, 7, 1440x900 
0x37CA2318, 38092255227373736, 225010922, 225010930, 8, 1440x900 
0x37CA2318, 38092255228032408, 225010988, 225010996, 8, 1440x900 
0x37CA2318, 38092255228696040, 225011057, 225011065, 8, 1440x900 
0x37CA2318, 38092255229366616, 225011122, 225011130, 8, 1440x900 
0x37CA2318, 38092255230038456, 225011188, 225011196, 8, 1440x900 
0x37CA2318, 38092255230691512, 225011258, 225011265, 7, 1440x900 
0x37CA2318, 38092255231346144, 225011322, 225011330, 8, 1440x900 
0x37CA2318, 38092255232004000, 225011388, 225011396, 8, 1440x900 
0x37CA2318, 38092255232697576, 225011458, 225011466, 8, 1440x900 
0x37CA2318, 38092255233342104, 225011520, 225011533, 13, 1440x900 
0x37CA2318, 38092255234001904, 225011588, 225011595, 7, 1440x900 
0x37CA2318, 38092255234643480, 225011648, 225011656, 8, 1440x900 
0x37CA2318, 38092255235303480, 225011717, 225011725, 8, 1440x900 
0x37CA2318, 38092255235963072, 225011782, 225011790, 8, 1440x900 
0x37CA2318, 38092255236623488, 225011848, 225011855, 7, 1440x900 
0x37CA2318, 38092255237301576, 225011918, 225011925, 7, 1440x900 
0x37CA2318, 38092255237942704, 225011978, 225011988, 10, 1440x900 
0x37CA2318, 38092255238631448, 225012048, 225012056, 8, 1440x900 
0x37CA2318, 38092255239260640, 225012113, 225012120, 7, 1440x900 
0x37CA2318, 38092255239922264, 225012177, 225012186, 9, 1440x900 
0x37CA2318, 38092255240602288, 225012247, 225012255, 8, 1440x900 
0x37CA2318, 38092255241244144, 225012312, 225012319, 7, 1440x900 
0x37CA2318, 38092255241904336, 225012378, 225012386, 8, 1440x900 
0x37CA2318, 38092255242565784, 225012446, 225012454, 8, 1440x900 
0x37CA2318, 38092255243222600, 225012507, 225012515, 8, 1440x900 
0x37CA2318, 38092255243920848, 225012579, 225012587, 8, 1440x900 
0x37CA2318, 38092255244572464, 225012643, 225012652, 9, 1440x900 
0x37CA2318, 38092255245249672, 225012708, 225012716, 8, 1440x900 
0x37CA2318, 38092255245882576, 225012773, 225012781, 8, 1440x900 
0x37CA2318, 38092255246530784, 225012842, 225012850, 8, 1440x900 
0x37CA2318, 38092255247190880, 225012904, 225012913, 9, 1440x900 
0x37CA2318, 38092255247871768, 225012979, 225012987, 8, 1440x900 
0x37CA2318, 38092255248532472, 225013042, 225013051, 9, 1440x900 
0x37CA2318, 38092255249196848, 225013109, 225013117, 8, 1440x900 
0x37CA2318, 38092255249856944, 225013172, 225013184, 12, 1440x900 
0x37CA2318, 38092255250517816, 225013240, 225013248, 8, 1440x900 
0x37CA2318, 38092255251167312, 225013304, 225013311, 7, 1440x900 
0x37CA2318, 38092255251815456, 225013368, 225013378, 10, 1440x900 
0x37CA2318, 38092255252487552, 225013433, 225013441, 8, 1440x900 
0x37CA2318, 38092255253152464, 225013503, 225013510, 7, 1440x900 
0x37CA2318, 38092255253797648, 225013567, 225013575, 8, 1440x900 
0x37CA2318, 38092255254458720, 225013632, 225013641, 9, 1440x900 
0x37CA2318, 38092255255119216, 225013697, 225013705, 8, 1440x900 
0x37CA2318, 38092255255784608, 225013767, 225013775, 8, 1440x900 
0x37CA2318, 38092255256603832, 225013847, 225013856, 9, 1440x900 
0x37CA2318, 38092255257102856, 225013898, 225013905, 7, 1440x900 
0x37CA2318, 38092255257763352, 225013963, 225013971, 8, 1440x900 
0x37CA2318, 38092255258434672, 225014028, 225014036, 8, 1440x900 
0x37CA2318, 38092255259081912, 225014093, 225014101, 8, 1440x900 
0x37CA2318, 38092255259774064, 225014163, 225014171, 8, 1440x900 
0x37CA2318, 38092255260404672, 225014227, 225014234, 7, 1440x900 
0x37CA2318, 38092255261065664, 225014293, 225014301, 8, 1440x900 
0x37CA2318, 38092255261729136, 225014362, 225014370, 8, 1440x900 
0x37CA2318, 38092255262387496, 225014428, 225014436, 8, 1440x900 
0x37CA2318, 38092255263065144, 225014492, 225014500, 8, 1440x900 
0x37CA2318, 38092255263710760, 225014557, 225014564, 7, 1440x900 
0x37CA2318, 38092255264371104, 225014623, 225014630, 7, 1440x900 
0x37CA2318, 38092255265036880, 225014688, 225014696, 8, 1440x900 
0x37CA2318, 38092255265693152, 225014753, 225014762, 9, 1440x900 
0x37CA2318, 38092255266353360, 225014822, 225014830, 8, 1440x900 
0x37CA2318, 38092255267013984, 225014887, 225014895, 8, 1440x900 
0x37CA2318, 38092255267687032, 225014956, 225014964, 8, 1440x900 
0x37CA2318, 38092255268347504, 225015021, 225015028, 7, 1440x900 
0x37CA2318, 38092255269000232, 225015089, 225015099, 10, 1440x900 
0x37CA2318, 38092255269671432, 225015153, 225015163, 10, 1440x900 
0x37CA2318, 38092255270326624, 225015218, 225015225, 7, 1440x900 
0x37CA2318, 38092255270989840, 225015288, 225015295, 7, 1440x900 
0x37CA2318, 38092255271650912, 225015353, 225015360, 7, 1440x900 
0x37CA2318, 38092255272298376, 225015418, 225015426, 8, 1440x900 
0x37CA2318, 38092255272958424, 225015483, 225015490, 7, 1440x900 
0x37CA2318, 38092255273619024, 225015551, 225015559, 8, 1440x900 
0x37CA2318, 38092255274278776, 225015616, 225015624, 8, 1440x900 
0x37CA2318, 38092255275137056, 225015702, 225015710, 8, 1440x900 
0x37CA2318, 38092255275789568, 225015768, 225015775, 7, 1440x900 
0x37CA2318, 38092255276458664, 225015837, 225015846, 9, 1440x900 
0x37CA2318, 38092255277117760, 225015898, 225015905, 7, 1440x900 
0x37CA2318, 38092255277778184, 225015963, 225015971, 8, 1440x900 
0x37CA2318, 38092255278439160, 225016033, 225016041, 8, 1440x900 
0x37CA2318, 38092255279100152, 225016097, 225016106, 9, 1440x900 
0x37CA2318, 38092255279763928, 225016163, 225016171, 8, 1440x900 
0x37CA2318, 38092255280426320, 225016233, 225016241, 8, 1440x900 
0x37CA2318, 38092255281085920, 225016297, 225016305, 8, 1440x900 
0x37CA2318, 38092255281746760, 225016362, 225016370, 8, 1440x900 
0x37CA2318, 38092255282407696, 225016428, 225016437, 9, 1440x900 
0x37CA2318, 38092255283059376, 225016497, 225016505, 8, 1440x900 
0x37CA2318, 38092255283721280, 225016563, 225016571, 8, 1440x900 
0x37CA2318, 38092255284392000, 225016628, 225016636, 8, 1440x900 
0x37CA2318, 38092255285052888, 225016697, 225016705, 8, 1440x900 
0x37CA2318, 38092255285713680, 225016762, 225016770, 8, 1440x900 
0x37CA2318, 38092255286371408, 225016828, 225016836, 8, 1440x900 
0x37CA2318, 38092255287030680, 225016891, 225016899, 8, 1440x900 
0x37CA2318, 38092255287693936, 225016958, 225016966, 8, 1440x900 
0x37CA2318, 38092255288358304, 225017023, 225017032, 9, 1440x900 
0x37CA2318, 38092255289027536, 225017093, 225017105, 12, 1440x900 
0x37CA2318, 38092255289678480, 225017153, 225017161, 8, 1440x900 
0x37CA2318, 38092255290345376, 225017224, 225017232, 8, 1440x900 
0x37CA2318, 38092255291000952, 225017287, 225017296, 9, 1440x900 
0x37CA2318, 38092255291652552, 225017353, 225017361, 8, 1440x900 
0x37CA2318, 38092255292323176, 225017422, 225017431, 9, 1440x900 
0x37CA2318, 38092255292983160, 225017488, 225017497, 9, 1440x900 
0x37CA2318, 38092255293644136, 225017552, 225017561, 9, 1440x900 
0x37CA2318, 38092255294296128, 225017622, 225017630, 8, 1440x900 
0x37CA2318, 38092255294956480, 225017682, 225017691, 9, 1440x900 
0x37CA2318, 38092255295625856, 225017752, 225017760, 8, 1440x900 
0x37CA2318, 38092255296288616, 225017817, 225017825, 8, 1440x900 
0x37CA2318, 38092255296958072, 225017887, 225017895, 8, 1440x900 
0x37CA2318, 38092255297618496, 225017951, 225017958, 7, 1440x900 
0x37CA2318, 38092255298269808, 225018017, 225018025, 8, 1440x900 
0x37CA2318, 38092255299396080, 225018128, 225018137, 9, 1440x900 
0x37CA2318, 38092255300077504, 225018193, 225018201, 8, 1440x900 
0x37CA2318, 38092255300714448, 225018257, 225018264, 7, 1440x900 
0x37CA2318, 38092255301374216, 225018322, 225018330, 8, 1440x900 
0x37CA2318, 38092255302049576, 225018391, 225018399, 8, 1440x900 
0x37CA2318, 38092255302704176, 225018457, 225018464, 7, 1440x900 
0x37CA2318, 38092255303364224, 225018522, 225018530, 8, 1440x900 
0x37CA2318, 38092255304215992, 225018608, 225018615, 7, 1440x900 
0x37CA2318, 38092255304884328, 225018673, 225018681, 8, 1440x900 
0x37CA2318, 38092255305547808, 225018742, 225018750, 8, 1440x900 
0x37CA2318, 38092255306200000, 225018807, 225018815, 8, 1440x900 
0x37CA2318, 38092255306878384, 225018873, 225018881, 8, 1440x900 
0x37CA2318, 38092255307526360, 225018938, 225018946, 8, 1440x900 
0x37CA2318, 38092255308190992, 225019007, 225019015, 8, 1440x900 
0x37CA2318, 38092255308852008, 225019073, 225019080, 7, 1440x900 
0x37CA2318, 38092255309313904, 225019118, 225019125, 7, 1440x900 
0x37CA2318, 38092255309977160, 225019187, 225019195, 8, 1440x900 
0x37CA2318, 38092255310649776, 225019252, 225019260, 8, 1440x900 
0x37CA2318, 38092255311295984, 225019317, 225019324, 7, 1440x900 
0x37CA2318, 38092255311959176, 225019382, 225019389, 7, 1440x900 
0x37CA2318, 38092255312625576, 225019448, 225019455, 7, 1440x900 
0x37CA2318, 38092255313289840, 225019513, 225019521, 8, 1440x900 
0x37CA2318, 38092255313964288, 225019582, 225019590, 8, 1440x900 
0x37CA2318, 38092255314606136, 225019647, 225019654, 7, 1440x900 
0x37CA2318, 38092255315268376, 225019717, 225019725, 8, 1440x900 
0x37CA2318, 38092255316130856, 225019803, 225019811, 8, 1440x900 
0x37CA2318, 38092255316802896, 225019868, 225019876, 8, 1440x900 
0x37CA2318, 38092255317482688, 225019937, 225019945, 8, 1440x900 
0x37CA2318, 38092255318132840, 225020003, 225020011, 8, 1440x900 
0x37CA2318, 38092255318797288, 225020069, 225020078, 9, 1440x900 
0x37CA2318, 38092255319460072, 225020132, 225020139, 7, 1440x900 
0x37CA2318, 38092255320120632, 225020203, 225020211, 8, 1440x900 
0x37CA2318, 38092255320780184, 225020267, 225020275, 8, 1440x900 
0x37CA2318, 38092255321431768, 225020332, 225020340, 8, 1440x900 
0x37CA2318, 38092255322102368, 225020402, 225020410, 8, 1440x900 
0x37CA2318, 38092255322762392, 225020467, 225020475, 8, 1440x900 
0x37CA2318, 38092255323423248, 225020533, 225020542, 9, 1440x900 
0x37CA2318, 38092255324086616, 225020597, 225020605, 8, 1440x900 
0x37CA2318, 38092255324746272, 225020662, 225020671, 9, 1440x900 
0x37CA2318, 38092255325410584, 225020728, 225020737, 9, 1440x900 
0x37CA2318, 38092255326067584, 225020794, 225020802, 8, 1440x900 
0x37CA2318, 38092255326728096, 225020862, 225020871, 9, 1440x900 
0x37CA2318, 38092255327389232, 225020928, 225020936, 8, 1440x900 
0x37CA2318, 38092255328048232, 225020993, 225021001, 8, 1440x900 
0x37CA2318, 38092255328710056, 225021063, 225021071, 8, 1440x900 
0x37CA2318, 38092255329379408, 225021122, 225021131, 9, 1440x900 
0x37CA2318, 38092255330039168, 225021191, 225021198, 7, 1440x900 
0x37CA2318, 38092255330692328, 225021253, 225021262, 9, 1440x900 
0x37CA2318, 38092255331354016, 225021323, 225021332, 9, 1440x900 
0x37CA2318, 38092255332023968, 225021392, 225021400, 8, 1440x900 
0x37CA2318, 38092255332682280, 225021457, 225021465, 8, 1440x900 
0x37CA2318, 38092255333341920, 225021522, 225021531, 9, 1440x900 
0x37CA2318, 38092255334010416, 225021587, 225021594, 7, 1440x900 
0x37CA2318, 38092255334757624, 225021664, 225021679, 15, 1440x900 
0x37CA2318, 38092255335154240, 225021702, 225021708, 6, 1440x900 
0x37CA2318, 38092255335979320, 225021783, 225021791, 8, 1440x900 
0x37CA2318, 38092255336655520, 225021852, 225021861, 9, 1440x900 
0x37CA2318, 38092255337303928, 225021918, 225021925, 7, 1440x900 
0x37CA2318, 38092255337973592, 225021983, 225021990, 7, 1440x900 
0x37CA2318, 38092255338644184, 225022053, 225022060, 7, 1440x900 
0x37CA2318, 38092255339294840, 225022117, 225022124, 7, 1440x900 
0x37CA2318, 38092255339929616, 225022178, 225022187, 9, 1440x900 
0x37CA2318, 38092255340617904, 225022247, 225022254, 7, 1440x900 
0x37CA2318, 38092255341275424, 225022313, 225022321, 8, 1440x900 
0x37CA2318, 38092255341936776, 225022383, 225022390, 7, 1440x900 
0x37CA2318, 38092255342591152, 225022447, 225022455, 8, 1440x900 
0x37CA2318, 38092255343261048, 225022513, 225022521, 8, 1440x900 
0x37CA2318, 38092255343922128, 225022582, 225022590, 8, 1440x900 
0x37CA2318, 38092255344583616, 225022647, 225022654, 7, 1440x900 
0x37CA2318, 38092255345252264, 225022712, 225022721, 9, 1440x900 
0x37CA2318, 38092255345905976, 225022782, 225022790, 8, 1440x900 
0x37CA2318, 38092255346568280, 225022848, 225022856, 8, 1440x900 
0x37CA2318, 38092255347046352, 225022898, 225022906, 8, 1440x900 
0x37CA2318, 38092255347710016, 225022958, 225022969, 11, 1440x900 
0x37CA2318, 38092255348366608, 225023022, 225023032, 10, 1440x900 
0x37CA2318, 38092255349029560, 225023088, 225023096, 8, 1440x900 
0x37CA2318, 38092255349699704, 225023154, 225023163, 9, 1440x900 
0x37CA2318, 38092255350352136, 225023221, 225023228, 7, 1440x900 
0x37CA2318, 38092255351002248, 225023287, 225023294, 7, 1440x900 
0x37CA2318, 38092255351687976, 225023354, 225023363, 9, 1440x900 
0x37CA2318, 38092255352335672, 225023418, 225023426, 8, 1440x900 
0x37CA2318, 38092255353169704, 225023502, 225023510, 8, 1440x900 
0x37CA2318, 38092255353639472, 225023548, 225023556, 8, 1440x900 
0x37CA2318, 38092255354299480, 225023617, 225023624, 7, 1440x900 
0x37CA2318, 38092255354959416, 225023681, 225023688, 7, 1440x900 
0x37CA2318, 38092255355815016, 225023773, 225023781, 8, 1440x900 
0x37CA2318, 38092255356493640, 225023838, 225023847, 9, 1440x900 
0x37CA2318, 38092255357152936, 225023903, 225023912, 9, 1440x900 
0x37CA2318, 38092255357634816, 225023948, 225023956, 8, 1440x900 
0x37CA2318, 38092255358469224, 225024033, 225024040, 7, 1440x900 
0x37CA2318, 38092255359139336, 225024101, 225024109, 8, 1440x900 
0x37CA2318, 38092255359808256, 225024167, 225024175, 8, 1440x900 
0x37CA2318, 38092255360459104, 225024232, 225024240, 8, 1440x900 
0x37CA2318, 38092255361122104, 225024297, 225024305, 8, 1440x900 
0x37CA2318, 38092255361782064, 225024368, 225024376, 8, 1440x900 
0x37CA2318, 38092255362444872, 225024437, 225024447, 10, 1440x900 
0x37CA2318, 38092255363095432, 225024497, 225024506, 9, 1440x900 
0x37CA2318, 38092255363766624, 225024567, 225024576, 9, 1440x900 
0x37CA2318, 38092255364419552, 225024632, 225024640, 8, 1440x900 
0x37CA2318, 38092255365089584, 225024699, 225024708, 9, 1440x900 
0x37CA2318, 38092255365759120, 225024762, 225024771, 9, 1440x900 
0x37CA2318, 38092255366412544, 225024832, 225024840, 8, 1440x900 
0x37CA2318, 38092255367096824, 225024908, 225024917, 9, 1440x900 
0x37CA2318, 38092255368410872, 225025027, 225025034, 7, 1440x900 
0x37CA2318, 38092255369065808, 225025093, 225025100, 7, 1440x900 
0x37CA2318, 38092255369727048, 225025163, 225025171, 8, 1440x900 
0x37CA2318, 38092255370387200, 225025226, 225025234, 8, 1440x900 
0x37CA2318, 38092255371056464, 225025292, 225025299, 7, 1440x900 
0x37CA2318, 38092255371708160, 225025362, 225025369, 7, 1440x900 
0x37CA2318, 38092255372366328, 225025428, 225025436, 8, 1440x900 
0x37CA2318, 38092255373034544, 225025493, 225025501, 8, 1440x900 
0x37CA2318, 38092255373704376, 225025563, 225025572, 9, 1440x900 
0x37CA2318, 38092255374183352, 225025604, 225025612, 8, 1440x900 
0x37CA2318, 38092255375025064, 225025693, 225025701, 8, 1440x900 
0x37CA2318, 38092255375677040, 225025758, 225025766, 8, 1440x900 
0x37CA2318, 38092255376327984, 225025823, 225025831, 8, 1440x900 
0x37CA2318, 38092255376998152, 225025888, 225025896, 8, 1440x900 
0x37CA2318, 38092255377650128, 225025953, 225025961, 8, 1440x900 
0x37CA2318, 38092255378312280, 225026018, 225026027, 9, 1440x900 
0x37CA2318, 38092255378973160, 225026084, 225026093, 9, 1440x900 
0x37CA2318, 38092255379634272, 225026153, 225026161, 8, 1440x900 
0x37CA2318, 38092255380302696, 225026219, 225026227, 8, 1440x900 
0x37CA2318, 38092255380963712, 225026282, 225026290, 8, 1440x900 
0x37CA2318, 38092255381629208, 225026351, 225026358, 7, 1440x900 
0x37CA2318, 38092255382278968, 225026413, 225026421, 8, 1440x900 
0x37CA2318, 38092255382949408, 225026483, 225026490, 7, 1440x900 
0x37CA2318, 38092255383600176, 225026547, 225026555, 8, 1440x900 
0x37CA2318, 38092255384260704, 225026613, 225026620, 7, 1440x900 
0x37CA2318, 38092255384921872, 225026678, 225026685, 7, 1440x900 
0x37CA2318, 38092255385575216, 225026748, 225026756, 8, 1440x900 
0x37CA2318, 38092255386243648, 225026812, 225026820, 8, 1440x900 
0x37CA2318, 38092255386913536, 225026883, 225026891, 8, 1440x900 
0x37CA2318, 38092255387575168, 225026948, 225026956, 8, 1440x900 
0x37CA2318, 38092255388236848, 225027012, 225027020, 8, 1440x900 
0x37CA2318, 38092255388905184, 225027078, 225027087, 9, 1440x900 
0x37CA2318, 38092255389546600, 225027142, 225027151, 9, 1440x900 
0x37CA2318, 38092255390225560, 225027212, 225027220, 8, 1440x900 
0x37CA2318, 38092255390885928, 225027276, 225027284, 8, 1440x900 
0x37CA2318, 38092255391545736, 225027343, 225027351, 8, 1440x900 
0x37CA2318, 38092255392210328, 225027407, 225027414, 7, 1440x900 
0x37CA2318, 38092255392872472, 225027477, 225027486, 9, 1440x900 
0x37CA2318, 38092255393523208, 225027538, 225027545, 7, 1440x900 
0x37CA2318, 38092255394185440, 225027607, 225027614, 7, 1440x900 
0x37CA2318, 38092255394847040, 225027671, 225027679, 8, 1440x900 
0x37CA2318, 38092255395500400, 225027737, 225027746, 9, 1440x900 
0x37CA2318, 38092255396161184, 225027803, 225027812, 9, 1440x900 
0x37CA2318, 38092255396821664, 225027872, 225027880, 8, 1440x900 
0x37CA2318, 38092255397492200, 225027938, 225027946, 8, 1440x900 
0x37CA2318, 38092255398144424, 225028004, 225028012, 8, 1440x900 
0x37CA2318, 38092255398815352, 225028073, 225028081, 8, 1440x900 
0x37CA2318, 38092255399470176, 225028138, 225028146, 8, 1440x900 
0x37CA2318, 38092255400129888, 225028202, 225028210, 8, 1440x900 
0x37CA2318, 38092255400808944, 225028273, 225028281, 8, 1440x900 
0x37CA2318, 38092255401462128, 225028338, 225028346, 8, 1440x900 
0x37CA2318, 38092255402113632, 225028402, 225028410, 8, 1440x900 
0x37CA2318, 38092255402792672, 225028468, 225028476, 8, 1440x900 
0x37CA2318, 38092255403444320, 225028539, 225028547, 8, 1440x900 
0x37CA2318, 38092255404104496, 225028597, 225028606, 9, 1440x900 
0x37CA2318, 38092255404763528, 225028663, 225028670, 7, 1440x900 
0x37CA2318, 38092255405425152, 225028728, 225028736, 8, 1440x900 
0x37CA2318, 38092255406076944, 225028793, 225028800, 7, 1440x900 
0x37CA2318, 38092255406745704, 225028862, 225028869, 7, 1440x900 
0x37CA2318, 38092255407412824, 225028928, 225028937, 9, 1440x900 
0x37CA2318, 38092255408067024, 225028993, 225029002, 9, 1440x900 
0x37CA2318, 38092255408736048, 225029063, 225029071, 8, 1440x900 
0x37CA2318, 38092255409394240, 225029124, 225029132, 8, 1440x900 
0x37CA2318, 38092255410045152, 225029194, 225029202, 8, 1440x900 
0x37CA2318, 38092255410716824, 225029258, 225029266, 8, 1440x900 
0x37CA2318, 38092255411374224, 225029324, 225029331, 7, 1440x900 
0x37CA2318, 38092255412024456, 225029388, 225029396, 8, 1440x900 
0x37CA2318, 38092255412702264, 225029457, 225029464, 7, 1440x900 
0x37CA2318, 38092255413362616, 225029522, 225029529, 7, 1440x900 
0x37CA2318, 38092255414022824, 225029588, 225029596, 8, 1440x900 
0x37CA2318, 38092255414684336, 225029654, 225029663, 9, 1440x900 
0x37CA2318, 38092255415334688, 225029718, 225029726, 8, 1440x900 
0x37CA2318, 38092255416004760, 225029789, 225029797, 8, 1440x900 
0x37CA2318, 38092255416666032, 225029858, 225029866, 8, 1440x900 
0x37CA2318, 38092255417335088, 225029923, 225029931, 8, 1440x900 
0x37CA2318, 38092255417993888, 225029988, 225029996, 8, 1440x900 
0x37CA2318, 38092255418662592, 225030053, 225030062, 9, 1440x900 
0x37CA2318, 38092255419322520, 225030123, 225030131, 8, 1440x900 
0x37CA2318, 38092255419972016, 225030183, 225030190, 7, 1440x900 
0x37CA2318, 38092255420633512, 225030248, 225030256, 8, 1440x900 
0x37CA2318, 38092255421302184, 225030317, 225030324, 7, 1440x900 
0x37CA2318, 38092255421954256, 225030383, 225030391, 8, 1440x900 
0x37CA2318, 38092255422615400, 225030448, 225030455, 7, 1440x900 
0x37CA2318, 38092255423276264, 225030517, 225030524, 7, 1440x900 
0x37CA2318, 38092255423934880, 225030579, 225030587, 8, 1440x900 
0x37CA2318, 38092255424596568, 225030647, 225030655, 8, 1440x900 
0x37CA2318, 38092255425257872, 225030713, 225030721, 8, 1440x900 
0x37CA2318, 38092255425927088, 225030782, 225030790, 8, 1440x900 
0x37CA2318, 38092255426588184, 225030848, 225030856, 8, 1440x900 
0x37CA2318, 38092255427249672, 225030912, 225030921, 9, 1440x900 
0x37CA2318, 38092255427910776, 225030982, 225030990, 8, 1440x900 
0x37CA2318, 38092255428572152, 225031043, 225031052, 9, 1440x900 
0x37CA2318, 38092255429230672, 225031113, 225031121, 8, 1440x900 
0x37CA2318, 38092255429891056, 225031178, 225031187, 9, 1440x900 
0x37CA2318, 38092255430549232, 225031243, 225031251, 8, 1440x900 
0x37CA2318, 38092255431218808, 225031313, 225031322, 9, 1440x900 
0x37CA2318, 38092255431888568, 225031377, 225031384, 7, 1440x900 
0x37CA2318, 38092255432542912, 225031443, 225031451, 8, 1440x900 
0x37CA2318, 38092255433195008, 225031508, 225031516, 8, 1440x900 
0x37CA2318, 38092255433873336, 225031578, 225031586, 8, 1440x900 
0x37CA2318, 38092255434524160, 225031638, 225031646, 8, 1440x900 
0x37CA2318, 38092255435184736, 225031703, 225031711, 8, 1440x900 
0x37CA2318, 38092255435837512, 225031771, 225031779, 8, 1440x900 
0x37CA2318, 38092255436500984, 225031838, 225031847, 9, 1440x900 
0x37CA2318, 38092255437171280, 225031904, 225031912, 8, 1440x900 
0x37CA2318, 38092255437831224, 225031973, 225031981, 8, 1440x900 
0x37CA2318, 38092255438490560, 225032039, 225032047, 8, 1440x900 
0x37CA2318, 38092255439150384, 225032107, 225032115, 8, 1440x900 
0x37CA2318, 38092255439811696, 225032168, 225032176, 8, 1440x900 
0x37CA2318, 38092255440468120, 225032234, 225032243, 9, 1440x900 
0x37CA2318, 38092255441138504, 225032302, 225032310, 8, 1440x900 
0x37CA2318, 38092255441795672, 225032367, 225032375, 8, 1440x900 
0x37CA2318, 38092255442450824, 225032437, 225032445, 8, 1440x900 
0x37CA2318, 38092255443120304, 225032503, 225032511, 8, 1440x900 
0x37CA2318, 38092255443781128, 225032567, 225032575, 8, 1440x900 
0x37CA2318, 38092255444450824, 225032632, 225032641, 9, 1440x900 
0x37CA2318, 38092255445104944, 225032699, 225032707, 8, 1440x900 
0x37CA2318, 38092255445770880, 225032768, 225032776, 8, 1440x900 
0x37CA2318, 38092255446421312, 225032833, 225032842, 9, 1440x900 
0x37CA2318, 38092255447082696, 225032897, 225032905, 8, 1440x900 
0x37CA2318, 38092255447751776, 225032968, 225032976, 8, 1440x900 
0x37CA2318, 38092255448421568, 225033028, 225033035, 7, 1440x900 
0x37CA2318, 38092255449728104, 225033163, 225033172, 9, 1440x900 
0x37CA2318, 38092255450394384, 225033228, 225033236, 8, 1440x900 
0x37CA2318, 38092255451062984, 225033292, 225033300, 8, 1440x900 
0x37CA2318, 38092255451715648, 225033360, 225033369, 9, 1440x900 
0x37CA2318, 38092255452376120, 225033427, 225033434, 7, 1440x900 
0x37CA2318, 38092255453034760, 225033492, 225033500, 8, 1440x900 
0x37CA2318, 38092255453704680, 225033558, 225033565, 7, 1440x900 
0x37CA2318, 38092255454365128, 225033623, 225033630, 7, 1440x900 
0x37CA2318, 38092255455025136, 225033694, 225033704, 10, 1440x900 
0x37CA2318, 38092255455482440, 225033733, 225033741, 8, 1440x900 
0x37CA2318, 38092255456335664, 225033818, 225033826, 8, 1440x900 
0x37CA2318, 38092255456990272, 225033888, 225033896, 8, 1440x900 
0x37CA2318, 38092255457664208, 225033953, 225033961, 8, 1440x900 
0x37CA2318, 38092255458322680, 225034018, 225034026, 8, 1440x900 
0x37CA2318, 38092255458975024, 225034083, 225034091, 8, 1440x900 
0x37CA2318, 38092255459644160, 225034153, 225034162, 9, 1440x900 
0x37CA2318, 38092255460306528, 225034222, 225034230, 8, 1440x900 
0x37CA2318, 38092255460975792, 225034288, 225034296, 8, 1440x900 
0x37CA2318, 38092255461628432, 225034353, 225034361, 8, 1440x900 
0x37CA2318, 38092255462290024, 225034417, 225034425, 8, 1440x900 
0x37CA2318, 38092255462953832, 225034482, 225034491, 9, 1440x900 
0x37CA2318, 38092255463614256, 225034552, 225034561, 9, 1440x900 
0x37CA2318, 38092255464276472, 225034618, 225034626, 8, 1440x900 
0x37CA2318, 38092255464946296, 225034688, 225034696, 8, 1440x900 
0x37CA2318, 38092255465596088, 225034747, 225034756, 9, 1440x900 
0x37CA2318, 38092255466257864, 225034817, 225034825, 8, 1440x900 
0x37CA2318, 38092255466919568, 225034883, 225034891, 8, 1440x900 
0x37CA2318, 38092255467579472, 225034947, 225034955, 8, 1440x900 
0x37CA2318, 38092255468240112, 225035012, 225035020, 8, 1440x900 
0x37CA2318, 38092255468893328, 225035078, 225035086, 8, 1440x900 
0x37CA2318, 38092255469563080, 225035145, 225035154, 9, 1440x900 
0x37CA2318, 38092255470232232, 225035207, 225035216, 9, 1440x900 
0x37CA2318, 38092255470883968, 225035274, 225035282, 8, 1440x900 
0x37CA2318, 38092255471554064, 225035342, 225035349, 7, 1440x900 
0x37CA2318, 38092255472214808, 225035413, 225035421, 8, 1440x900 
0x37CA2318, 38092255472865728, 225035478, 225035486, 8, 1440x900 
0x37CA2318, 38092255473535296, 225035543, 225035551, 8, 1440x900 
0x37CA2318, 38092255474177856, 225035608, 225035616, 8, 1440x900 
0x37CA2318, 38092255474847232, 225035679, 225035687, 8, 1440x900 
0x37CA2318, 38092255475516128, 225035738, 225035746, 8, 1440x900 
0x37CA2318, 38092255476182792, 225035802, 225035812, 10, 1440x900 
0x37CA2318, 38092255476648320, 225035848, 225035856, 8, 1440x900 
0x37CA2318, 38092255477303512, 225035915, 225035924, 9, 1440x900 
0x37CA2318, 38092255477962968, 225035983, 225035991, 8, 1440x900 
0x37CA2318, 38092255478810680, 225036068, 225036077, 9, 1440x900 
0x37CA2318, 38092255479472320, 225036137, 225036145, 8, 1440x900 
0x37CA2318, 38092255480151520, 225036208, 225036216, 8, 1440x900 
0x37CA2318, 38092255480811704, 225036273, 225036287, 14, 1440x900 
0x37CA2318, 38092255481469928, 225036337, 225036345, 8, 1440x900 
0x37CA2318, 38092255482130968, 225036403, 225036411, 8, 1440x900 
0x37CA2318, 38092255482788216, 225036470, 225036478, 8, 1440x900 
0x37CA2318, 38092255483448992, 225036532, 225036541, 9, 1440x900 
0x37CA2318, 38092255484110392, 225036602, 225036610, 8, 1440x900 
0x37CA2318, 38092255484778768, 225036668, 225036676, 8, 1440x900 
0x37CA2318, 38092255485429568, 225036727, 225036735, 8, 1440x900 
0x37CA2318, 38092255486092416, 225036798, 225036807, 9, 1440x900 
0x37CA2318, 38092255486752888, 225036867, 225036875, 8, 1440x900 
0x37CA2318, 38092255487422720, 225036933, 225036941, 8, 1440x900 
0x37CA2318, 38092255488073216, 225036993, 225037003, 10, 1440x900 
0x37CA2318, 38092255488735600, 225037063, 225037070, 7, 1440x900 
0x37CA2318, 38092255489395800, 225037132, 225037140, 8, 1440x900 
0x37CA2318, 38092255490048904, 225037196, 225037205, 9, 1440x900 
0x37CA2318, 38092255490725440, 225037262, 225037270, 8, 1440x900 
0x37CA2318, 38092255491375368, 225037328, 225037336, 8, 1440x900 
0x37CA2318, 38092255492035504, 225037392, 225037400, 8, 1440x900 
0x37CA2318, 38092255492697000, 225037457, 225037466, 9, 1440x900 
0x37CA2318, 38092255493358528, 225037522, 225037530, 8, 1440x900 
0x37CA2318, 38092255494011008, 225037588, 225037597, 9, 1440x900 
0x37CA2318, 38092255494689480, 225037658, 225037666, 8, 1440x900 
0x37CA2318, 38092255495345968, 225037725, 225037734, 9, 1440x900 
0x37CA2318, 38092255496010720, 225037787, 225037794, 7, 1440x900 
0x37CA2318, 38092255496671256, 225037857, 225037865, 8, 1440x900 
0x37CA2318, 38092255497333088, 225037922, 225037930, 8, 1440x900 
0x37CA2318, 38092255497984256, 225037988, 225037996, 8, 1440x900 
0x37CA2318, 38092255498655552, 225038057, 225038065, 8, 1440x900 
0x37CA2318, 38092255499315848, 225038122, 225038130, 8, 1440x900 
0x37CA2318, 38092255499977424, 225038188, 225038196, 8, 1440x900 
0x37CA2318, 38092255500646008, 225038253, 225038261, 8, 1440x900 
0x37CA2318, 38092255501296864, 225038323, 225038331, 8, 1440x900 
0x37CA2318, 38092255501959712, 225038387, 225038395, 8, 1440x900 
0x37CA2318, 38092255502619560, 225038452, 225038460, 8, 1440x900 
0x37CA2318, 38092255503281712, 225038513, 225038521, 8, 1440x900 
0x37CA2318, 38092255503936144, 225038583, 225038591, 8, 1440x900 
0x37CA2318, 38092255504615040, 225038650, 225038658, 8, 1440x900 
0x37CA2318, 38092255505281424, 225038713, 225038722, 9, 1440x900 
0x37CA2318, 38092255505935992, 225038782, 225038790, 8, 1440x900 
0x37CA2318, 38092255506603368, 225038845, 225038854, 9, 1440x900 
0x37CA2318, 38092255507262136, 225038912, 225038919, 7, 1440x900 
0x37CA2318, 38092255507914928, 225038978, 225038986, 8, 1440x900 
0x37CA2318, 38092255508576216, 225039044, 225039052, 8, 1440x900 
0x37CA2318, 38092255509710400, 225039158, 225039166, 8, 1440x900 
0x37CA2318, 38092255510366000, 225039228, 225039237, 9, 1440x900 
0x37CA2318, 38092255511055552, 225039289, 225039298, 9, 1440x900 
0x37CA2318, 38092255511714976, 225039357, 225039365, 8, 1440x900 
0x37CA2318, 38092255512342056, 225039422, 225039430, 8, 1440x900 
0x37CA2318, 38092255513018896, 225039487, 225039495, 8, 1440x900 
0x37CA2318, 38092255513670296, 225039553, 225039562, 9, 1440x900 
0x37CA2318, 38092255514535568, 225039643, 225039651, 8, 1440x900 
0x37CA2318, 38092255515014008, 225039692, 225039700, 8, 1440x900 
0x37CA2318, 38092255515655008, 225039756, 225039764, 8, 1440x900 
0x37CA2318, 38092255516322656, 225039818, 225039826, 8, 1440x900 
0x37CA2318, 38092255516970144, 225039883, 225039891, 8, 1440x900 
0x37CA2318, 38092255517629992, 225039948, 225039956, 8, 1440x900 
0x37CA2318, 38092255518289944, 225040016, 225040023, 7, 1440x900 
0x37CA2318, 38092255518950080, 225040082, 225040090, 8, 1440x900 
0x37CA2318, 38092255519610344, 225040147, 225040154, 7, 1440x900 
0x37CA2318, 38092255520470008, 225040233, 225040240, 7, 1440x900 
0x37CA2318, 38092255521130304, 225040298, 225040306, 8, 1440x900 
0x37CA2318, 38092255521788384, 225040363, 225040372, 9, 1440x900 
0x37CA2318, 38092255522449312, 225040433, 225040441, 8, 1440x900 
0x37CA2318, 38092255523112640, 225040498, 225040507, 9, 1440x900 
0x37CA2318, 38092255523771112, 225040563, 225040571, 8, 1440x900 
0x37CA2318, 38092255524435536, 225040638, 225040647, 9, 1440x900 
0x37CA2318, 38092255525105192, 225040698, 225040707, 9, 1440x900 
0x37CA2318, 38092255525588976, 225040743, 225040751, 8, 1440x900 
0x37CA2318, 38092255526483680, 225040837, 225040844, 7, 1440x900 
0x37CA2318, 38092255526879584, 225040872, 225040880, 8, 1440x900 
0x37CA2318, 38092255527541288, 225040941, 225040948, 7, 1440x900 
0x37CA2318, 38092255528201560, 225041006, 225041013, 7, 1440x900 
0x37CA2318, 38092255528864056, 225041072, 225041084, 12, 1440x900 
0x37CA2318, 38092255529521880, 225041138, 225041145, 7, 1440x900 
0x37CA2318, 38092255530330520, 225041218, 225041227, 9, 1440x900 
0x37CA2318, 38092255531001640, 225041289, 225041300, 11, 1440x900 
0x37CA2318, 38092255531678904, 225041354, 225041362, 8, 1440x900 
0x37CA2318, 38092255532320360, 225041419, 225041428, 9, 1440x900 
0x37CA2318, 38092255532988584, 225041487, 225041494, 7, 1440x900 
0x37CA2318, 38092255533641552, 225041549, 225041558, 9, 1440x900 
0x37CA2318, 38092255534298888, 225041614, 225041626, 12, 1440x900 
0x37CA2318, 38092255534966616, 225041683, 225041691, 8, 1440x900 
0x37CA2318, 38092255535629928, 225041748, 225041756, 8, 1440x900 
0x37CA2318, 38092255536282000, 225041813, 225041823, 10, 1440x900 
0x37CA2318, 38092255536957112, 225041883, 225041890, 7, 1440x900 
0x37CA2318, 38092255537602240, 225041947, 225041955, 8, 1440x900 
0x37CA2318, 38092255538270616, 225042012, 225042020, 8, 1440x900 
0x37CA2318, 38092255538928776, 225042079, 225042086, 7, 1440x900 
0x37CA2318, 38092255539588384, 225042143, 225042153, 10, 1440x900 
0x37CA2318, 38092255540347552, 225042219, 225042228, 9, 1440x900 
0x37CA2318, 38092255540911200, 225042279, 225042287, 8, 1440x900 
0x37CA2318, 38092255541571608, 225042345, 225042354, 9, 1440x900 
0x37CA2318, 38092255542346264, 225042418, 225042428, 10, 1440x900 
0x37CA2318, 38092255542895120, 225042478, 225042485, 7, 1440x900 
0x37CA2318, 38092255543561808, 225042542, 225042549, 7, 1440x900 
0x37CA2318, 38092255544241904, 225042611, 225042619, 8, 1440x900 
0x37CA2318, 38092255544898360, 225042676, 225042683, 7, 1440x900 
0x37CA2318, 38092255545558000, 225042742, 225042749, 7, 1440x900 
0x37CA2318, 38092255546226264, 225042807, 225042815, 8, 1440x900 
0x37CA2318, 38092255546882752, 225042877, 225042885, 8, 1440x900 
0x37CA2318, 38092255547585936, 225042947, 225042954, 7, 1440x900 
0x37CA2318, 38092255548197376, 225043004, 225043013, 9, 1440x900 
0x37CA2318, 38092255548858592, 225043073, 225043081, 8, 1440x900 
0x37CA2318, 38092255549525000, 225043139, 225043147, 8, 1440x900 
0x37CA2318, 38092255550185992, 225043208, 225043216, 8, 1440x900 
0x37CA2318, 38092255550866184, 225043272, 225043287, 15, 1440x900 
0x37CA2318, 38092255551527624, 225043340, 225043349, 9, 1440x900 
0x37CA2318, 38092255552188608, 225043407, 225043414, 7, 1440x900 
0x37CA2318, 38092255552829848, 225043468, 225043476, 8, 1440x900 
0x37CA2318, 38092255553491008, 225043534, 225043548, 14, 1440x900 
0x37CA2318, 38092255554151360, 225043604, 225043611, 7, 1440x900 
0x37CA2318, 38092255554809416, 225043667, 225043675, 8, 1440x900 
0x37CA2318, 38092255555527392, 225043739, 225043751, 12, 1440x900 
0x37CA2318, 38092255556156752, 225043803, 225043811, 8, 1440x900 
0x37CA2318, 38092255556793848, 225043867, 225043885, 18, 1440x900 
0x37CA2318, 38092255557487048, 225043933, 225043943, 10, 1440x900 
0x37CA2318, 38092255558122600, 225043998, 225044004, 6, 1440x900 
0x37CA2318, 38092255558804520, 225044066, 225044074, 8, 1440x900 
0x37CA2318, 38092255559472240, 225044131, 225044144, 13, 1440x900 
0x37CA2318, 38092255560164600, 225044206, 225044214, 8, 1440x900 
0x37CA2318, 38092255560790856, 225044263, 225044272, 9, 1440x900 
0x37CA2318, 38092255561449288, 225044328, 225044336, 8, 1440x900 
0x37CA2318, 38092255562109152, 225044393, 225044401, 8, 1440x900 
0x37CA2318, 38092255562774176, 225044462, 225044470, 8, 1440x900 
0x37CA2318, 38092255563426872, 225044528, 225044542, 14, 1440x900 
0x37CA2318, 38092255564201984, 225044607, 225044616, 9, 1440x900 
0x37CA2318, 38092255564776304, 225044662, 225044671, 9, 1440x900 
0x37CA2318, 38092255565415600, 225044728, 225044736, 8, 1440x900 
0x37CA2318, 38092255566074928, 225044793, 225044801, 8, 1440x900 
0x37CA2318, 38092255566743240, 225044858, 225044867, 9, 1440x900 
0x37CA2318, 38092255567404112, 225044926, 225044933, 7, 1440x900 
0x37CA2318, 38092255568060376, 225044992, 225045000, 8, 1440x900 
0x37CA2318, 38092255568720624, 225045058, 225045066, 8, 1440x900 
0x37CA2318, 38092255569380048, 225045123, 225045131, 8, 1440x900 
0x37CA2318, 38092255570049784, 225045193, 225045201, 8, 1440x900 
0x37CA2318, 38092255570706472, 225045258, 225045266, 8, 1440x900 
0x37CA2318, 38092255571363176, 225045323, 225045331, 8, 1440x900 
0x37CA2318, 38092255572023192, 225045387, 225045395, 8, 1440x900 
0x37CA2318, 38092255572683784, 225045453, 225045462, 9, 1440x900 
0x37CA2318, 38092255573345000, 225045522, 225045530, 8, 1440x900 
0x37CA2318, 38092255574003856, 225045587, 225045595, 8, 1440x900 
0x37CA2318, 38092255574664768, 225045652, 225045660, 8, 1440x900 
0x37CA2318, 38092255575326192, 225045718, 225045726, 8, 1440x900 
0x37CA2318, 38092255575986176, 225045783, 225045791, 8, 1440x900 
0x37CA2318, 38092255576648480, 225045852, 225045860, 8, 1440x900 
0x37CA2318, 38092255577306368, 225045916, 225045924, 8, 1440x900 
0x37CA2318, 38092255577968656, 225045983, 225045990, 7, 1440x900 
0x37CA2318, 38092255578625008, 225046047, 225046055, 8, 1440x900 
0x37CA2318, 38092255579288152, 225046113, 225046121, 8, 1440x900 
0x37CA2318, 38092255579948680, 225046178, 225046186, 8, 1440x900 
0x37CA2318, 38092255580608624, 225046247, 225046254, 7, 1440x900 
0x37CA2318, 38092255581269296, 225046313, 225046322, 9, 1440x900 
0x37CA2318, 38092255581931560, 225046379, 225046387, 8, 1440x900 
0x37CA2318, 38092255582714912, 225046459, 225046467, 8, 1440x900 
0x37CA2318, 38092255583444896, 225046531, 225046538, 7, 1440x900 
0x37CA2318, 38092255584117064, 225046598, 225046605, 7, 1440x900 
0x37CA2318, 38092255584678144, 225046653, 225046661, 8, 1440x900 
0x37CA2318, 38092255585232024, 225046708, 225046716, 8, 1440x900 
0x37CA2318, 38092255585896288, 225046778, 225046786, 8, 1440x900 
0x37CA2318, 38092255586751632, 225046862, 225046871, 9, 1440x900 
0x37CA2318, 38092255587217520, 225046910, 225046919, 9, 1440x900 
0x37CA2318, 38092255587877120, 225046977, 225046985, 8, 1440x900 
0x37CA2318, 38092255589195032, 225047107, 225047115, 8, 1440x900 
0x37CA2318, 38092255590057264, 225047198, 225047206, 8, 1440x900 
0x37CA2318, 38092255590518240, 225047243, 225047252, 9, 1440x900 
0x37CA2318, 38092255591181000, 225047309, 225047318, 9, 1440x900 
0x37CA2318, 38092255591840944, 225047378, 225047386, 8, 1440x900 
0x37CA2318, 38092255592501104, 225047442, 225047450, 8, 1440x900 
0x37CA2318, 38092255593161832, 225047504, 225047513, 9, 1440x900 
0x37CA2318, 38092255593821976, 225047573, 225047582, 9, 1440x900 
0x37CA2318, 38092255594483712, 225047634, 225047641, 7, 1440x900 
0x37CA2318, 38092255595140024, 225047704, 225047711, 7, 1440x900 
0x37CA2318, 38092255595799864, 225047767, 225047775, 8, 1440x900 
0x37CA2318, 38092255596460128, 225047833, 225047841, 8, 1440x900 
0x37CA2318, 38092255597121160, 225047898, 225047906, 8, 1440x900 
0x37CA2318, 38092255597801744, 225047968, 225047975, 7, 1440x900 
0x37CA2318, 38092255598442952, 225048033, 225048041, 8, 1440x900 
0x37CA2318, 38092255599100824, 225048097, 225048104, 7, 1440x900 
0x37CA2318, 38092255599764816, 225048168, 225048176, 8, 1440x900 
0x37CA2318, 38092255600424424, 225048233, 225048241, 8, 1440x900 
0x37CA2318, 38092255601085600, 225048298, 225048306, 8, 1440x900 
0x37CA2318, 38092255601946968, 225048387, 225048395, 8, 1440x900 
0x37CA2318, 38092255602600064, 225048447, 225048454, 7, 1440x900 
0x37CA2318, 38092255603068496, 225048498, 225048506, 8, 1440x900 
0x37CA2318, 38092255603729920, 225048563, 225048571, 8, 1440x900 
0x37CA2318, 38092255604392776, 225048628, 225048636, 8, 1440x900 
0x37CA2318, 38092255605048920, 225048694, 225048702, 8, 1440x900 
0x37CA2318, 38092255605712896, 225048758, 225048765, 7, 1440x900 
0x37CA2318, 38092255606366976, 225048822, 225048830, 8, 1440x900 
0x37CA2318, 38092255607027024, 225048889, 225048897, 8, 1440x900 
0x37CA2318, 38092255607691512, 225048958, 225048967, 9, 1440x900 
0x37CA2318, 38092255608349544, 225049022, 225049030, 8, 1440x900 
0x37CA2318, 38092255609010232, 225049091, 225049099, 8, 1440x900 
0x37CA2318, 38092255609669944, 225049153, 225049161, 8, 1440x900 
0x37CA2318, 38092255610329624, 225049221, 225049229, 8, 1440x900 
0x37CA2318, 38092255610989816, 225049287, 225049295, 8, 1440x900 
0x37CA2318, 38092255611650088, 225049353, 225049361, 8, 1440x900 
0x37CA2318, 38092255612326440, 225049422, 225049429, 7, 1440x900 
0x37CA2318, 38092255612971312, 225049483, 225049491, 8, 1440x900 
0x37CA2318, 38092255613631312, 225049552, 225049558, 6, 1440x900 
0x37CA2318, 38092255614291056, 225049618, 225049625, 7, 1440x900 
0x37CA2318, 38092255614952032, 225049682, 225049690, 8, 1440x900 
0x37CA2318, 38092255615814976, 225049768, 225049775, 7, 1440x900 
0x37CA2318, 38092255616484144, 225049837, 225049846, 9, 1440x900 
0x37CA2318, 38092255616938560, 225049883, 225049890, 7, 1440x900 
0x37CA2318, 38092255617793504, 225049967, 225049975, 8, 1440x900 
0x37CA2318, 38092255618461776, 225050032, 225050040, 8, 1440x900 
0x37CA2318, 38092255618919712, 225050081, 225050089, 8, 1440x900 
0x37CA2318, 38092255619580336, 225050148, 225050155, 7, 1440x900 
0x37CA2318, 38092255620240680, 225050212, 225050220, 8, 1440x900 
0x37CA2318, 38092255620900096, 225050277, 225050285, 8, 1440x900 
0x37CA2318, 38092255621561136, 225050342, 225050351, 9, 1440x900 
0x37CA2318, 38092255622224048, 225050411, 225050419, 8, 1440x900 
0x37CA2318, 38092255623075936, 225050493, 225050502, 9, 1440x900 
0x37CA2318, 38092255623731424, 225050563, 225050572, 9, 1440x900 
0x37CA2318, 38092255624207592, 225050608, 225050617, 9, 1440x900 
0x37CA2318, 38092255624868608, 225050679, 225050690, 11, 1440x900 
0x37CA2318, 38092255625525488, 225050738, 225050746, 8, 1440x900 
0x37CA2318, 38092255626186352, 225050803, 225050812, 9, 1440x900 
0x37CA2318, 38092255626851984, 225050872, 225050880, 8, 1440x900 
0x37CA2318, 38092255627507968, 225050936, 225050945, 9, 1440x900 
0x37CA2318, 38092255628169840, 225051003, 225051011, 8, 1440x900 
0x37CA2318, 38092255628827792, 225051068, 225051077, 9, 1440x900 
0x37CA2318, 38092255629496952, 225051138, 225051146, 8, 1440x900 
0x37CA2318, 38092255630160544, 225051208, 225051216, 8, 1440x900 
0x37CA2318, 38092255630815512, 225051267, 225051276, 9, 1440x900 
0x37CA2318, 38092255631475464, 225051332, 225051340, 8, 1440x900 
0x37CA2318, 38092255632147936, 225051402, 225051409, 7, 1440x900 
0x37CA2318, 38092255632794752, 225051466, 225051473, 7, 1440x900 
0x37CA2318, 38092255633454696, 225051529, 225051537, 8, 1440x900 
0x37CA2318, 38092255634127008, 225051598, 225051606, 8, 1440x900 
0x37CA2318, 38092255634774736, 225051663, 225051671, 8, 1440x900 
0x37CA2318, 38092255635434816, 225051728, 225051736, 8, 1440x900 
0x37CA2318, 38092255636094768, 225051793, 225051803, 10, 1440x900 
0x37CA2318, 38092255636756016, 225051862, 225051870, 8, 1440x900 
0x37CA2318, 38092255637426096, 225051933, 225051941, 8, 1440x900 
0x37CA2318, 38092255638080280, 225051998, 225052006, 8, 1440x900 
0x37CA2318, 38092255638748936, 225052063, 225052072, 9, 1440x900 
0x37CA2318, 38092255639605976, 225052148, 225052156, 8, 1440x900 
0x37CA2318, 38092255640069328, 225052193, 225052204, 11, 1440x900 
0x37CA2318, 38092255640727368, 225052258, 225052266, 8, 1440x900 
0x37CA2318, 38092255641391984, 225052327, 225052335, 8, 1440x900 
0x37CA2318, 38092255642707800, 225052458, 225052466, 8, 1440x900 
0x37CA2318, 38092255643366808, 225052523, 225052531, 8, 1440x900 
0x37CA2318, 38092255644032304, 225052589, 225052597, 8, 1440x900 
0x37CA2318, 38092255644691056, 225052657, 225052664, 7, 1440x900 
0x37CA2318, 38092255645346632, 225052718, 225052726, 8, 1440x900 
0x37CA2318, 38092255646008640, 225052788, 225052795, 7, 1440x900 
0x37CA2318, 38092255646872368, 225052873, 225052879, 6, 1440x900 
0x37CA2318, 38092255647327584, 225052919, 225052927, 8, 1440x900 
0x37CA2318, 38092255648004968, 225052988, 225052996, 8, 1440x900 
0x37CA2318, 38092255648855120, 225053074, 225053083, 9, 1440x900 
0x37CA2318, 38092255649326864, 225053122, 225053130, 8, 1440x900 
0x37CA2318, 38092255650177400, 225053207, 225053215, 8, 1440x900 
0x37CA2318, 38092255650643496, 225053257, 225053266, 9, 1440x900 
0x37CA2318, 38092255651498608, 225053337, 225053345, 8, 1440x900 
0x37CA2318, 38092255652170408, 225053407, 225053415, 8, 1440x900 
0x37CA2318, 38092255652635008, 225053453, 225053461, 8, 1440x900 
0x37CA2318, 38092255653490584, 225053538, 225053545, 7, 1440x900 
0x37CA2318, 38092255653949024, 225053581, 225053590, 9, 1440x900 
0x37CA2318, 38092255654609256, 225053647, 225053655, 8, 1440x900 
0x37CA2318, 38092255655475184, 225053738, 225053746, 8, 1440x900 
0x37CA2318, 38092255656141168, 225053803, 225053811, 8, 1440x900 
0x37CA2318, 38092255656796728, 225053868, 225053876, 8, 1440x900 
0x37CA2318, 38092255657261272, 225053917, 225053925, 8, 1440x900 
0x37CA2318, 38092255658117216, 225053999, 225054008, 9, 1440x900 
0x37CA2318, 38092255658780040, 225054067, 225054075, 8, 1440x900 
0x37CA2318, 38092255659440096, 225054133, 225054141, 8, 1440x900 
0x37CA2318, 38092255660093608, 225054198, 225054207, 9, 1440x900 
0x37CA2318, 38092255660766808, 225054264, 225054272, 8, 1440x900 
0x37CA2318, 38092255661225608, 225054312, 225054321, 9, 1440x900 
0x37CA2318, 38092255661881312, 225054377, 225054385, 8, 1440x900 
0x37CA2318, 38092255662543728, 225054443, 225054451, 8, 1440x900 
0x37CA2318, 38092255663206040, 225054512, 225054520, 8, 1440x900 
0x37CA2318, 38092255663862344, 225054573, 225054582, 9, 1440x900 
0x37CA2318, 38092255664522632, 225054637, 225054645, 8, 1440x900 
0x37CA2318, 38092255665391296, 225054728, 225054736, 8, 1440x900 
0x37CA2318, 38092255666041968, 225054793, 225054801, 8, 1440x900 
0x37CA2318, 38092255666711920, 225054862, 225054870, 8, 1440x900 
0x37CA2318, 38092255667373832, 225054927, 225054935, 8, 1440x900 
0x37CA2318, 38092255668032864, 225054993, 225055001, 8, 1440x900 
0x37CA2318, 38092255668693224, 225055058, 225055066, 8, 1440x900 
0x37CA2318, 38092255669362688, 225055123, 225055132, 9, 1440x900 
0x37CA2318, 38092255670013560, 225055192, 225055200, 8, 1440x900 
0x37CA2318, 38092255670676192, 225055258, 225055266, 8, 1440x900 
0x37CA2318, 38092255671335472, 225055323, 225055331, 8, 1440x900 
0x37CA2318, 38092255671993960, 225055388, 225055396, 8, 1440x900 
0x37CA2318, 38092255672657928, 225055453, 225055462, 9, 1440x900 
0x37CA2318, 38092255673318184, 225055523, 225055532, 9, 1440x900 
0x37CA2318, 38092255673781408, 225055567, 225055574, 7, 1440x900 
0x37CA2318, 38092255674442344, 225055631, 225055640, 9, 1440x900 
0x37CA2318, 38092255675101040, 225055697, 225055704, 7, 1440x900 
0x37CA2318, 38092255675761560, 225055762, 225055770, 8, 1440x900 
0x37CA2318, 38092255676440704, 225055832, 225055840, 8, 1440x900 
0x37CA2318, 38092255677089528, 225055897, 225055905, 8, 1440x900 
0x37CA2318, 38092255677749792, 225055963, 225055971, 8, 1440x900 
0x37CA2318, 38092255678413456, 225056032, 225056040, 8, 1440x900 
0x37CA2318, 38092255679071344, 225056098, 225056106, 8, 1440x900 
0x37CA2318, 38092255679731512, 225056162, 225056170, 8, 1440x900 
0x37CA2318, 38092255680394840, 225056227, 225056236, 9, 1440x900 
0x37CA2318, 38092255681052104, 225056297, 225056305, 8, 1440x900 
0x37CA2318, 38092255681717880, 225056362, 225056370, 8, 1440x900 
0x37CA2318, 38092255682375816, 225056424, 225056432, 8, 1440x900 
0x37CA2318, 38092255683038576, 225056498, 225056506, 8, 1440x900 
0x37CA2318, 38092255683704208, 225056557, 225056567, 10, 1440x900 
0x37CA2318, 38092255684371080, 225056622, 225056630, 8, 1440x900 
0x37CA2318, 38092255685020808, 225056687, 225056695, 8, 1440x900 
0x37CA2318, 38092255685677488, 225056753, 225056761, 8, 1440x900 
0x37CA2318, 38092255686337520, 225056818, 225056826, 8, 1440x900 
0x37CA2318, 38092255687157728, 225056902, 225056909, 7, 1440x900 
0x37CA2318, 38092255687657520, 225056953, 225056960, 7, 1440x900 
0x37CA2318, 38092255688317592, 225057017, 225057025, 8, 1440x900 
0x37CA2318, 38092255688990544, 225057083, 225057091, 8, 1440x900 
0x37CA2318, 38092255689649864, 225057149, 225057157, 8, 1440x900 
0x37CA2318, 38092255690306160, 225057217, 225057224, 7, 1440x900 
0x37CA2318, 38092255690965912, 225057282, 225057290, 8, 1440x900 
0x37CA2318, 38092255691824128, 225057369, 225057376, 7, 1440x900 
0x37CA2318, 38092255692486048, 225057437, 225057445, 8, 1440x900 
0x37CA2318, 38092255693147768, 225057502, 225057510, 8, 1440x900 
0x37CA2318, 38092255693809384, 225057568, 225057577, 9, 1440x900 
0x37CA2318, 38092255694284552, 225057618, 225057627, 9, 1440x900 
0x37CA2318, 38092255694934016, 225057683, 225057691, 8, 1440x900 
0x37CA2318, 38092255695593936, 225057748, 225057757, 9, 1440x900 
0x37CA2318, 38092255696251968, 225057812, 225057820, 8, 1440x900 
0x37CA2318, 38092255697116776, 225057898, 225057906, 8, 1440x900 
0x37CA2318, 38092255697587160, 225057947, 225057955, 8, 1440x900 
0x37CA2318, 38092255698237080, 225058012, 225058020, 8, 1440x900 
0x37CA2318, 38092255699095728, 225058097, 225058105, 8, 1440x900 
0x37CA2318, 38092255699562664, 225058142, 225058150, 8, 1440x900 
0x37CA2318, 38092255700237064, 225058213, 225058221, 8, 1440x900 
0x37CA2318, 38092255700894416, 225058282, 225058290, 8, 1440x900 
0x37CA2318, 38092255701554120, 225058347, 225058355, 8, 1440x900 
0x37CA2318, 38092255702214112, 225058413, 225058421, 8, 1440x900 
0x37CA2318, 38092255703077792, 225058493, 225058501, 8, 1440x900 
0x37CA2318, 38092255703731664, 225058561, 225058569, 8, 1440x900 
0x37CA2318, 38092255704851152, 225058673, 225058681, 8, 1440x900 
0x37CA2318, 38092255705519128, 225058738, 225058747, 9, 1440x900 
0x37CA2318, 38092255706384536, 225058827, 225058835, 8, 1440x900 
0x37CA2318, 38092255706852040, 225058873, 225058881, 8, 1440x900 
0x37CA2318, 38092255707508256, 225058938, 225058946, 8, 1440x900 
0x37CA2318, 38092255708170360, 225059003, 225059011, 8, 1440x900 
0x37CA2318, 38092255708835096, 225059073, 225059081, 8, 1440x900 
0x37CA2318, 38092255709489488, 225059137, 225059145, 8, 1440x900 
0x37CA2318, 38092255710152328, 225059202, 225059210, 8, 1440x900 
0x37CA2318, 38092255711007696, 225059292, 225059300, 8, 1440x900 
0x37CA2318, 38092255711670120, 225059358, 225059366, 8, 1440x900 
0x37CA2318, 38092255712136944, 225059402, 225059411, 9, 1440x900 
0x37CA2318, 38092255712793488, 225059467, 225059475, 8, 1440x900 
0x37CA2318, 38092255713453072, 225059532, 225059539, 7, 1440x900 
0x37CA2318, 38092255714125096, 225059598, 225059605, 7, 1440x900 
0x37CA2318, 38092255714773008, 225059662, 225059670, 8, 1440x900 
0x37CA2318, 38092255715433800, 225059728, 225059736, 8, 1440x900 
0x37CA2318, 38092255716098920, 225059797, 225059805, 8, 1440x900 
0x37CA2318, 38092255716761536, 225059862, 225059871, 9, 1440x900 
0x37CA2318, 38092255717420984, 225059928, 225059937, 9, 1440x900 
0x37CA2318, 38092255718079896, 225059993, 225060002, 9, 1440x900 
0x37CA2318, 38092255718739760, 225060062, 225060071, 9, 1440x900 
0x37CA2318, 38092255719418352, 225060127, 225060136, 9, 1440x900 
0x37CA2318, 38092255720258320, 225060212, 225060220, 8, 1440x900 
0x37CA2318, 38092255720841120, 225060272, 225060280, 8, 1440x900 
0x37CA2318, 38092255721382512, 225060327, 225060335, 8, 1440x900 
0x37CA2318, 38092255722045704, 225060391, 225060428, 37, 1440x900 
0x37CA2318, 38092255722863752, 225060473, 225060481, 8, 1440x900 
0x37CA2318, 38092255723521472, 225060537, 225060545, 8, 1440x900 
0x37CA2318, 38092255724168832, 225060602, 225060609, 7, 1440x900 
0x37CA2318, 38092255724840864, 225060668, 225060676, 8, 1440x900 
0x37CA2318, 38092255725490760, 225060736, 225060744, 8, 1440x900 
0x37CA2318, 38092255726349456, 225060823, 225060830, 7, 1440x900 
0x37CA2318, 38092255727009824, 225060887, 225060894, 7, 1440x900 
0x37CA2318, 38092255727672816, 225060953, 225060960, 7, 1440x900 
0x37CA2318, 38092255728342824, 225061023, 225061031, 8, 1440x900 
0x37CA2318, 38092255728799272, 225061068, 225061077, 9, 1440x900 
0x37CA2318, 38092255729468872, 225061132, 225061140, 8, 1440x900 
0x37CA2318, 38092255730117928, 225061197, 225061205, 8, 1440x900 
0x37CA2318, 38092255730798736, 225061267, 225061274, 7, 1440x900 
0x37CA2318, 38092255731436920, 225061328, 225061336, 8, 1440x900 
0x37CA2318, 38092255732139488, 225061398, 225061406, 8, 1440x900 
0x37CA2318, 38092255732837264, 225061468, 225061476, 8, 1440x900 
0x37CA2318, 38092255733442832, 225061531, 225061538, 7, 1440x900 
0x37CA2318, 38092255734108984, 225061603, 225061612, 9, 1440x900 
0x37CA2318, 38092255734770696, 225061668, 225061676, 8, 1440x900 
0x37CA2318, 38092255735431128, 225061732, 225061742, 10, 1440x900 
0x37CA2318, 38092255736286640, 225061816, 225061823, 7, 1440x900 
0x37CA2318, 38092255736946456, 225061882, 225061890, 8, 1440x900 
0x37CA2318, 38092255737544792, 225061942, 225061949, 7, 1440x900 
0x37CA2318, 38092255738267912, 225062012, 225062020, 8, 1440x900 
0x37CA2318, 38092255738930888, 225062088, 225062098, 10, 1440x900 
0x37CA2318, 38092255739420216, 225062127, 225062135, 8, 1440x900 
0x37CA2318, 38092255740053008, 225062189, 225062198, 9, 1440x900 
0x37CA2318, 38092255740712872, 225062257, 225062265, 8, 1440x900 
0x37CA2318, 38092255741373688, 225062323, 225062331, 8, 1440x900 
0x37CA2318, 38092255742035616, 225062388, 225062398, 10, 1440x900 
0x37CA2318, 38092255742697776, 225062453, 225062461, 8, 1440x900 
0x37CA2318, 38092255743355992, 225062523, 225062530, 7, 1440x900 
0x37CA2318, 38092255744015848, 225062587, 225062594, 7, 1440x900 
0x37CA2318, 38092255744676800, 225062653, 225062661, 8, 1440x900 
0x37CA2318, 38092255745340112, 225062718, 225062726, 8, 1440x900 
0x37CA2318, 38092255745999376, 225062788, 225062796, 8, 1440x900 
0x37CA2318, 38092255746663224, 225062853, 225062861, 8, 1440x900 
0x37CA2318, 38092255747321360, 225062919, 225062926, 7, 1440x900 
0x37CA2318, 38092255747979528, 225062983, 225062990, 7, 1440x900 
0x37CA2318, 38092255748642248, 225063052, 225063060, 8, 1440x900 
0x37CA2318, 38092255749302712, 225063117, 225063125, 8, 1440x900 
0x37CA2318, 38092255749963016, 225063182, 225063190, 8, 1440x900 
0x37CA2318, 38092255750629280, 225063251, 225063259, 8, 1440x900 
0x37CA2318, 38092255751290488, 225063317, 225063325, 8, 1440x900 
0x37CA2318, 38092255751944768, 225063382, 225063390, 8, 1440x900 
0x37CA2318, 38092255752606928, 225063448, 225063456, 8, 1440x900 
0x37CA2318, 38092255753263536, 225063512, 225063520, 8, 1440x900 
0x37CA2318, 38092255753922680, 225063577, 225063585, 8, 1440x900 
0x37CA2318, 38092255754583528, 225063645, 225063653, 8, 1440x900 
0x37CA2318, 38092255755246216, 225063714, 225063723, 9, 1440x900 
0x37CA2318, 38092255755956024, 225063783, 225063795, 12, 1440x900 
0x37CA2318, 38092255756756224, 225063866, 225063875, 9, 1440x900 
0x37CA2318, 38092255757233832, 225063908, 225063916, 8, 1440x900 
0x37CA2318, 38092255757901544, 225063977, 225063997, 20, 1440x900 
0x37CA2318, 38092255758583232, 225064042, 225064050, 8, 1440x900 
0x37CA2318, 38092255759212856, 225064107, 225064119, 12, 1440x900 
0x37CA2318, 38092255759882880, 225064173, 225064181, 8, 1440x900 
0x37CA2318, 38092255760532872, 225064237, 225064246, 9, 1440x900 
0x37CA2318, 38092255761192008, 225064303, 225064312, 9, 1440x900 
0x37CA2318, 38092255761867872, 225064372, 225064380, 8, 1440x900 
0x37CA2318, 38092255762530040, 225064437, 225064445, 8, 1440x900 
0x37CA2318, 38092255763176728, 225064503, 225064510, 7, 1440x900 
0x37CA2318, 38092255763839096, 225064568, 225064576, 8, 1440x900 
0x37CA2318, 38092255764499232, 225064636, 225064643, 7, 1440x900 
0x37CA2318, 38092255765160600, 225064702, 225064710, 8, 1440x900 
0x37CA2318, 38092255765825264, 225064772, 225064779, 7, 1440x900 
0x37CA2318, 38092255766484024, 225064838, 225064847, 9, 1440x900 
0x37CA2318, 38092255767229912, 225064908, 225064924, 16, 1440x900 
0x37CA2318, 38092255767833024, 225064968, 225064976, 8, 1440x900 
0x37CA2318, 38092255768490152, 225065038, 225065048, 10, 1440x900 
0x37CA2318, 38092255769151328, 225065102, 225065109, 7, 1440x900 
0x37CA2318, 38092255769780592, 225065163, 225065171, 8, 1440x900 
0x37CA2318, 38092255770440424, 225065228, 225065236, 8, 1440x900 
0x37CA2318, 38092255771100416, 225065297, 225065304, 7, 1440x900 
0x37CA2318, 38092255771760704, 225065363, 225065370, 7, 1440x900 
0x37CA2318, 38092255772420768, 225065427, 225065434, 7, 1440x900 
0x37CA2318, 38092255773080616, 225065493, 225065501, 8, 1440x900 
0x37CA2318, 38092255773739992, 225065558, 225065566, 8, 1440x900 
0x37CA2318, 38092255774400808, 225065627, 225065634, 7, 1440x900 
0x37CA2318, 38092255775060840, 225065692, 225065699, 7, 1440x900 
0x37CA2318, 38092255775720904, 225065758, 225065765, 7, 1440x900 
0x37CA2318, 38092255777040224, 225065888, 225065896, 8, 1440x900 
0x37CA2318, 38092255777700824, 225065957, 225065964, 7, 1440x900 
0x37CA2318, 38092255778387200, 225066023, 225066032, 9, 1440x900 
0x37CA2318, 38092255779069552, 225066092, 225066100, 8, 1440x900 
0x37CA2318, 38092255779685632, 225066153, 225066161, 8, 1440x900 
0x37CA2318, 38092255780345280, 225066218, 225066226, 8, 1440x900 
0x37CA2318, 38092255781004960, 225066287, 225066295, 8, 1440x900 
0x37CA2318, 38092255781664832, 225066352, 225066359, 7, 1440x900 
0x37CA2318, 38092255782325384, 225066418, 225066425, 7, 1440x900 
0x37CA2318, 38092255783046464, 225066493, 225066506, 13, 1440x900 
0x37CA2318, 38092255783679592, 225066553, 225066561, 8, 1440x900 
0x37CA2318, 38092255784336200, 225066618, 225066626, 8, 1440x900 
0x37CA2318, 38092255785080480, 225066693, 225066705, 12, 1440x900 
0x37CA2318, 38092255785670928, 225066753, 225066760, 7, 1440x900 
0x37CA2318, 38092255786301744, 225066814, 225066823, 9, 1440x900 
0x37CA2318, 38092255786962080, 225066885, 225066892, 7, 1440x900 
0x37CA2318, 38092255787628496, 225066949, 225066957, 8, 1440x900 
0x37CA2318, 38092255788311720, 225067026, 225067035, 9, 1440x900 
0x37CA2318, 38092255788994744, 225067088, 225067110, 22, 1440x900 
0x37CA2318, 38092255789636200, 225067149, 225067157, 8, 1440x900 
0x37CA2318, 38092255790279024, 225067212, 225067221, 9, 1440x900 
0x37CA2318, 38092255790968376, 225067284, 225067292, 8, 1440x900 
0x37CA2318, 38092255791633776, 225067353, 225067360, 7, 1440x900 
0x37CA2318, 38092255792261408, 225067412, 225067420, 8, 1440x900 
0x37CA2318, 38092255792922552, 225067478, 225067486, 8, 1440x900 
0x37CA2318, 38092255793581416, 225067542, 225067549, 7, 1440x900 
0x37CA2318, 38092255794290640, 225067617, 225067624, 7, 1440x900 
0x37CA2318, 38092255794912888, 225067678, 225067686, 8, 1440x900 
0x37CA2318, 38092255795595680, 225067748, 225067755, 7, 1440x900 
0x37CA2318, 38092255796230368, 225067808, 225067815, 7, 1440x900 
0x37CA2318, 38092255796890272, 225067873, 225067881, 8, 1440x900 
0x37CA2318, 38092255797550464, 225067941, 225067948, 7, 1440x900 
0x37CA2318, 38092255798210080, 225068007, 225068014, 7, 1440x900 
0x37CA2318, 38092255798915448, 225068078, 225068089, 11, 1440x900 
0x37CA2318, 38092255799559128, 225068143, 225068150, 7, 1440x900 
0x37CA2318, 38092255800191696, 225068207, 225068214, 7, 1440x900 
0x37CA2318, 38092255800854768, 225068273, 225068281, 8, 1440x900 
0x37CA2318, 38092255801516200, 225068337, 225068344, 7, 1440x900 
0x37CA2318, 38092255802205656, 225068408, 225068416, 8, 1440x900 
0x37CA2318, 38092255802836928, 225068473, 225068481, 8, 1440x900 
0x37CA2318, 38092255803577248, 225068547, 225068562, 15, 1440x900 
0x37CA2318, 38092255804232272, 225068613, 225068635, 22, 1440x900 
0x37CA2318, 38092255804863776, 225068684, 225068693, 9, 1440x900 
0x37CA2318, 38092255805631592, 225068761, 225068773, 12, 1440x900 
0x37CA2318, 38092255806193504, 225068807, 225068814, 7, 1440x900 
0x37CA2318, 38092255806809120, 225068868, 225068875, 7, 1440x900 
0x37CA2318, 38092255807469632, 225068932, 225068940, 8, 1440x900 
0x37CA2318, 38092255808129440, 225069001, 225069008, 7, 1440x900 
0x37CA2318, 38092255808789472, 225069063, 225069071, 8, 1440x900 
0x37CA2318, 38092255809449448, 225069128, 225069136, 8, 1440x900 
0x37CA2318, 38092255810109424, 225069198, 225069206, 8, 1440x900 
0x37CA2318, 38092255810876544, 225069278, 225069300, 22, 1440x900 
0x37CA2318, 38092255811502800, 225069362, 225069372, 10, 1440x900 
0x37CA2318, 38092255812141344, 225069403, 225069410, 7, 1440x900 
0x37CA2318, 38092255812769096, 225069463, 225069478, 15, 1440x900 
0x37CA2318, 38092255813459576, 225069529, 225069545, 16, 1440x900 
0x37CA2318, 38092255814105192, 225069595, 225069609, 14, 1440x900 
0x37CA2318, 38092255814765568, 225069663, 225069670, 7, 1440x900 
0x37CA2318, 38092255815609256, 225069748, 225069754, 6, 1440x900 
0x37CA2318, 38092255816116048, 225069796, 225069803, 7, 1440x900 
0x37CA2318, 38092255816742976, 225069858, 225069866, 8, 1440x900 
0x37CA2318, 38092255817401864, 225069927, 225069934, 7, 1440x900 
0x37CA2318, 38092255818061136, 225069992, 225069999, 7, 1440x900 
0x37CA2318, 38092255818721352, 225070058, 225070064, 6, 1440x900 
0x37CA2318, 38092255819384936, 225070122, 225070129, 7, 1440x900 
0x37CA2318, 38092255820041048, 225070188, 225070195, 7, 1440x900 
0x37CA2318, 38092255820918504, 225070277, 225070284, 7, 1440x900 
0x37CA2318, 38092255821400456, 225070327, 225070335, 8, 1440x900 
0x37CA2318, 38092255822035240, 225070392, 225070400, 8, 1440x900 
0x37CA2318, 38092255822697224, 225070457, 225070463, 6, 1440x900 
0x37CA2318, 38092255823356152, 225070522, 225070529, 7, 1440x900 
0x37CA2318, 38092255824219168, 225070608, 225070616, 8, 1440x900 
0x37CA2318, 38092255824871888, 225070678, 225070686, 8, 1440x900 
0x37CA2318, 38092255825540944, 225070743, 225070751, 8, 1440x900 
0x37CA2318, 38092255826535696, 225070846, 225070864, 18, 1440x900 
0x37CA2318, 38092255826844368, 225070873, 225070881, 8, 1440x900 
0x37CA2318, 38092255827514720, 225070938, 225070946, 8, 1440x900 
0x37CA2318, 38092255828178000, 225071003, 225071011, 8, 1440x900 
0x37CA2318, 38092255828843456, 225071072, 225071080, 8, 1440x900 
0x37CA2318, 38092255829496296, 225071138, 225071145, 7, 1440x900 
0x37CA2318, 38092255830156432, 225071203, 225071209, 6, 1440x900 
0x37CA2318, 38092255830815872, 225071267, 225071275, 8, 1440x900 
0x37CA2318, 38092255831484272, 225071333, 225071345, 12, 1440x900 
0x37CA2318, 38092255832143440, 225071398, 225071409, 11, 1440x900 
0x37CA2318, 38092255832803328, 225071467, 225071475, 8, 1440x900 
0x37CA2318, 38092255833451544, 225071532, 225071542, 10, 1440x900 
0x37CA2318, 38092255834124520, 225071597, 225071605, 8, 1440x900 
0x37CA2318, 38092255834785136, 225071663, 225071671, 8, 1440x900 
0x37CA2318, 38092255835431480, 225071728, 225071736, 8, 1440x900 
0x37CA2318, 38092255836291832, 225071817, 225071825, 8, 1440x900 
0x37CA2318, 38092255836952832, 225071882, 225071889, 7, 1440x900 
0x37CA2318, 38092255837613376, 225071947, 225071956, 9, 1440x900 
0x37CA2318, 38092255838275128, 225072018, 225072026, 8, 1440x900 
0x37CA2318, 38092255838935816, 225072084, 225072093, 9, 1440x900 
0x37CA2318, 38092255839596576, 225072148, 225072157, 9, 1440x900 
0x37CA2318, 38092255840264736, 225072213, 225072224, 11, 1440x900 
0x37CA2318, 38092255840853696, 225072271, 225072283, 12, 1440x900 
0x37CA2318, 38092255841599880, 225072344, 225072354, 10, 1440x900 
0x37CA2318, 38092255842096864, 225072394, 225072402, 8, 1440x900 
0x37CA2318, 38092255842930968, 225072478, 225072485, 7, 1440x900 
0x37CA2318, 38092255843590896, 225072543, 225072552, 9, 1440x900 
0x37CA2318, 38092255844245680, 225072611, 225072619, 8, 1440x900 
0x37CA2318, 38092255844916640, 225072682, 225072690, 8, 1440x900 
0x37CA2318, 38092255845575056, 225072748, 225072756, 8, 1440x900 
0x37CA2318, 38092255846245720, 225072813, 225072822, 9, 1440x900 
0x37CA2318, 38092255846895536, 225072876, 225072884, 8, 1440x900 
0x37CA2318, 38092255847549184, 225072947, 225072955, 8, 1440x900 
0x37CA2318, 38092255848211632, 225073008, 225073017, 9, 1440x900 
0x37CA2318, 38092255848842968, 225073073, 225073082, 9, 1440x900 
0x37CA2318, 38092255849548080, 225073142, 225073150, 8, 1440x900 
0x37CA2318, 38092255850003544, 225073187, 225073195, 8, 1440x900 
0x37CA2318, 38092255850665392, 225073253, 225073260, 7, 1440x900 
0x37CA2318, 38092255851325048, 225073318, 225073326, 8, 1440x900 
0x37CA2318, 38092255851984640, 225073383, 225073391, 8, 1440x900 
0x37CA2318, 38092255852841080, 225073471, 225073479, 8, 1440x900 
0x37CA2318, 38092255853502440, 225073537, 225073545, 8, 1440x900 
0x37CA2318, 38092255854163040, 225073602, 225073611, 9, 1440x900 
0x37CA2318, 38092255854630320, 225073653, 225073661, 8, 1440x900 
0x37CA2318, 38092255855485104, 225073738, 225073746, 8, 1440x900 
0x37CA2318, 38092255856146960, 225073808, 225073816, 8, 1440x900 
0x37CA2318, 38092255856816448, 225073868, 225073876, 8, 1440x900 
0x37CA2318, 38092255857486000, 225073937, 225073945, 8, 1440x900 
0x37CA2318, 38092255858133104, 225074003, 225074011, 8, 1440x900 
0x37CA2318, 38092255858812696, 225074067, 225074076, 9, 1440x900 
0x37CA2318, 38092255859464064, 225074135, 225074144, 9, 1440x900 
0x37CA2318, 38092255860124248, 225074203, 225074212, 9, 1440x900 
0x37CA2318, 38092255860785232, 225074267, 225074275, 8, 1440x900 
0x37CA2318, 38092255861446368, 225074333, 225074341, 8, 1440x900 
0x37CA2318, 38092255862108680, 225074403, 225074412, 9, 1440x900 
0x37CA2318, 38092255862769008, 225074468, 225074477, 9, 1440x900 
0x37CA2318, 38092255863323800, 225074517, 225074527, 10, 1440x900 
0x37CA2318, 38092255864024680, 225074587, 225074595, 8, 1440x900 
0x37CA2318, 38092255864562848, 225074643, 225074650, 7, 1440x900 
0x37CA2318, 38092255865222456, 225074708, 225074716, 8, 1440x900 
0x37CA2318, 38092255865882824, 225074773, 225074781, 8, 1440x900 
0x37CA2318, 38092255866542288, 225074842, 225074850, 8, 1440x900 
0x37CA2318, 38092255867864808, 225074973, 225074980, 7, 1440x900 
0x37CA2318, 38092255868523312, 225075037, 225075045, 8, 1440x900 
0x37CA2318, 38092255869183920, 225075102, 225075110, 8, 1440x900 
0x37CA2318, 38092255869831128, 225075168, 225075175, 7, 1440x900 
0x37CA2318, 38092255870682856, 225075253, 225075270, 17, 1440x900 
0x37CA2318, 38092255871180816, 225075303, 225075311, 8, 1440x900 
0x37CA2318, 38092255871919456, 225075378, 225075385, 7, 1440x900 
0x37CA2318, 38092255872475368, 225075433, 225075440, 7, 1440x900 
0x37CA2318, 38092255873136520, 225075498, 225075506, 8, 1440x900 
0x37CA2318, 38092255873797056, 225075567, 225075574, 7, 1440x900 
0x37CA2318, 38092255874454840, 225075631, 225075638, 7, 1440x900 
0x37CA2318, 38092255875115688, 225075698, 225075706, 8, 1440x900 
0x37CA2318, 38092255875779312, 225075768, 225075776, 8, 1440x900 
0x37CA2318, 38092255876444576, 225075837, 225075846, 9, 1440x900 
0x37CA2318, 38092255877103848, 225075898, 225075905, 7, 1440x900 
0x37CA2318, 38092255877762888, 225075963, 225075970, 7, 1440x900 
0x37CA2318, 38092255878420752, 225076028, 225076036, 8, 1440x900 
0x37CA2318, 38092255879083936, 225076097, 225076105, 8, 1440x900 
0x37CA2318, 38092255879740880, 225076161, 225076169, 8, 1440x900 
0x37CA2318, 38092255880610000, 225076253, 225076262, 9, 1440x900 
0x37CA2318, 38092255881063688, 225076292, 225076301, 9, 1440x900 
0x37CA2318, 38092255881723728, 225076357, 225076366, 9, 1440x900 
0x37CA2318, 38092255882586776, 225076448, 225076456, 8, 1440x900 
0x37CA2318, 38092255883248848, 225076517, 225076525, 8, 1440x900 
0x37CA2318, 38092255883704192, 225076557, 225076565, 8, 1440x900 
0x37CA2318, 38092255884375040, 225076626, 225076634, 8, 1440x900 
0x37CA2318, 38092255885230336, 225076711, 225076719, 8, 1440x900 
0x37CA2318, 38092255885891000, 225076777, 225076785, 8, 1440x900 
0x37CA2318, 38092255886543120, 225076843, 225076850, 7, 1440x900 
0x37CA2318, 38092255887213976, 225076913, 225076922, 9, 1440x900 
0x37CA2318, 38092255887884584, 225076977, 225076985, 8, 1440x900 
0x37CA2318, 38092255888534696, 225077043, 225077051, 8, 1440x900 
0x37CA2318, 38092255889195320, 225077107, 225077114, 7, 1440x900 
0x37CA2318, 38092255889855976, 225077177, 225077185, 8, 1440x900 
0x37CA2318, 38092255890515224, 225077243, 225077251, 8, 1440x900 
0x37CA2318, 38092255890981488, 225077288, 225077296, 8, 1440x900 
0x37CA2318, 38092255891646864, 225077354, 225077363, 9, 1440x900 
0x37CA2318, 38092255892301344, 225077424, 225077433, 9, 1440x900 
0x37CA2318, 38092255892960560, 225077483, 225077491, 8, 1440x900 
0x37CA2318, 38092255893619624, 225077548, 225077556, 8, 1440x900 
0x37CA2318, 38092255894279408, 225077613, 225077622, 9, 1440x900 
0x37CA2318, 38092255894939440, 225077682, 225077690, 8, 1440x900 
0x37CA2318, 38092255895600480, 225077747, 225077754, 7, 1440x900 
0x37CA2318, 38092255896459920, 225077838, 225077847, 9, 1440x900 
0x37CA2318, 38092255896926384, 225077883, 225077891, 8, 1440x900 
0x37CA2318, 38092255897585792, 225077948, 225077956, 8, 1440x900 
0x37CA2318, 38092255898247968, 225078018, 225078026, 8, 1440x900 
0x37CA2318, 38092255899113552, 225078101, 225078110, 9, 1440x900 
0x37CA2318, 38092255899756896, 225078164, 225078172, 8, 1440x900 
0x37CA2318, 38092255900230608, 225078213, 225078222, 9, 1440x900 
0x37CA2318, 38092255900890280, 225078278, 225078286, 8, 1440x900 
0x37CA2318, 38092255901549776, 225078342, 225078350, 8, 1440x900 
0x37CA2318, 38092255902212160, 225078407, 225078414, 7, 1440x900 
0x37CA2318, 38092255902867640, 225078472, 225078480, 8, 1440x900 
0x37CA2318, 38092255903527040, 225078537, 225078545, 8, 1440x900 
0x37CA2318, 38092255904196944, 225078607, 225078615, 8, 1440x900 
0x37CA2318, 38092255904856232, 225078673, 225078679, 6, 1440x900 
0x37CA2318, 38092255905522384, 225078742, 225078750, 8, 1440x900 
0x37CA2318, 38092255906180920, 225078807, 225078815, 8, 1440x900 
0x37CA2318, 38092255906842912, 225078873, 225078882, 9, 1440x900 
0x37CA2318, 38092255907516392, 225078944, 225078952, 8, 1440x900 
0x37CA2318, 38092255908367976, 225079028, 225079036, 8, 1440x900 
0x37CA2318, 38092255909028024, 225079095, 225079103, 8, 1440x900 
0x37CA2318, 38092255909682576, 225079158, 225079169, 11, 1440x900 
0x37CA2318, 38092255910167744, 225079203, 225079210, 7, 1440x900 
0x37CA2318, 38092255910906816, 225079277, 225079284, 7, 1440x900 
0x37CA2318, 38092255911476960, 225079333, 225079341, 8, 1440x900 
0x37CA2318, 38092255912121016, 225079397, 225079405, 8, 1440x900 
0x37CA2318, 38092255912789488, 225079467, 225079475, 8, 1440x900 
0x37CA2318, 38092255913452792, 225079532, 225079548, 16, 1440x900 
0x37CA2318, 38092255914145864, 225079603, 225079612, 9, 1440x900 
0x37CA2318, 38092255914779440, 225079668, 225079676, 8, 1440x900 
0x37CA2318, 38092255915439400, 225079731, 225079740, 9, 1440x900 
0x37CA2318, 38092255916100104, 225079794, 225079806, 12, 1440x900 
0x37CA2318, 38092255916760880, 225079864, 225079873, 9, 1440x900 
0x37CA2318, 38092255917420360, 225079928, 225079936, 8, 1440x900 
0x37CA2318, 38092255918069536, 225079992, 225080000, 8, 1440x900 
0x37CA2318, 38092255918727952, 225080058, 225080066, 8, 1440x900 
0x37CA2318, 38092255919388704, 225080123, 225080131, 8, 1440x900 
0x37CA2318, 38092255920198256, 225080207, 225080214, 7, 1440x900 
0x37CA2318, 38092255920724392, 225080258, 225080266, 8, 1440x900 
0x37CA2318, 38092255921575984, 225080347, 225080355, 8, 1440x900 
0x37CA2318, 38092255922236824, 225080413, 225080421, 8, 1440x900 
0x37CA2318, 38092255922898984, 225080479, 225080487, 8, 1440x900 
0x37CA2318, 38092255923552672, 225080543, 225080551, 8, 1440x900 
0x37CA2318, 38092255924255744, 225080612, 225080619, 7, 1440x900 
0x37CA2318, 38092255924683648, 225080652, 225080660, 8, 1440x900 
0x37CA2318, 38092255926007712, 225080787, 225080795, 8, 1440x900 
0x37CA2318, 38092255926664648, 225080852, 225080860, 8, 1440x900 
0x37CA2318, 38092255927543568, 225080944, 225080955, 11, 1440x900 
0x37CA2318, 38092255928008592, 225080988, 225080997, 9, 1440x900 
0x37CA2318, 38092255928739624, 225081061, 225081072, 11, 1440x900 
0x37CA2318, 38092255929390544, 225081125, 225081135, 10, 1440x900 
0x37CA2318, 38092255930015432, 225081187, 225081194, 7, 1440x900 
0x37CA2318, 38092255930730496, 225081258, 225081272, 14, 1440x900 
0x37CA2318, 38092255931364976, 225081323, 225081331, 8, 1440x900 
0x37CA2318, 38092255932009088, 225081387, 225081395, 8, 1440x900 
0x37CA2318, 38092255932696896, 225081456, 225081463, 7, 1440x900 
0x37CA2318, 38092255933326952, 225081517, 225081525, 8, 1440x900 
0x37CA2318, 38092255933986552, 225081583, 225081592, 9, 1440x900 
0x37CA2318, 38092255934647792, 225081649, 225081658, 9, 1440x900 
0x37CA2318, 38092255935310432, 225081718, 225081726, 8, 1440x900 
0x37CA2318, 38092255936007640, 225081787, 225081794, 7, 1440x900 
0x37CA2318, 38092255936628944, 225081847, 225081857, 10, 1440x900 
0x37CA2318, 38092255937288928, 225081917, 225081924, 7, 1440x900 
0x37CA2318, 38092255937948240, 225081978, 225081987, 9, 1440x900 
0x37CA2318, 38092255938608296, 225082047, 225082055, 8, 1440x900 
0x37CA2318, 38092255939268256, 225082113, 225082121, 8, 1440x900 
0x37CA2318, 38092255939928592, 225082177, 225082187, 10, 1440x900 
0x37CA2318, 38092255940593472, 225082265, 225082283, 18, 1440x900 
0x37CA2318, 38092255941249616, 225082311, 225082318, 7, 1440x900 
0x37CA2318, 38092255942060952, 225082394, 225082405, 11, 1440x900 
0x37CA2318, 38092255942651776, 225082449, 225082461, 12, 1440x900 
0x37CA2318, 38092255943338880, 225082519, 225082527, 8, 1440x900 
0x37CA2318, 38092255943990656, 225082583, 225082593, 10, 1440x900 
0x37CA2318, 38092255944689664, 225082660, 225082684, 24, 1440x900 
0x37CA2318, 38092255945334680, 225082718, 225082728, 10, 1440x900 
0x37CA2318, 38092255946024552, 225082801, 225082832, 31, 1440x900 
0x37CA2318, 38092255946587320, 225082848, 225082855, 7, 1440x900 
0x37CA2318, 38092255947318600, 225082922, 225082936, 14, 1440x900 
0x37CA2318, 38092255947974200, 225082982, 225083014, 32, 1440x900 
0x37CA2318, 38092255948665112, 225083061, 225083083, 22, 1440x900 
0x37CA2318, 38092255949289048, 225083115, 225083135, 20, 1440x900 
0x37CA2318, 38092255949929872, 225083194, 225083218, 24, 1440x900 
0x37CA2318, 38092255950609696, 225083256, 225083283, 27, 1440x900 
0x37CA2318, 38092255951239184, 225083316, 225083335, 19, 1440x900 
0x37CA2318, 38092255951914728, 225083382, 225083402, 20, 1440x900 
0x37CA2318, 38092255952527312, 225083441, 225083457, 16, 1440x900 
0x37CA2318, 38092255953174496, 225083503, 225083511, 8, 1440x900 
0x37CA2318, 38092255953841568, 225083572, 225083579, 7, 1440x900 
0x37CA2318, 38092255954490936, 225083633, 225083643, 10, 1440x900 
0x37CA2318, 38092255955131448, 225083702, 225083719, 17, 1440x900 
0x37CA2318, 38092255955808680, 225083767, 225083774, 7, 1440x900 
0x37CA2318, 38092255956651536, 225083852, 225083859, 7, 1440x900 
0x37CA2318, 38092255957302992, 225083917, 225083924, 7, 1440x900 
0x37CA2318, 38092255957962416, 225083983, 225083991, 8, 1440x900 
0x37CA2318, 38092255958430816, 225084033, 225084041, 8, 1440x900 
0x37CA2318, 38092255959276464, 225084113, 225084121, 8, 1440x900 
0x37CA2318, 38092255959937568, 225084182, 225084190, 8, 1440x900 
0x37CA2318, 38092255960562104, 225084240, 225084248, 8, 1440x900 
0x37CA2318, 38092255961268048, 225084313, 225084320, 7, 1440x900 
0x37CA2318, 38092255961936032, 225084382, 225084390, 8, 1440x900 
0x37CA2318, 38092255962422504, 225084432, 225084442, 10, 1440x900 
0x37CA2318, 38092255963061616, 225084492, 225084500, 8, 1440x900 
0x37CA2318, 38092255963906704, 225084578, 225084586, 8, 1440x900 
0x37CA2318, 38092255964575408, 225084643, 225084651, 8, 1440x900 
0x37CA2318, 38092255965229480, 225084708, 225084716, 8, 1440x900 
0x37CA2318, 38092255965899032, 225084776, 225084783, 7, 1440x900 
0x37CA2318, 38092255966544984, 225084843, 225084851, 8, 1440x900 
0x37CA2318, 38092255967215712, 225084908, 225084915, 7, 1440x900 
0x37CA2318, 38092255968062680, 225084998, 225085007, 9, 1440x900 
0x37CA2318, 38092255968362208, 225085022, 225085030, 8, 1440x900 
0x37CA2318, 38092255969206584, 225085107, 225085115, 8, 1440x900 
0x37CA2318, 38092255969876216, 225085178, 225085186, 8, 1440x900 
0x37CA2318, 38092255970536088, 225085239, 225085248, 9, 1440x900 
0x37CA2318, 38092255971222544, 225085307, 225085315, 8, 1440x900 
0x37CA2318, 38092255971861744, 225085372, 225085379, 7, 1440x900 
0x37CA2318, 38092255972527568, 225085438, 225085446, 8, 1440x900 
0x37CA2318, 38092255973184768, 225085503, 225085511, 8, 1440x900 
0x37CA2318, 38092255973850784, 225085572, 225085579, 7, 1440x900 
0x37CA2318, 38092255974402856, 225085627, 225085655, 28, 1440x900 
0x37CA2318, 38092255975021720, 225085693, 225085704, 11, 1440x900 
0x37CA2318, 38092255975633208, 225085748, 225085756, 8, 1440x900 
0x37CA2318, 38092255976291336, 225085817, 225085824, 7, 1440x900 
0x37CA2318, 38092255976949352, 225085879, 225085887, 8, 1440x900 
0x37CA2318, 38092255977816568, 225085970, 225085978, 8, 1440x900 
0x37CA2318, 38092255978271152, 225086012, 225086019, 7, 1440x900 
0x37CA2318, 38092255978931632, 225086078, 225086086, 8, 1440x900 
0x37CA2318, 38092255979591840, 225086143, 225086151, 8, 1440x900 
0x37CA2318, 38092255980250272, 225086212, 225086219, 7, 1440x900 
0x37CA2318, 38092255980910816, 225086277, 225086284, 7, 1440x900 
0x37CA2318, 38092255981578224, 225086343, 225086350, 7, 1440x900 
0x37CA2318, 38092255982237776, 225086407, 225086415, 8, 1440x900 
0x37CA2318, 38092255982898352, 225086477, 225086484, 7, 1440x900 
0x37CA2318, 38092255983561160, 225086542, 225086549, 7, 1440x900 
0x37CA2318, 38092255984226648, 225086608, 225086615, 7, 1440x900 
0x37CA2318, 38092255984882056, 225086673, 225086681, 8, 1440x900 
0x37CA2318, 38092255986201648, 225086808, 225086815, 7, 1440x900 
0x37CA2318, 38092255986864760, 225086873, 225086882, 9, 1440x900 
0x37CA2318, 38092255987522216, 225086937, 225086945, 8, 1440x900 
0x37CA2318, 38092255988180704, 225087003, 225087011, 8, 1440x900 
0x37CA2318, 38092255988840328, 225087068, 225087076, 8, 1440x900 
0x37CA2318, 38092255989502624, 225087137, 225087145, 8, 1440x900 
0x37CA2318, 38092255990162088, 225087203, 225087211, 8, 1440x900 
0x37CA2318, 38092255990819896, 225087269, 225087279, 10, 1440x900 
0x37CA2318, 38092255991512392, 225087340, 225087348, 8, 1440x900 
0x37CA2318, 38092255992143112, 225087404, 225087411, 7, 1440x900 
0x37CA2318, 38092255992808920, 225087467, 225087474, 7, 1440x900 
0x37CA2318, 38092255993477560, 225087539, 225087548, 9, 1440x900 
0x37CA2318, 38092255994283448, 225087618, 225087641, 23, 1440x900 
0x37CA2318, 38092255994868496, 225087672, 225087690, 18, 1440x900 
0x37CA2318, 38092255995485168, 225087737, 225087745, 8, 1440x900 
0x37CA2318, 38092255996113712, 225087797, 225087804, 7, 1440x900 
0x37CA2318, 38092255996777152, 225087862, 225087870, 8, 1440x900 
0x37CA2318, 38092255997437920, 225087932, 225087939, 7, 1440x900 
0x37CA2318, 38092255998123008, 225087997, 225088006, 9, 1440x900 
0x37CA2318, 38092255998755592, 225088061, 225088070, 9, 1440x900 
0x37CA2318, 38092255999611648, 225088147, 225088154, 7, 1440x900 
0x37CA2318, 38092256000268560, 225088218, 225088226, 8, 1440x900 
0x37CA2318, 38092256000933904, 225088278, 225088286, 8, 1440x900 
0x37CA2318, 38092256001603768, 225088348, 225088357, 9, 1440x900 
0x37CA2318, 38092256002253416, 225088412, 225088419, 7, 1440x900 
0x37CA2318, 38092256002912192, 225088482, 225088490, 8, 1440x900 
0x37CA2318, 38092256003574976, 225088549, 225088557, 8, 1440x900 
0x37CA2318, 38092256004235936, 225088613, 225088621, 8, 1440x900 
0x37CA2318, 38092256004905240, 225088678, 225088686, 8, 1440x900 
0x37CA2318, 38092256005565664, 225088747, 225088755, 8, 1440x900 
0x37CA2318, 38092256006217312, 225088813, 225088821, 8, 1440x900 
0x37CA2318, 38092256006885960, 225088880, 225088887, 7, 1440x900 
0x37CA2318, 38092256007536680, 225088942, 225088950, 8, 1440x900 
0x37CA2318, 38092256008198176, 225089007, 225089016, 9, 1440x900 
0x37CA2318, 38092256008777504, 225089067, 225089075, 8, 1440x900 
0x37CA2318, 38092256009397256, 225089126, 225089133, 7, 1440x900 
0x37CA2318, 38092256009994480, 225089188, 225089200, 12, 1440x900 
0x37CA2318, 38092256010674968, 225089253, 225089260, 7, 1440x900 
0x37CA2318, 38092256011321352, 225089318, 225089325, 7, 1440x900 
0x37CA2318, 38092256012014848, 225089387, 225089395, 8, 1440x900 
0x37CA2318, 38092256012640944, 225089449, 225089456, 7, 1440x900 
0x37CA2318, 38092256013300992, 225089518, 225089524, 6, 1440x900 
0x37CA2318, 38092256013993512, 225089588, 225089597, 9, 1440x900 
0x37CA2318, 38092256014622168, 225089653, 225089660, 7, 1440x900 
0x37CA2318, 38092256015282392, 225089717, 225089724, 7, 1440x900 
0x37CA2318, 38092256016138608, 225089802, 225089809, 7, 1440x900 
0x37CA2318, 38092256016809248, 225089868, 225089875, 7, 1440x900 
0x37CA2318, 38092256017459088, 225089932, 225089939, 7, 1440x900 
0x37CA2318, 38092256018011240, 225089988, 225089999, 11, 1440x900 
0x37CA2318, 38092256018604936, 225090047, 225090054, 7, 1440x900 
0x37CA2318, 38092256019253552, 225090112, 225090119, 7, 1440x900 
0x37CA2318, 38092256019924912, 225090182, 225090191, 9, 1440x900 
0x37CA2318, 38092256020578064, 225090243, 225090251, 8, 1440x900 
0x37CA2318, 38092256021233112, 225090308, 225090316, 8, 1440x900 
0x37CA2318, 38092256021894920, 225090377, 225090384, 7, 1440x900 
0x37CA2318, 38092256022555024, 225090442, 225090450, 8, 1440x900 
0x37CA2318, 38092256023212808, 225090507, 225090514, 7, 1440x900 
0x37CA2318, 38092256024064416, 225090598, 225090605, 7, 1440x900 
0x37CA2318, 38092256024683168, 225090658, 225090666, 8, 1440x900 
0x37CA2318, 38092256025394584, 225090729, 225090737, 8, 1440x900 
0x37CA2318, 38092256025895872, 225090774, 225090782, 8, 1440x900 
0x37CA2318, 38092256026714856, 225090858, 225090866, 8, 1440x900 
0x37CA2318, 38092256027377536, 225090927, 225090935, 8, 1440x900 
0x37CA2318, 38092256027850296, 225090973, 225090981, 8, 1440x900 
0x37CA2318, 38092256028705408, 225091058, 225091066, 8, 1440x900 
0x37CA2318, 38092256029366872, 225091127, 225091135, 8, 1440x900 
0x37CA2318, 38092256030029552, 225091193, 225091201, 8, 1440x900 
0x37CA2318, 38092256030692512, 225091258, 225091267, 9, 1440x900 
0x37CA2318, 38092256031361472, 225091324, 225091332, 8, 1440x900 
0x37CA2318, 38092256031825576, 225091372, 225091381, 9, 1440x900 
0x37CA2318, 38092256032672040, 225091453, 225091460, 7, 1440x900 
0x37CA2318, 38092256033333624, 225091519, 225091526, 7, 1440x900 
0x37CA2318, 38092256033991480, 225091586, 225091593, 7, 1440x900 
0x37CA2318, 38092256034468608, 225091632, 225091639, 7, 1440x900 
0x37CA2318, 38092256035325544, 225091724, 225091732, 8, 1440x900 
0x37CA2318, 38092256035987320, 225091788, 225091796, 8, 1440x900 
0x37CA2318, 38092256036656544, 225091852, 225091860, 8, 1440x900 
0x37CA2318, 38092256037114640, 225091897, 225091905, 8, 1440x900 
0x37CA2318, 38092256037974944, 225091982, 225091990, 8, 1440x900 
0x37CA2318, 38092256038644640, 225092052, 225092059, 7, 1440x900 
0x37CA2318, 38092256039296608, 225092116, 225092123, 7, 1440x900 
0x37CA2318, 38092256039955728, 225092187, 225092194, 7, 1440x900 
0x37CA2318, 38092256040612552, 225092247, 225092255, 8, 1440x900 
0x37CA2318, 38092256041275160, 225092314, 225092322, 8, 1440x900 
0x37CA2318, 38092256041945480, 225092384, 225092392, 8, 1440x900 
0x37CA2318, 38092256042597224, 225092448, 225092456, 8, 1440x900 
0x37CA2318, 38092256043257656, 225092512, 225092519, 7, 1440x900 
0x37CA2318, 38092256043917656, 225092578, 225092585, 7, 1440x900 
0x37CA2318, 38092256044586176, 225092646, 225092653, 7, 1440x900 
0x37CA2318, 38092256045237136, 225092708, 225092716, 8, 1440x900 
0x37CA2318, 38092256045898048, 225092777, 225092783, 6, 1440x900 
0x37CA2318, 38092256046558632, 225092841, 225092849, 8, 1440x900 
0x37CA2318, 38092256047218792, 225092908, 225092915, 7, 1440x900 
0x37CA2318, 38092256047880264, 225092977, 225092985, 8, 1440x900 
0x37CA2318, 38092256048534440, 225093043, 225093051, 8, 1440x900 
0x37CA2318, 38092256049204104, 225093109, 225093116, 7, 1440x900 
0x37CA2318, 38092256049864088, 225093179, 225093187, 8, 1440x900 
0x37CA2318, 38092256050533712, 225093238, 225093248, 10, 1440x900 
0x37CA2318, 38092256050990368, 225093282, 225093290, 8, 1440x900 
0x37CA2318, 38092256051852080, 225093372, 225093379, 7, 1440x900 
0x37CA2318, 38092256052315384, 225093418, 225093428, 10, 1440x900 
0x37CA2318, 38092256052977584, 225093483, 225093491, 8, 1440x900 
0x37CA2318, 38092256053641904, 225093548, 225093557, 9, 1440x900 
0x37CA2318, 38092256054304528, 225093617, 225093624, 7, 1440x900 
0x37CA2318, 38092256054979272, 225093687, 225093695, 8, 1440x900 
0x37CA2318, 38092256055663088, 225093753, 225093762, 9, 1440x900 
0x37CA2318, 38092256056287424, 225093812, 225093819, 7, 1440x900 
0x37CA2318, 38092256057681296, 225093962, 225093973, 11, 1440x900 
0x37CA2318, 38092256058307664, 225094025, 225094037, 12, 1440x900 
0x37CA2318, 38092256059006672, 225094092, 225094115, 23, 1440x900 
0x37CA2318, 38092256059647680, 225094160, 225094172, 12, 1440x900 
0x37CA2318, 38092256060315848, 225094225, 225094248, 23, 1440x900 
0x37CA2318, 38092256060946192, 225094284, 225094290, 6, 1440x900 
0x37CA2318, 38092256061622160, 225094350, 225094365, 15, 1440x900 
0x37CA2318, 38092256062299456, 225094424, 225094431, 7, 1440x900 
0x37CA2318, 38092256062931920, 225094478, 225094497, 19, 1440x900 
0x37CA2318, 38092256063599488, 225094547, 225094553, 6, 1440x900 
0x37CA2318, 38092256064275408, 225094614, 225094622, 8, 1440x900 
0x37CA2318, 38092256064951408, 225094681, 225094699, 18, 1440x900 
0x37CA2318, 38092256065700384, 225094760, 225094767, 7, 1440x900 
0x37CA2318, 38092256066271376, 225094818, 225094842, 24, 1440x900 
0x37CA2318, 38092256068142792, 225095004, 225095026, 22, 1440x900 
0x37CA2318, 38092256068734888, 225095058, 225095073, 15, 1440x900 
0x37CA2318, 38092256069083240, 225095122, 225095138, 16, 1440x900 
0x37CA2318, 38092256069937864, 225095190, 225095210, 20, 1440x900 
0x37CA2318, 38092256070604544, 225095247, 225095268, 21, 1440x900 
0x37CA2318, 38092256070943240, 225095280, 225095288, 8, 1440x900 
0x37CA2318, 38092256071567496, 225095342, 225095349, 7, 1440x900 
0x37CA2318, 38092256072263584, 225095413, 225095420, 7, 1440x900 
0x37CA2318, 38092256072898544, 225095477, 225095485, 8, 1440x900 
0x37CA2318, 38092256073564128, 225095542, 225095552, 10, 1440x900 
0x37CA2318, 38092256074240056, 225095615, 225095633, 18, 1440x900 
0x37CA2318, 38092256074887104, 225095673, 225095682, 9, 1440x900 
0x37CA2318, 38092256075680656, 225095759, 225095769, 10, 1440x900 
0x37CA2318, 38092256076204184, 225095807, 225095814, 7, 1440x900 
0x37CA2318, 38092256076862904, 225095872, 225095880, 8, 1440x900 
0x37CA2318, 38092256077518480, 225095938, 225095944, 6, 1440x900 
0x37CA2318, 38092256078182888, 225096009, 225096019, 10, 1440x900 
0x37CA2318, 38092256079043536, 225096092, 225096100, 8, 1440x900 
0x37CA2318, 38092256079524216, 225096138, 225096146, 8, 1440x900 
0x37CA2318, 38092256080175288, 225096210, 225096253, 43, 1440x900 
0x37CA2318, 38092256080909488, 225096287, 225096302, 15, 1440x900 
0x37CA2318, 38092256081563424, 225096344, 225096356, 12, 1440x900 
0x37CA2318, 38092256084878904, 225096675, 225096688, 13, 1440x900 
0x37CA2318, 38092256088141768, 225097002, 225097010, 8, 1440x900 
0x37CA2318, 38092256088801000, 225097073, 225097082, 9, 1440x900 
0x37CA2318, 38092256089462616, 225097135, 225097144, 9, 1440x900 
0x37CA2318, 38092256090128688, 225097204, 225097213, 9, 1440x900 
0x37CA2318, 38092256090780256, 225097262, 225097271, 9, 1440x900 
0x37CA2318, 38092256091441920, 225097332, 225097341, 9, 1440x900 
0x37CA2318, 38092256092100408, 225097396, 225097404, 8, 1440x900 
0x37CA2318, 38092256092770152, 225097463, 225097472, 9, 1440x900 
0x37CA2318, 38092256093443472, 225097532, 225097541, 9, 1440x900 
0x37CA2318, 38092256094099336, 225097597, 225097606, 9, 1440x900 
0x37CA2318, 38092256094956960, 225097683, 225097692, 9, 1440x900 
0x37CA2318, 38092256095582240, 225097743, 225097755, 12, 1440x900 
0x37CA2318, 38092256096148072, 225097798, 225097812, 14, 1440x900 
0x37CA2318, 38092256096768224, 225097862, 225097870, 8, 1440x900 
0x37CA2318, 38092256097400256, 225097926, 225097934, 8, 1440x900 
0x37CA2318, 38092256098060496, 225097992, 225098000, 8, 1440x900 
0x37CA2318, 38092256098721360, 225098057, 225098066, 9, 1440x900 
0x37CA2318, 38092256099380448, 225098123, 225098132, 9, 1440x900 
0x37CA2318, 38092256100049752, 225098192, 225098200, 8, 1440x900 
0x37CA2318, 38092256100714144, 225098257, 225098265, 8, 1440x900 
0x37CA2318, 38092256101613104, 225098347, 225098356, 9, 1440x900 
0x37CA2318, 38092256102032808, 225098388, 225098397, 9, 1440x900 
0x37CA2318, 38092256102691224, 225098456, 225098464, 8, 1440x900 
0x37CA2318, 38092256103351416, 225098523, 225098531, 8, 1440x900 
0x37CA2318, 38092256104011320, 225098587, 225098596, 9, 1440x900 
0x37CA2318, 38092256104675056, 225098653, 225098662, 9, 1440x900 
0x37CA2318, 38092256105329928, 225098718, 225098727, 9, 1440x900 
0x37CA2318, 38092256106001840, 225098787, 225098796, 9, 1440x900 
0x37CA2318, 38092256106661392, 225098853, 225098861, 8, 1440x900 
0x37CA2318, 38092256107525064, 225098943, 225098952, 9, 1440x900 
0x37CA2318, 38092256107995464, 225098988, 225098998, 10, 1440x900 
0x37CA2318, 38092256108791248, 225099067, 225099075, 8, 1440x900 
0x37CA2318, 38092256109309056, 225099117, 225099125, 8, 1440x900 
0x37CA2318, 38092256110170928, 225099203, 225099210, 7, 1440x900 
0x37CA2318, 38092256110632376, 225099248, 225099257, 9, 1440x900 
0x37CA2318, 38092256111294640, 225099316, 225099324, 8, 1440x900 
0x37CA2318, 38092256111954064, 225099382, 225099391, 9, 1440x900 
0x37CA2318, 38092256112813136, 225099472, 225099481, 9, 1440x900 
0x37CA2318, 38092256113291272, 225099519, 225099528, 9, 1440x900 
0x37CA2318, 38092256114130896, 225099598, 225099614, 16, 1440x900 
0x37CA2318, 38092256114627040, 225099647, 225099655, 8, 1440x900 
0x37CA2318, 38092256115439280, 225099732, 225099740, 8, 1440x900 
0x37CA2318, 38092256115944056, 225099783, 225099791, 8, 1440x900 
0x37CA2318, 38092256116595136, 225099846, 225099855, 9, 1440x900 
0x37CA2318, 38092256117241000, 225099911, 225099919, 8, 1440x900 
0x37CA2318, 38092256118089328, 225099994, 225100005, 11, 1440x900 
0x37CA2318, 38092256118599608, 225100049, 225100058, 9, 1440x900 
0x37CA2318, 38092256119394560, 225100126, 225100135, 9, 1440x900 
0x37CA2318, 38092256120081720, 225100198, 225100207, 9, 1440x900 
0x37CA2318, 38092256120748592, 225100263, 225100272, 9, 1440x900 
0x37CA2318, 38092256121220504, 225100308, 225100317, 9, 1440x900 
0x37CA2318, 38092256122068992, 225100395, 225100404, 9, 1440x900 
0x37CA2318, 38092256122536904, 225100443, 225100451, 8, 1440x900 
0x37CA2318, 38092256123208712, 225100512, 225100521, 9, 1440x900 
0x37CA2318, 38092256123863568, 225100573, 225100582, 9, 1440x900 
0x37CA2318, 38092256124531568, 225100643, 225100652, 9, 1440x900 
0x37CA2318, 38092256125177480, 225100703, 225100713, 10, 1440x900 
0x37CA2318, 38092256126028816, 225100793, 225100801, 8, 1440x900 
0x37CA2318, 38092256126699096, 225100857, 225100865, 8, 1440x900 
0x37CA2318, 38092256127164496, 225100903, 225100912, 9, 1440x900 
0x37CA2318, 38092256127854384, 225100971, 225100980, 9, 1440x900 
0x37CA2318, 38092256128484392, 225101033, 225101042, 9, 1440x900 
0x37CA2318, 38092256129151040, 225101104, 225101113, 9, 1440x900 
0x37CA2318, 38092256129811760, 225101172, 225101181, 9, 1440x900 
0x37CA2318, 38092256130466320, 225101236, 225101244, 8, 1440x900 
0x37CA2318, 38092256131138656, 225101303, 225101313, 10, 1440x900 
0x37CA2318, 38092256131792136, 225101367, 225101376, 9, 1440x900 
0x37CA2318, 38092256132492760, 225101437, 225101445, 8, 1440x900 
0x37CA2318, 38092256133120256, 225101498, 225101506, 8, 1440x900 
0x37CA2318, 38092256133775232, 225101563, 225101572, 9, 1440x900 
0x37CA2318, 38092256134438160, 225101632, 225101641, 9, 1440x900 
0x37CA2318, 38092256135096128, 225101698, 225101707, 9, 1440x900 
0x37CA2318, 38092256135949848, 225101783, 225101792, 9, 1440x900 
0x37CA2318, 38092256136427880, 225101828, 225101836, 8, 1440x900 
0x37CA2318, 38092256137087752, 225101897, 225101905, 8, 1440x900 
0x37CA2318, 38092256137754960, 225101968, 225101977, 9, 1440x900 
0x37CA2318, 38092256138408632, 225102032, 225102041, 9, 1440x900 
0x37CA2318, 38092256139081264, 225102093, 225102101, 8, 1440x900 
0x37CA2318, 38092256139933888, 225102178, 225102186, 8, 1440x900 
0x37CA2318, 38092256140592352, 225102246, 225102254, 8, 1440x900 
0x37CA2318, 38092256141253728, 225102313, 225102320, 7, 1440x900 
0x37CA2318, 38092256141723248, 225102358, 225102367, 9, 1440x900 
0x37CA2318, 38092256142383480, 225102427, 225102435, 8, 1440x900 
0x37CA2318, 38092256143052544, 225102490, 225102499, 9, 1440x900 
0x37CA2318, 38092256143718064, 225102557, 225102565, 8, 1440x900 
0x37CA2318, 38092256144365536, 225102622, 225102630, 8, 1440x900 
0x37CA2318, 38092256145026320, 225102687, 225102695, 8, 1440x900 
0x37CA2318, 38092256145690304, 225102758, 225102767, 9, 1440x900 
0x37CA2318, 38092256146351272, 225102823, 225102830, 7, 1440x900 
0x37CA2318, 38092256147018256, 225102893, 225102902, 9, 1440x900 
0x37CA2318, 38092256147671856, 225102953, 225102962, 9, 1440x900 
0x37CA2318, 38092256148341232, 225103021, 225103030, 9, 1440x900 
0x37CA2318, 38092256149005808, 225103088, 225103096, 8, 1440x900 
0x37CA2318, 38092256149664856, 225103156, 225103165, 9, 1440x900 
0x37CA2318, 38092256150328888, 225103218, 225103227, 9, 1440x900 
0x37CA2318, 38092256150988184, 225103287, 225103296, 9, 1440x900 
0x37CA2318, 38092256151650384, 225103357, 225103365, 8, 1440x900 
0x37CA2318, 38092256152316064, 225103424, 225103433, 9, 1440x900 
0x37CA2318, 38092256152972392, 225103483, 225103492, 9, 1440x900 
0x37CA2318, 38092256153638216, 225103553, 225103561, 8, 1440x900 
0x37CA2318, 38092256154389576, 225103627, 225103635, 8, 1440x900 
0x37CA2318, 38092256155611496, 225103747, 225103755, 8, 1440x900 
0x37CA2318, 38092256156278568, 225103813, 225103822, 9, 1440x900 
0x37CA2318, 38092256156935184, 225103883, 225103891, 8, 1440x900 
0x37CA2318, 38092256157597520, 225103947, 225103955, 8, 1440x900 
0x37CA2318, 38092256158258304, 225104011, 225104018, 7, 1440x900 
0x37CA2318, 38092256158933392, 225104083, 225104092, 9, 1440x900 
0x37CA2318, 38092256159583728, 225104147, 225104155, 8, 1440x900 
0x37CA2318, 38092256160242528, 225104211, 225104219, 8, 1440x900 
0x37CA2318, 38092256160904160, 225104278, 225104286, 8, 1440x900 
0x37CA2318, 38092256161567704, 225104343, 225104351, 8, 1440x900 
0x37CA2318, 38092256162228824, 225104413, 225104422, 9, 1440x900 
0x37CA2318, 38092256162888344, 225104475, 225104483, 8, 1440x900 
0x37CA2318, 38092256163575752, 225104543, 225104551, 8, 1440x900 
0x37CA2318, 38092256164202536, 225104608, 225104615, 7, 1440x900 
0x37CA2318, 38092256164946264, 225104684, 225104696, 12, 1440x900 
0x37CA2318, 38092256165567120, 225104742, 225104754, 12, 1440x900 
0x37CA2318, 38092256166217632, 225104810, 225104818, 8, 1440x900 
0x37CA2318, 38092256166843816, 225104872, 225104890, 18, 1440x900 
0x37CA2318, 38092256167550248, 225104943, 225104950, 7, 1440x900 
0x37CA2318, 38092256168176384, 225105003, 225105012, 9, 1440x900 
0x37CA2318, 38092256168844016, 225105072, 225105080, 8, 1440x900 
0x37CA2318, 38092256169699240, 225105157, 225105166, 9, 1440x900 
0x37CA2318, 38092256170350416, 225105223, 225105231, 8, 1440x900 
0x37CA2318, 38092256171023704, 225105288, 225105309, 21, 1440x900 
0x37CA2318, 38092256171579040, 225105343, 225105351, 8, 1440x900 
0x37CA2318, 38092256172174864, 225105403, 225105414, 11, 1440x900 
0x37CA2318, 38092256172837144, 225105472, 225105485, 13, 1440x900 
0x37CA2318, 38092256173462616, 225105532, 225105540, 8, 1440x900 
0x37CA2318, 38092256174124672, 225105597, 225105605, 8, 1440x900 
0x37CA2318, 38092256175422792, 225105738, 225105751, 13, 1440x900 
0x37CA2318, 38092256175615520, 225105779, 225105788, 9, 1440x900 
0x37CA2318, 38092256176178336, 225105804, 225105811, 7, 1440x900 
0x37CA2318, 38092256176770720, 225105873, 225105892, 19, 1440x900 
0x37CA2318, 38092256177461272, 225105932, 225105939, 7, 1440x900 
0x37CA2318, 38092256178777072, 225106062, 225106070, 8, 1440x900 
0x37CA2318, 38092256179404848, 225106126, 225106134, 8, 1440x900 
0x37CA2318, 38092256180076760, 225106193, 225106202, 9, 1440x900 
0x37CA2318, 38092256180740616, 225106264, 225106271, 7, 1440x900 
0x37CA2318, 38092256181401328, 225106326, 225106333, 7, 1440x900 
0x37CA2318, 38092256182098920, 225106397, 225106404, 7, 1440x900 
0x37CA2318, 38092256182715576, 225106457, 225106464, 7, 1440x900 
0x37CA2318, 38092256183376256, 225106523, 225106531, 8, 1440x900 
0x37CA2318, 38092256184035752, 225106588, 225106596, 8, 1440x900 
0x37CA2318, 38092256184888296, 225106677, 225106684, 7, 1440x900 
0x37CA2318, 38092256185358456, 225106722, 225106731, 9, 1440x900 
0x37CA2318, 38092256186151808, 225106802, 225106809, 7, 1440x900 
0x37CA2318, 38092256186887928, 225106873, 225106882, 9, 1440x900 
0x37CA2318, 38092256187548320, 225106941, 225106949, 8, 1440x900 
0x37CA2318, 38092256188200144, 225107007, 225107014, 7, 1440x900 
0x37CA2318, 38092256188863944, 225107074, 225107081, 7, 1440x900 
0x37CA2318, 38092256189533232, 225107138, 225107153, 15, 1440x900 
0x37CA2318, 38092256190010360, 225107186, 225107194, 8, 1440x900 
0x37CA2318, 38092256190854224, 225107272, 225107281, 9, 1440x900 
0x37CA2318, 38092256191492112, 225107337, 225107345, 8, 1440x900 
0x37CA2318, 38092256192175016, 225107404, 225107412, 8, 1440x900 
0x37CA2318, 38092256192829872, 225107468, 225107476, 8, 1440x900 
0x37CA2318, 38092256193496184, 225107537, 225107545, 8, 1440x900 
0x37CA2318, 38092256194161000, 225107602, 225107610, 8, 1440x900 
0x37CA2318, 38092256194819808, 225107668, 225107675, 7, 1440x900 
0x37CA2318, 38092256195474216, 225107733, 225107740, 7, 1440x900 
0x37CA2318, 38092256196174624, 225107808, 225107816, 8, 1440x900 
0x37CA2318, 38092256196798888, 225107867, 225107875, 8, 1440x900 
0x37CA2318, 38092256197471832, 225107933, 225107941, 8, 1440x900 
0x37CA2318, 38092256198122136, 225107998, 225108006, 8, 1440x900 
0x37CA2318, 38092256198790632, 225108068, 225108076, 8, 1440x900 
0x37CA2318, 38092256199460592, 225108132, 225108140, 8, 1440x900 
0x37CA2318, 38092256200111976, 225108202, 225108210, 8, 1440x900 
0x37CA2318, 38092256200775944, 225108269, 225108277, 8, 1440x900 
0x37CA2318, 38092256201435112, 225108334, 225108343, 9, 1440x900 
0x37CA2318, 38092256201910776, 225108377, 225108385, 8, 1440x900 
0x37CA2318, 38092256202752736, 225108462, 225108470, 8, 1440x900 
0x37CA2318, 38092256203419872, 225108528, 225108535, 7, 1440x900 
0x37CA2318, 38092256203890480, 225108578, 225108585, 7, 1440x900 
0x37CA2318, 38092256204730824, 225108663, 225108671, 8, 1440x900 
0x37CA2318, 38092256205400416, 225108732, 225108740, 8, 1440x900 
0x37CA2318, 38092256206068560, 225108794, 225108803, 9, 1440x900 
0x37CA2318, 38092256206728976, 225108862, 225108870, 8, 1440x900 
0x37CA2318, 38092256207391488, 225108928, 225108936, 8, 1440x900 
0x37CA2318, 38092256208046320, 225108993, 225109002, 9, 1440x900 
0x37CA2318, 38092256208711288, 225109057, 225109066, 9, 1440x900 
0x37CA2318, 38092256209194896, 225109108, 225109117, 9, 1440x900 
0x37CA2318, 38092256210028160, 225109193, 225109202, 9, 1440x900 
0x37CA2318, 38092256210706704, 225109257, 225109265, 8, 1440x900 
0x37CA2318, 38092256211341576, 225109318, 225109326, 8, 1440x900 
0x37CA2318, 38092256212006336, 225109387, 225109394, 7, 1440x900 
0x37CA2318, 38092256212686560, 225109453, 225109462, 9, 1440x900 
0x37CA2318, 38092256213346240, 225109523, 225109530, 7, 1440x900 
0x37CA2318, 38092256213827736, 225109568, 225109576, 8, 1440x900 
0x37CA2318, 38092256214673280, 225109652, 225109660, 8, 1440x900 
0x37CA2318, 38092256215338984, 225109723, 225109730, 7, 1440x900 
0x37CA2318, 38092256215990448, 225109788, 225109796, 8, 1440x900 
0x37CA2318, 38092256216531392, 225109842, 225109850, 8, 1440x900 
0x37CA2318, 38092256217316328, 225109918, 225109927, 9, 1440x900 
0x37CA2318, 38092256217979128, 225109988, 225109996, 8, 1440x900 
0x37CA2318, 38092256218638328, 225110053, 225110061, 8, 1440x900 
0x37CA2318, 38092256219298488, 225110122, 225110130, 8, 1440x900 
0x37CA2318, 38092256219960504, 225110187, 225110195, 8, 1440x900 
0x37CA2318, 38092256220620600, 225110253, 225110261, 8, 1440x900 
0x37CA2318, 38092256221088464, 225110293, 225110302, 9, 1440x900 
0x37CA2318, 38092256221938472, 225110378, 225110387, 9, 1440x900 
0x37CA2318, 38092256222610048, 225110448, 225110457, 9, 1440x900 
0x37CA2318, 38092256223077392, 225110493, 225110501, 8, 1440x900 
0x37CA2318, 38092256223914048, 225110584, 225110592, 8, 1440x900 
0x37CA2318, 38092256224575320, 225110649, 225110657, 8, 1440x900 
0x37CA2318, 38092256225058880, 225110692, 225110699, 7, 1440x900 
0x37CA2318, 38092256225725344, 225110764, 225110772, 8, 1440x900 
0x37CA2318, 38092256226566248, 225110848, 225110857, 9, 1440x900 
0x37CA2318, 38092256227041656, 225110892, 225110899, 7, 1440x900 
0x37CA2318, 38092256227887640, 225110977, 225110985, 8, 1440x900 
0x37CA2318, 38092256228542128, 225111042, 225111050, 8, 1440x900 
0x37CA2318, 38092256229286704, 225111113, 225111122, 9, 1440x900 
0x37CA2318, 38092256229815776, 225111168, 225111176, 8, 1440x900 
0x37CA2318, 38092256230340872, 225111221, 225111228, 7, 1440x900 
0x37CA2318, 38092256231001848, 225111287, 225111295, 8, 1440x900 
0x37CA2318, 38092256231667080, 225111353, 225111361, 8, 1440x900 
0x37CA2318, 38092256232344976, 225111421, 225111428, 7, 1440x900 
0x37CA2318, 38092256232994936, 225111488, 225111496, 8, 1440x900 
0x37CA2318, 38092256233655480, 225111552, 225111559, 7, 1440x900 
0x37CA2318, 38092256234318496, 225111618, 225111626, 8, 1440x900 
0x37CA2318, 38092256234987208, 225111688, 225111695, 7, 1440x900 
0x37CA2318, 38092256235643688, 225111753, 225111760, 7, 1440x900 
0x37CA2318, 38092256236303952, 225111819, 225111826, 7, 1440x900 
0x37CA2318, 38092256236967904, 225111882, 225111891, 9, 1440x900 
0x37CA2318, 38092256237640496, 225111952, 225111960, 8, 1440x900 
0x37CA2318, 38092256238283392, 225112019, 225112027, 8, 1440x900 
0x37CA2318, 38092256238942312, 225112082, 225112089, 7, 1440x900 
0x37CA2318, 38092256239602464, 225112148, 225112155, 7, 1440x900 
0x37CA2318, 38092256240261888, 225112212, 225112219, 7, 1440x900 
0x37CA2318, 38092256240921384, 225112278, 225112286, 8, 1440x900 
0x37CA2318, 38092256241582192, 225112343, 225112351, 8, 1440x900 
0x37CA2318, 38092256242242048, 225112408, 225112416, 8, 1440x900 
0x37CA2318, 38092256242913520, 225112477, 225112485, 8, 1440x900 
0x37CA2318, 38092256243561632, 225112542, 225112549, 7, 1440x900 
0x37CA2318, 38092256244223144, 225112608, 225112615, 7, 1440x900 
0x37CA2318, 38092256244893776, 225112678, 225112685, 7, 1440x900 
0x37CA2318, 38092256246208632, 225112813, 225112821, 8, 1440x900 
0x37CA2318, 38092256246867856, 225112877, 225112885, 8, 1440x900 
0x37CA2318, 38092256247528216, 225112937, 225112945, 8, 1440x900 
0x37CA2318, 38092256248215544, 225113008, 225113015, 7, 1440x900 
0x37CA2318, 38092256248861952, 225113072, 225113080, 8, 1440x900 
0x37CA2318, 38092256249508920, 225113137, 225113144, 7, 1440x900 
0x37CA2318, 38092256250169696, 225113202, 225113210, 8, 1440x900 
0x37CA2318, 38092256250825856, 225113267, 225113275, 8, 1440x900 
0x37CA2318, 38092256251485144, 225113333, 225113341, 8, 1440x900 
0x37CA2318, 38092256252146376, 225113398, 225113406, 8, 1440x900 
0x37CA2318, 38092256252806032, 225113467, 225113474, 7, 1440x900 
0x37CA2318, 38092256253481792, 225113534, 225113542, 8, 1440x900 
0x37CA2318, 38092256254126192, 225113598, 225113605, 7, 1440x900 
0x37CA2318, 38092256254786112, 225113663, 225113671, 8, 1440x900 
0x37CA2318, 38092256255446280, 225113728, 225113736, 8, 1440x900 
0x37CA2318, 38092256256106704, 225113797, 225113805, 8, 1440x900 
0x37CA2318, 38092256256766896, 225113863, 225113870, 7, 1440x900 
0x37CA2318, 38092256257427440, 225113927, 225113935, 8, 1440x900 
0x37CA2318, 38092256258087088, 225113992, 225114000, 8, 1440x900 
0x37CA2318, 38092256258756504, 225114062, 225114070, 8, 1440x900 
0x37CA2318, 38092256259406880, 225114128, 225114135, 7, 1440x900 
0x37CA2318, 38092256260067512, 225114192, 225114200, 8, 1440x900 
0x37CA2318, 38092256260875232, 225114274, 225114283, 9, 1440x900 
0x37CA2318, 38092256261607360, 225114353, 225114372, 19, 1440x900 
0x37CA2318, 38092256262337544, 225114418, 225114439, 21, 1440x900 
0x37CA2318, 38092256262949128, 225114483, 225114505, 22, 1440x900 
0x37CA2318, 38092256263658728, 225114558, 225114571, 13, 1440x900 
0x37CA2318, 38092256264210424, 225114609, 225114640, 31, 1440x900 
0x37CA2318, 38092256264884104, 225114673, 225114681, 8, 1440x900 
0x37CA2318, 38092256265524224, 225114739, 225114748, 9, 1440x900 
0x37CA2318, 38092256266184672, 225114809, 225114821, 12, 1440x900 
0x37CA2318, 38092256266842064, 225114868, 225114877, 9, 1440x900 
0x37CA2318, 38092256267502432, 225114937, 225114945, 8, 1440x900 
0x37CA2318, 38092256268162464, 225115003, 225115022, 19, 1440x900 
0x37CA2318, 38092256268827864, 225115067, 225115075, 8, 1440x900 
0x37CA2318, 38092256269482928, 225115133, 225115154, 21, 1440x900 
0x37CA2318, 38092256270176360, 225115202, 225115221, 19, 1440x900 
0x37CA2318, 38092256270803744, 225115267, 225115276, 9, 1440x900 
0x37CA2318, 38092256271462576, 225115332, 225115340, 8, 1440x900 
0x37CA2318, 38092256272124496, 225115398, 225115416, 18, 1440x900 
0x37CA2318, 38092256272838496, 225115471, 225115478, 7, 1440x900 
0x37CA2318, 38092256273500976, 225115537, 225115544, 7, 1440x900 
0x37CA2318, 38092256274166144, 225115605, 225115612, 7, 1440x900 
0x37CA2318, 38092256274846336, 225115672, 225115679, 7, 1440x900 
0x37CA2318, 38092256275513696, 225115737, 225115747, 10, 1440x900 
0x37CA2318, 38092256276113624, 225115797, 225115806, 9, 1440x900 
0x37CA2318, 38092256276857896, 225115874, 225115891, 17, 1440x900 
0x37CA2318, 38092256277527056, 225115938, 225115947, 9, 1440x900 
0x37CA2318, 38092256278170072, 225116002, 225116010, 8, 1440x900 
0x37CA2318, 38092256278833104, 225116068, 225116078, 10, 1440x900 
0x37CA2318, 38092256279504304, 225116137, 225116146, 9, 1440x900 
0x37CA2318, 38092256280074424, 225116195, 225116205, 10, 1440x900 
0x37CA2318, 38092256280765776, 225116268, 225116287, 19, 1440x900 
0x37CA2318, 38092256281429960, 225116332, 225116341, 9, 1440x900 
0x37CA2318, 38092256282094864, 225116402, 225116409, 7, 1440x900 
0x37CA2318, 38092256282741696, 225116464, 225116477, 13, 1440x900 
0x37CA2318, 38092256283385624, 225116529, 225116540, 11, 1440x900 
0x37CA2318, 38092256284049536, 225116592, 225116599, 7, 1440x900 
0x37CA2318, 38092256284707624, 225116658, 225116666, 8, 1440x900 
0x37CA2318, 38092256285373072, 225116722, 225116731, 9, 1440x900 
0x37CA2318, 38092256286162696, 225116804, 225116812, 8, 1440x900 
0x37CA2318, 38092256286783760, 225116868, 225116878, 10, 1440x900 
0x37CA2318, 38092256287459160, 225116938, 225116948, 10, 1440x900 
0x37CA2318, 38092256288076192, 225116993, 225117003, 10, 1440x900 
0x37CA2318, 38092256288695360, 225117053, 225117061, 8, 1440x900 
0x37CA2318, 38092256289355608, 225117122, 225117128, 6, 1440x900 
0x37CA2318, 38092256290015528, 225117187, 225117194, 7, 1440x900 
0x37CA2318, 38092256290675992, 225117254, 225117261, 7, 1440x900 
0x37CA2318, 38092256291336784, 225117317, 225117326, 9, 1440x900 
0x37CA2318, 38092256291996256, 225117383, 225117391, 8, 1440x900 
0x37CA2318, 38092256292666328, 225117457, 225117464, 7, 1440x900 
0x37CA2318, 38092256293326320, 225117518, 225117527, 9, 1440x900 
0x37CA2318, 38092256293985904, 225117589, 225117598, 9, 1440x900 
0x37CA2318, 38092256294645376, 225117652, 225117659, 7, 1440x900 
0x37CA2318, 38092256295306048, 225117717, 225117724, 7, 1440x900 
0x37CA2318, 38092256295966152, 225117782, 225117789, 7, 1440x900 
0x37CA2318, 38092256296635504, 225117848, 225117856, 8, 1440x900 
0x37CA2318, 38092256297295440, 225117916, 225117923, 7, 1440x900 
0x37CA2318, 38092256297958096, 225117982, 225117989, 7, 1440x900 
0x37CA2318, 38092256298618312, 225118047, 225118055, 8, 1440x900 
0x37CA2318, 38092256299283824, 225118118, 225118126, 8, 1440x900 
0x37CA2318, 38092256299954352, 225118183, 225118193, 10, 1440x900 
0x37CA2318, 38092256300596536, 225118247, 225118254, 7, 1440x900 
0x37CA2318, 38092256301258016, 225118311, 225118318, 7, 1440x900 
0x37CA2318, 38092256301926248, 225118382, 225118391, 9, 1440x900 
0x37CA2318, 38092256302607904, 225118452, 225118463, 11, 1440x900 
0x37CA2318, 38092256303244104, 225118511, 225118518, 7, 1440x900 
0x37CA2318, 38092256303905488, 225118577, 225118585, 8, 1440x900 
0x37CA2318, 38092256304568592, 225118642, 225118650, 8, 1440x900 
0x37CA2318, 38092256305229008, 225118712, 225118722, 10, 1440x900 
0x37CA2318, 38092256305885896, 225118773, 225118781, 8, 1440x900 
0x37CA2318, 38092256306548976, 225118843, 225118850, 7, 1440x900 
0x37CA2318, 38092256307211192, 225118912, 225118920, 8, 1440x900 
0x37CA2318, 38092256307869072, 225118973, 225118981, 8, 1440x900 
0x37CA2318, 38092256308530912, 225119038, 225119047, 9, 1440x900 
0x37CA2318, 38092256309190632, 225119107, 225119114, 7, 1440x900 
0x37CA2318, 38092256309850736, 225119172, 225119180, 8, 1440x900 
0x37CA2318, 38092256310516312, 225119238, 225119246, 8, 1440x900 
0x37CA2318, 38092256311179872, 225119308, 225119319, 11, 1440x900 
0x37CA2318, 38092256311829248, 225119369, 225119376, 7, 1440x900 
0x37CA2318, 38092256312499280, 225119434, 225119441, 7, 1440x900 
0x37CA2318, 38092256313159120, 225119502, 225119509, 7, 1440x900 
0x37CA2318, 38092256313819008, 225119569, 225119576, 7, 1440x900 
0x37CA2318, 38092256314479376, 225119633, 225119641, 8, 1440x900 
0x37CA2318, 38092256315139344, 225119698, 225119705, 7, 1440x900 
0x37CA2318, 38092256315799360, 225119767, 225119774, 7, 1440x900 
0x37CA2318, 38092256316459176, 225119833, 225119841, 8, 1440x900 
0x37CA2318, 38092256317127640, 225119898, 225119905, 7, 1440x900 
0x37CA2318, 38092256317778960, 225119962, 225119969, 7, 1440x900 
0x37CA2318, 38092256318440136, 225120031, 225120038, 7, 1440x900 
0x37CA2318, 38092256319099520, 225120093, 225120101, 8, 1440x900 
0x37CA2318, 38092256319761352, 225120162, 225120169, 7, 1440x900 
0x37CA2318, 38092256320419288, 225120227, 225120234, 7, 1440x900 
0x37CA2318, 38092256321089392, 225120293, 225120301, 8, 1440x900 
0x37CA2318, 38092256321747488, 225120358, 225120366, 8, 1440x900 
0x37CA2318, 38092256322410168, 225120428, 225120436, 8, 1440x900 
0x37CA2318, 38092256323067760, 225120492, 225120500, 8, 1440x900 
0x37CA2318, 38092256323730496, 225120558, 225120566, 8, 1440x900 
0x37CA2318, 38092256324397640, 225120628, 225120637, 9, 1440x900 
0x37CA2318, 38092256325054840, 225120694, 225120705, 11, 1440x900 
0x37CA2318, 38092256325710408, 225120758, 225120765, 7, 1440x900 
0x37CA2318, 38092256326371496, 225120824, 225120831, 7, 1440x900 
0x37CA2318, 38092256327031088, 225120888, 225120895, 7, 1440x900 
0x37CA2318, 38092256327692208, 225120953, 225120961, 8, 1440x900 
0x37CA2318, 38092256328351304, 225121022, 225121029, 7, 1440x900 
0x37CA2318, 38092256329011408, 225121087, 225121094, 7, 1440x900 
0x37CA2318, 38092256329671512, 225121153, 225121160, 7, 1440x900 
0x37CA2318, 38092256330344736, 225121223, 225121232, 9, 1440x900 
0x37CA2318, 38092256331005608, 225121293, 225121302, 9, 1440x900 
0x37CA2318, 38092256332329064, 225121418, 225121425, 7, 1440x900 
0x37CA2318, 38092256332989280, 225121483, 225121490, 7, 1440x900 
0x37CA2318, 38092256333651640, 225121552, 225121559, 7, 1440x900 
0x37CA2318, 38092256334312520, 225121617, 225121624, 7, 1440x900 
0x37CA2318, 38092256334972048, 225121682, 225121689, 7, 1440x900 
0x37CA2318, 38092256335638720, 225121750, 225121758, 8, 1440x900 
0x37CA2318, 38092256336315224, 225121817, 225121825, 8, 1440x900 
0x37CA2318, 38092256336961824, 225121881, 225121888, 7, 1440x900 
0x37CA2318, 38092256337624584, 225121947, 225121955, 8, 1440x900 
0x37CA2318, 38092256338285120, 225122016, 225122023, 7, 1440x900 
0x37CA2318, 38092256338944768, 225122083, 225122090, 7, 1440x900 
0x37CA2318, 38092256339605448, 225122151, 225122161, 10, 1440x900 
0x37CA2318, 38092256340268120, 225122213, 225122221, 8, 1440x900 
0x37CA2318, 38092256340929032, 225122278, 225122285, 7, 1440x900 
0x37CA2318, 38092256341589176, 225122343, 225122351, 8, 1440x900 
0x37CA2318, 38092256342250816, 225122413, 225122422, 9, 1440x900 
0x37CA2318, 38092256342910816, 225122477, 225122484, 7, 1440x900 
0x37CA2318, 38092256343572472, 225122543, 225122550, 7, 1440x900 
0x37CA2318, 38092256344232832, 225122608, 225122616, 8, 1440x900 
0x37CA2318, 38092256344895928, 225122677, 225122684, 7, 1440x900 
0x37CA2318, 38092256345555120, 225122742, 225122749, 7, 1440x900 
0x37CA2318, 38092256346216128, 225122807, 225122815, 8, 1440x900 
0x37CA2318, 38092256346876040, 225122873, 225122880, 7, 1440x900 
0x37CA2318, 38092256347536520, 225122942, 225122949, 7, 1440x900 
0x37CA2318, 38092256348194664, 225123007, 225123014, 7, 1440x900 
0x37CA2318, 38092256348855496, 225123072, 225123079, 7, 1440x900 
0x37CA2318, 38092256349515464, 225123137, 225123144, 7, 1440x900 
0x37CA2318, 38092256350175648, 225123203, 225123210, 7, 1440x900 
0x37CA2318, 38092256350838696, 225123269, 225123276, 7, 1440x900 
0x37CA2318, 38092256351495760, 225123333, 225123340, 7, 1440x900 
0x37CA2318, 38092256352155560, 225123402, 225123409, 7, 1440x900 
0x37CA2318, 38092256352818528, 225123471, 225123478, 7, 1440x900 
0x37CA2318, 38092256353492712, 225123539, 225123550, 11, 1440x900 
0x37CA2318, 38092256354139408, 225123597, 225123605, 8, 1440x900 
0x37CA2318, 38092256354802968, 225123668, 225123682, 14, 1440x900 
0x37CA2318, 38092256355466552, 225123733, 225123740, 7, 1440x900 
0x37CA2318, 38092256356121696, 225123798, 225123806, 8, 1440x900 
0x37CA2318, 38092256356778912, 225123864, 225123871, 7, 1440x900 
0x37CA2318, 38092256357438952, 225123928, 225123936, 8, 1440x900 
0x37CA2318, 38092256358099056, 225123997, 225124004, 7, 1440x900 
0x37CA2318, 38092256358759504, 225124062, 225124069, 7, 1440x900 
0x37CA2318, 38092256359419312, 225124127, 225124135, 8, 1440x900 
0x37CA2318, 38092256360079264, 225124193, 225124200, 7, 1440x900 
0x37CA2318, 38092256360739176, 225124258, 225124265, 7, 1440x900 
0x37CA2318, 38092256361400144, 225124327, 225124334, 7, 1440x900 
0x37CA2318, 38092256362060672, 225124393, 225124400, 7, 1440x900 
0x37CA2318, 38092256362720504, 225124457, 225124465, 8, 1440x900 
0x37CA2318, 38092256363380256, 225124523, 225124530, 7, 1440x900 
0x37CA2318, 38092256364052272, 225124593, 225124603, 10, 1440x900 
0x37CA2318, 38092256364714112, 225124658, 225124667, 9, 1440x900 
0x37CA2318, 38092256365368784, 225124723, 225124730, 7, 1440x900 
0x37CA2318, 38092256366027904, 225124788, 225124795, 7, 1440x900 
0x37CA2318, 38092256366688480, 225124853, 225124861, 8, 1440x900 
0x37CA2318, 38092256367350904, 225124923, 225124930, 7, 1440x900 
0x37CA2318, 38092256368006264, 225124987, 225124994, 7, 1440x900 
0x37CA2318, 38092256368676880, 225125053, 225125062, 9, 1440x900 
0x37CA2318, 38092256369343624, 225125123, 225125131, 8, 1440x900 
0x37CA2318, 38092256370012216, 225125194, 225125202, 8, 1440x900 
0x37CA2318, 38092256370656240, 225125253, 225125260, 7, 1440x900 
0x37CA2318, 38092256371318736, 225125318, 225125325, 7, 1440x900 
0x37CA2318, 38092256371977888, 225125382, 225125390, 8, 1440x900 
0x37CA2318, 38092256372638272, 225125448, 225125456, 8, 1440x900 
0x37CA2318, 38092256373298328, 225125513, 225125521, 8, 1440x900 
0x37CA2318, 38092256373963752, 225125583, 225125591, 8, 1440x900 
0x37CA2318, 38092256374624936, 225125652, 225125661, 9, 1440x900 
0x37CA2318, 38092256375292048, 225125726, 225125744, 18, 1440x900 
0x37CA2318, 38092256375940840, 225125779, 225125787, 8, 1440x900 
0x37CA2318, 38092256376604248, 225125847, 225125854, 7, 1440x900 
0x37CA2318, 38092256377271512, 225125913, 225125920, 7, 1440x900 
0x37CA2318, 38092256377931264, 225125977, 225125985, 8, 1440x900 
0x37CA2318, 38092256378592280, 225126047, 225126054, 7, 1440x900 
0x37CA2318, 38092256379251600, 225126112, 225126119, 7, 1440x900 
0x37CA2318, 38092256379911272, 225126177, 225126184, 7, 1440x900 
0x37CA2318, 38092256380571728, 225126242, 225126250, 8, 1440x900 
0x37CA2318, 38092256381232600, 225126308, 225126316, 8, 1440x900 
0x37CA2318, 38092256381892256, 225126373, 225126380, 7, 1440x900 
0x37CA2318, 38092256382552376, 225126442, 225126448, 6, 1440x900 
0x37CA2318, 38092256383212920, 225126507, 225126514, 7, 1440x900 
0x37CA2318, 38092256383873288, 225126572, 225126584, 12, 1440x900 
0x37CA2318, 38092256384535552, 225126638, 225126646, 8, 1440x900 
0x37CA2318, 38092256385192272, 225126703, 225126711, 8, 1440x900 
0x37CA2318, 38092256385852424, 225126772, 225126779, 7, 1440x900 
0x37CA2318, 38092256386513120, 225126838, 225126847, 9, 1440x900 
0x37CA2318, 38092256387176240, 225126902, 225126910, 8, 1440x900 
0x37CA2318, 38092256387838912, 225126968, 225126976, 8, 1440x900 
0x37CA2318, 38092256388505952, 225127037, 225127044, 7, 1440x900 
0x37CA2318, 38092256389168480, 225127102, 225127110, 8, 1440x900 
0x37CA2318, 38092256389825792, 225127168, 225127176, 8, 1440x900 
0x37CA2318, 38092256390485880, 225127237, 225127244, 7, 1440x900 
0x37CA2318, 38092256391146592, 225127298, 225127306, 8, 1440x900 
0x37CA2318, 38092256391805936, 225127368, 225127375, 7, 1440x900 
0x37CA2318, 38092256392471576, 225127433, 225127440, 7, 1440x900 
0x37CA2318, 38092256393131408, 225127498, 225127506, 8, 1440x900 
0x37CA2318, 38092256393792000, 225127563, 225127570, 7, 1440x900 
0x37CA2318, 38092256394451888, 225127632, 225127639, 7, 1440x900 
0x37CA2318, 38092256395111624, 225127698, 225127705, 7, 1440x900 
0x37CA2318, 38092256395774320, 225127762, 225127770, 8, 1440x900 
0x37CA2318, 38092256396432032, 225127828, 225127835, 7, 1440x900 
0x37CA2318, 38092256397094736, 225127893, 225127901, 8, 1440x900 
0x37CA2318, 38092256397754352, 225127961, 225127968, 7, 1440x900 
0x37CA2318, 38092256398414944, 225128027, 225128034, 7, 1440x900 
0x37CA2318, 38092256399074848, 225128092, 225128099, 7, 1440x900 
0x37CA2318, 38092256399740848, 225128163, 225128171, 8, 1440x900 
0x37CA2318, 38092256400400608, 225128233, 225128241, 8, 1440x900 
0x37CA2318, 38092256401056408, 225128292, 225128299, 7, 1440x900 
0x37CA2318, 38092256401716752, 225128357, 225128364, 7, 1440x900 
0x37CA2318, 38092256402379392, 225128422, 225128430, 8, 1440x900 
0x37CA2318, 38092256403041000, 225128489, 225128497, 8, 1440x900 
0x37CA2318, 38092256403701016, 225128557, 225128564, 7, 1440x900 
0x37CA2318, 38092256404361680, 225128622, 225128629, 7, 1440x900 
0x37CA2318, 38092256405027320, 225128698, 225128706, 8, 1440x900 
0x37CA2318, 38092256405689912, 225128757, 225128764, 7, 1440x900 
0x37CA2318, 38092256406351568, 225128823, 225128831, 8, 1440x900 
0x37CA2318, 38092256407011888, 225128886, 225128894, 8, 1440x900 
0x37CA2318, 38092256408329296, 225129018, 225129026, 8, 1440x900 
0x37CA2318, 38092256409031832, 225129092, 225129099, 7, 1440x900 
0x37CA2318, 38092256409674664, 225129153, 225129161, 8, 1440x900 
0x37CA2318, 38092256410338016, 225129218, 225129226, 8, 1440x900 
0x37CA2318, 38092256410998528, 225129284, 225129292, 8, 1440x900 
0x37CA2318, 38092256411659272, 225129353, 225129359, 6, 1440x900 
0x37CA2318, 38092256412319088, 225129418, 225129424, 6, 1440x900 
0x37CA2318, 38092256412978832, 225129483, 225129491, 8, 1440x900 
0x37CA2318, 38092256413639192, 225129548, 225129555, 7, 1440x900 
0x37CA2318, 38092256414298632, 225129617, 225129624, 7, 1440x900 
0x37CA2318, 38092256414958968, 225129688, 225129695, 7, 1440x900 
0x37CA2318, 38092256415619088, 225129747, 225129755, 8, 1440x900 
0x37CA2318, 38092256416285024, 225129812, 225129820, 8, 1440x900 
0x37CA2318, 38092256416945032, 225129879, 225129887, 8, 1440x900 
0x37CA2318, 38092256417605056, 225129947, 225129954, 7, 1440x900 
0x37CA2318, 38092256418264976, 225130013, 225130019, 6, 1440x900 
0x37CA2318, 38092256418925120, 225130078, 225130086, 8, 1440x900 
0x37CA2318, 38092256419585104, 225130143, 225130151, 8, 1440x900 
0x37CA2318, 38092256420245512, 225130212, 225130219, 7, 1440x900 
0x37CA2318, 38092256420912640, 225130277, 225130284, 7, 1440x900 
0x37CA2318, 38092256421576448, 225130342, 225130350, 8, 1440x900 
0x37CA2318, 38092256422236560, 225130408, 225130416, 8, 1440x900 
0x37CA2318, 38092256422901720, 225130480, 225130488, 8, 1440x900 
0x37CA2318, 38092256423601592, 225130548, 225130556, 8, 1440x900 
0x37CA2318, 38092256424222656, 225130607, 225130615, 8, 1440x900 
0x37CA2318, 38092256424884192, 225130676, 225130683, 7, 1440x900 
0x37CA2318, 38092256425544992, 225130741, 225130748, 7, 1440x900 
0x37CA2318, 38092256426228688, 225130811, 225130819, 8, 1440x900 
0x37CA2318, 38092256426872016, 225130873, 225130880, 7, 1440x900 
0x37CA2318, 38092256427544080, 225130943, 225130951, 8, 1440x900 
0x37CA2318, 38092256428212416, 225131007, 225131015, 8, 1440x900 
0x37CA2318, 38092256428869320, 225131081, 225131088, 7, 1440x900 
0x37CA2318, 38092256429523248, 225131138, 225131146, 8, 1440x900 
0x37CA2318, 38092256430181952, 225131203, 225131211, 8, 1440x900 
0x37CA2318, 38092256430842312, 225131270, 225131278, 8, 1440x900 
0x37CA2318, 38092256431502160, 225131338, 225131345, 7, 1440x900 
0x37CA2318, 38092256432162048, 225131403, 225131410, 7, 1440x900 
0x37CA2318, 38092256432822672, 225131468, 225131476, 8, 1440x900 
0x37CA2318, 38092256433481520, 225131537, 225131544, 7, 1440x900 
0x37CA2318, 38092256434142632, 225131598, 225131606, 8, 1440x900 
0x37CA2318, 38092256434802512, 225131667, 225131674, 7, 1440x900 
0x37CA2318, 38092256435462448, 225131732, 225131740, 8, 1440x900 
0x37CA2318, 38092256436154344, 225131803, 225131813, 10, 1440x900 
0x37CA2318, 38092256436794064, 225131863, 225131871, 8, 1440x900 
0x37CA2318, 38092256437464408, 225131932, 225131940, 8, 1440x900 
0x37CA2318, 38092256438133384, 225131998, 225132007, 9, 1440x900 
0x37CA2318, 38092256438787360, 225132063, 225132072, 9, 1440x900 
0x37CA2318, 38092256439447960, 225132132, 225132140, 8, 1440x900 
0x37CA2318, 38092256440131960, 225132201, 225132209, 8, 1440x900 
0x37CA2318, 38092256440755800, 225132262, 225132269, 7, 1440x900 
0x37CA2318, 38092256441414440, 225132327, 225132334, 7, 1440x900 
0x37CA2318, 38092256442076960, 225132393, 225132400, 7, 1440x900 
0x37CA2318, 38092256442735912, 225132458, 225132466, 8, 1440x900 
0x37CA2318, 38092256443395712, 225132523, 225132530, 7, 1440x900 
0x37CA2318, 38092256444063208, 225132592, 225132599, 7, 1440x900 
0x37CA2318, 38092256444723640, 225132658, 225132666, 8, 1440x900 
0x37CA2318, 38092256445434936, 225132727, 225132735, 8, 1440x900 
0x37CA2318, 38092256446044136, 225132793, 225132799, 6, 1440x900 
0x37CA2318, 38092256446951008, 225132906, 225132936, 30, 1440x900 
0x37CA2318, 38092256447918904, 225132981, 225133018, 37, 1440x900 
0x37CA2318, 38092256448418496, 225133032, 225133040, 8, 1440x900 
0x37CA2318, 38092256448975344, 225133083, 225133091, 8, 1440x900 
0x37CA2318, 38092256449633560, 225133147, 225133155, 8, 1440x900 
0x37CA2318, 38092256450298912, 225133217, 225133225, 8, 1440x900 
0x37CA2318, 38092256450955760, 225133282, 225133289, 7, 1440x900 
0x37CA2318, 38092256451618720, 225133348, 225133355, 7, 1440x900 
0x37CA2318, 38092256452331976, 225133419, 225133426, 7, 1440x900 
0x37CA2318, 38092256452951208, 225133482, 225133489, 7, 1440x900 
0x37CA2318, 38092256453618784, 225133548, 225133558, 10, 1440x900 
0x37CA2318, 38092256454628856, 225133647, 225133658, 11, 1440x900 
0x37CA2318, 38092256454929472, 225133678, 225133690, 12, 1440x900 
0x37CA2318, 38092256457577888, 225133958, 225133988, 30, 1440x900 
0x37CA2318, 38092256458354104, 225134020, 225134030, 10, 1440x900 
0x37CA2318, 38092256458996112, 225134093, 225134127, 34, 1440x900 
0x37CA2318, 38092256459807536, 225134175, 225134218, 43, 1440x900 
0x37CA2318, 38092256460443496, 225134229, 225134238, 9, 1440x900 
0x37CA2318, 38092256460940080, 225134279, 225134291, 12, 1440x900 
0x37CA2318, 38092256461559616, 225134343, 225134354, 11, 1440x900 
0x37CA2318, 38092256462256352, 225134412, 225134420, 8, 1440x900 
0x37CA2318, 38092256462888368, 225134473, 225134485, 12, 1440x900 
0x37CA2318, 38092256463549664, 225134542, 225134549, 7, 1440x900 
0x37CA2318, 38092256464207560, 225134607, 225134618, 11, 1440x900 
0x37CA2318, 38092256464926600, 225134681, 225134689, 8, 1440x900 
0x37CA2318, 38092256465539008, 225134738, 225134746, 8, 1440x900 
0x37CA2318, 38092256466197312, 225134803, 225134812, 9, 1440x900 
0x37CA2318, 38092256466856712, 225134872, 225134880, 8, 1440x900 
0x37CA2318, 38092256467520440, 225134937, 225134945, 8, 1440x900 
0x37CA2318, 38092256468186616, 225135003, 225135011, 8, 1440x900 
0x37CA2318, 38092256468845456, 225135070, 225135079, 9, 1440x900 
0x37CA2318, 38092256469509560, 225135137, 225135144, 7, 1440x900 
0x37CA2318, 38092256470229536, 225135219, 225135347, 128, 1440x900 
0x37CA2318, 38092256471607624, 225135355, 225135364, 9, 1440x900 
0x37CA2318, 38092256472092848, 225135395, 225135435, 40, 1440x900 
0x37CA2318, 38092256472410904, 225135438, 225135457, 19, 1440x900 
0x37CA2318, 38092256472973832, 225135489, 225135510, 21, 1440x900 
0x37CA2318, 38092256473676256, 225135553, 225135563, 10, 1440x900 
0x37CA2318, 38092256474320336, 225135618, 225135625, 7, 1440x900 
0x37CA2318, 38092256474973768, 225135687, 225135695, 8, 1440x900 
0x37CA2318, 38092256475666448, 225135753, 225135761, 8, 1440x900 
0x37CA2318, 38092256476294408, 225135819, 225135827, 8, 1440x900 
0x37CA2318, 38092256476949352, 225135879, 225135887, 8, 1440x900 
0x37CA2318, 38092256477614376, 225135947, 225135955, 8, 1440x900 
0x37CA2318, 38092256478288904, 225136013, 225136022, 9, 1440x900 
0x37CA2318, 38092256479595504, 225136148, 225136155, 7, 1440x900 
0x37CA2318, 38092256480258576, 225136214, 225136223, 9, 1440x900 
0x37CA2318, 38092256480916024, 225136280, 225136289, 9, 1440x900 
0x37CA2318, 38092256481574224, 225136344, 225136352, 8, 1440x900 
0x37CA2318, 38092256482234224, 225136408, 225136420, 12, 1440x900 
0x37CA2318, 38092256482896680, 225136478, 225136485, 7, 1440x900 
0x37CA2318, 38092256483569328, 225136543, 225136554, 11, 1440x900 
0x37CA2318, 38092256484224872, 225136608, 225136617, 9, 1440x900 
0x37CA2318, 38092256484886688, 225136673, 225136682, 9, 1440x900 
0x37CA2318, 38092256485545104, 225136742, 225136753, 11, 1440x900 
0x37CA2318, 38092256486206344, 225136807, 225136814, 7, 1440x900 
0x37CA2318, 38092256486866504, 225136872, 225136880, 8, 1440x900 
0x37CA2318, 38092256487525288, 225136938, 225136946, 8, 1440x900 
0x37CA2318, 38092256488188208, 225137007, 225137016, 9, 1440x900 
0x37CA2318, 38092256488928608, 225137097, 225137105, 8, 1440x900 
0x37CA2318, 38092256489626952, 225137148, 225137159, 11, 1440x900 
0x37CA2318, 38092256490160440, 225137202, 225137212, 10, 1440x900 
0x37CA2318, 38092256490827264, 225137268, 225137276, 8, 1440x900 
0x37CA2318, 38092256491501168, 225137339, 225137350, 11, 1440x900 
0x37CA2318, 38092256492420808, 225137438, 225137461, 23, 1440x900 
0x37CA2318, 38092256492927312, 225137505, 225137513, 8, 1440x900 
0x37CA2318, 38092256493526656, 225137538, 225137547, 9, 1440x900 
0x37CA2318, 38092256494147584, 225137607, 225137616, 9, 1440x900 
0x37CA2318, 38092256494832600, 225137668, 225137676, 8, 1440x900 
0x37CA2318, 38092256495458784, 225137732, 225137739, 7, 1440x900 
0x37CA2318, 38092256496117336, 225137797, 225137804, 7, 1440x900 
0x37CA2318, 38092256496778232, 225137862, 225137870, 8, 1440x900 
0x37CA2318, 38092256497440056, 225137928, 225137937, 9, 1440x900 
0x37CA2318, 38092256498099584, 225137993, 225138002, 9, 1440x900 
0x37CA2318, 38092256498765992, 225138062, 225138070, 8, 1440x900 
0x37CA2318, 38092256499426256, 225138128, 225138136, 8, 1440x900 
0x37CA2318, 38092256500086536, 225138193, 225138201, 8, 1440x900 
0x37CA2318, 38092256500756408, 225138262, 225138269, 7, 1440x900 
0x37CA2318, 38092256501416280, 225138327, 225138335, 8, 1440x900 
0x37CA2318, 38092256502075704, 225138393, 225138401, 8, 1440x900 
0x37CA2318, 38092256502736744, 225138458, 225138466, 8, 1440x900 
0x37CA2318, 38092256503396408, 225138523, 225138531, 8, 1440x900 
0x37CA2318, 38092256504056704, 225138592, 225138600, 8, 1440x900 
0x37CA2318, 38092256504718112, 225138657, 225138665, 8, 1440x900 
0x37CA2318, 38092256505376192, 225138723, 225138730, 7, 1440x900 
0x37CA2318, 38092256506035824, 225138788, 225138796, 8, 1440x900 
0x37CA2318, 38092256506704896, 225138857, 225138864, 7, 1440x900 
0x37CA2318, 38092256507364848, 225138922, 225138929, 7, 1440x900 
0x37CA2318, 38092256508028168, 225138988, 225138996, 8, 1440x900 
0x37CA2318, 38092256508684416, 225139052, 225139059, 7, 1440x900 
0x37CA2318, 38092256509346752, 225139119, 225139128, 9, 1440x900 
0x37CA2318, 38092256510009312, 225139186, 225139194, 8, 1440x900 
0x37CA2318, 38092256510672056, 225139252, 225139259, 7, 1440x900 
0x37CA2318, 38092256511327416, 225139318, 225139325, 7, 1440x900 
0x37CA2318, 38092256511986928, 225139383, 225139391, 8, 1440x900 
0x37CA2318, 38092256512647776, 225139452, 225139459, 7, 1440x900 
0x37CA2318, 38092256513307696, 225139517, 225139524, 7, 1440x900 
0x37CA2318, 38092256513967248, 225139582, 225139590, 8, 1440x900 
0x37CA2318, 38092256514632200, 225139648, 225139656, 8, 1440x900 
0x37CA2318, 38092256515943072, 225139784, 225139800, 16, 1440x900 
0x37CA2318, 38092256516571832, 225139843, 225139854, 11, 1440x900 
0x37CA2318, 38092256517194424, 225139908, 225139915, 7, 1440x900 
0x37CA2318, 38092256517849776, 225139972, 225139979, 7, 1440x900 
0x37CA2318, 38092256518510264, 225140037, 225140045, 8, 1440x900 
0x37CA2318, 38092256519171824, 225140103, 225140110, 7, 1440x900 
0x37CA2318, 38092256519831408, 225140168, 225140176, 8, 1440x900 
0x37CA2318, 38092256520491312, 225140236, 225140243, 7, 1440x900 
0x37CA2318, 38092256521161696, 225140303, 225140310, 7, 1440x900 
0x37CA2318, 38092256521823328, 225140367, 225140375, 8, 1440x900 
0x37CA2318, 38092256522482952, 225140432, 225140440, 8, 1440x900 
0x37CA2318, 38092256523141472, 225140501, 225140508, 7, 1440x900 
0x37CA2318, 38092256523800160, 225140567, 225140574, 7, 1440x900 
0x37CA2318, 38092256524460328, 225140632, 225140639, 7, 1440x900 
0x37CA2318, 38092256525120824, 225140698, 225140705, 7, 1440x900 
0x37CA2318, 38092256525780144, 225140764, 225140772, 8, 1440x900 
0x37CA2318, 38092256526440328, 225140829, 225140837, 8, 1440x900 
0x37CA2318, 38092256527099600, 225140893, 225140901, 8, 1440x900 
0x37CA2318, 38092256527759920, 225140963, 225140969, 6, 1440x900 
0x37CA2318, 38092256528427832, 225141029, 225141046, 17, 1440x900 
0x37CA2318, 38092256529087680, 225141093, 225141101, 8, 1440x900 
0x37CA2318, 38092256529758104, 225141165, 225141173, 8, 1440x900 
0x37CA2318, 38092256530418456, 225141228, 225141236, 8, 1440x900 
0x37CA2318, 38092256531078784, 225141293, 225141301, 8, 1440x900 
0x37CA2318, 38092256531771352, 225141362, 225141378, 16, 1440x900 
0x37CA2318, 38092256532397712, 225141427, 225141436, 9, 1440x900 
0x37CA2318, 38092256533103856, 225141495, 225141503, 8, 1440x900 
0x37CA2318, 38092256533792496, 225141563, 225141574, 11, 1440x900 
0x37CA2318, 38092256534382560, 225141629, 225141641, 12, 1440x900 
0x37CA2318, 38092256535040424, 225141692, 225141700, 8, 1440x900 
0x37CA2318, 38092256535787120, 225141768, 225141779, 11, 1440x900 
0x37CA2318, 38092256536370040, 225141822, 225141831, 9, 1440x900 
0x37CA2318, 38092256537037880, 225141887, 225141895, 8, 1440x900 
0x37CA2318, 38092256537692840, 225141953, 225141961, 8, 1440x900 
0x37CA2318, 38092256538360368, 225142022, 225142036, 14, 1440x900 
0x37CA2318, 38092256539018872, 225142087, 225142094, 7, 1440x900 
0x37CA2318, 38092256539682112, 225142152, 225142160, 8, 1440x900 
0x37CA2318, 38092256540341560, 225142222, 225142229, 7, 1440x900 
0x37CA2318, 38092256541092736, 225142300, 225142308, 8, 1440x900 
0x37CA2318, 38092256541752912, 225142360, 225142372, 12, 1440x900 
0x37CA2318, 38092256542413680, 225142427, 225142436, 9, 1440x900 
0x37CA2318, 38092256543072728, 225142495, 225142503, 8, 1440x900 
0x37CA2318, 38092256543732272, 225142557, 225142565, 8, 1440x900 
0x37CA2318, 38092256544502368, 225142635, 225142643, 8, 1440x900 
0x37CA2318, 38092256545247376, 225142711, 225142719, 8, 1440x900 
0x37CA2318, 38092256545711048, 225142757, 225142764, 7, 1440x900 
0x37CA2318, 38092256546380728, 225142823, 225142831, 8, 1440x900 
0x37CA2318, 38092256547248656, 225142912, 225142921, 9, 1440x900 
0x37CA2318, 38092256547898880, 225142977, 225142984, 7, 1440x900 
0x37CA2318, 38092256548557680, 225143042, 225143050, 8, 1440x900 
0x37CA2318, 38092256549229712, 225143111, 225143118, 7, 1440x900 
0x37CA2318, 38092256549879408, 225143173, 225143180, 7, 1440x900 
0x37CA2318, 38092256550550752, 225143242, 225143249, 7, 1440x900 
0x37CA2318, 38092256551211792, 225143307, 225143314, 7, 1440x900 
0x37CA2318, 38092256551871776, 225143373, 225143380, 7, 1440x900 
0x37CA2318, 38092256552539232, 225143448, 225143457, 9, 1440x900 
0x37CA2318, 38092256553210024, 225143507, 225143514, 7, 1440x900 
0x37CA2318, 38092256553867880, 225143574, 225143581, 7, 1440x900 
0x37CA2318, 38092256554519256, 225143641, 225143649, 8, 1440x900 
0x37CA2318, 38092256555188024, 225143708, 225143716, 8, 1440x900 
0x37CA2318, 38092256555857112, 225143772, 225143780, 8, 1440x900 
0x37CA2318, 38092256556507504, 225143837, 225143844, 7, 1440x900 
0x37CA2318, 38092256557167912, 225143903, 225143911, 8, 1440x900 
0x37CA2318, 38092256557830136, 225143968, 225143976, 8, 1440x900 
0x37CA2318, 38092256558498864, 225144035, 225144044, 9, 1440x900 
0x37CA2318, 38092256559141648, 225144098, 225144106, 8, 1440x900 
0x37CA2318, 38092256559610552, 225144146, 225144153, 7, 1440x900 
0x37CA2318, 38092256560478056, 225144233, 225144241, 8, 1440x900 
0x37CA2318, 38092256561140528, 225144298, 225144306, 8, 1440x900 
0x37CA2318, 38092256561809672, 225144367, 225144374, 7, 1440x900 
0x37CA2318, 38092256562462128, 225144432, 225144439, 7, 1440x900 
0x37CA2318, 38092256563114352, 225144498, 225144504, 6, 1440x900 
0x37CA2318, 38092256563605944, 225144548, 225144557, 9, 1440x900 
0x37CA2318, 38092256564458768, 225144633, 225144640, 7, 1440x900 
0x37CA2318, 38092256565120856, 225144697, 225144705, 8, 1440x900 
0x37CA2318, 38092256565579840, 225144743, 225144752, 9, 1440x900 
0x37CA2318, 38092256566448512, 225144829, 225144837, 8, 1440x900 
0x37CA2318, 38092256567098168, 225144897, 225144911, 14, 1440x900 
0x37CA2318, 38092256567767952, 225144962, 225144969, 7, 1440x900 
0x37CA2318, 38092256568418464, 225145027, 225145034, 7, 1440x900 
0x37CA2318, 38092256569088304, 225145097, 225145104, 7, 1440x900 
0x37CA2318, 38092256569748192, 225145159, 225145167, 8, 1440x900 
0x37CA2318, 38092256570216360, 225145207, 225145214, 7, 1440x900 
0x37CA2318, 38092256571075232, 225145292, 225145300, 8, 1440x900 
0x37CA2318, 38092256571776832, 225145363, 225145370, 7, 1440x900 
0x37CA2318, 38092256572447600, 225145432, 225145439, 7, 1440x900 
0x37CA2318, 38092256572998480, 225145485, 225145495, 10, 1440x900 
0x37CA2318, 38092256573640192, 225145548, 225145560, 12, 1440x900 
0x37CA2318, 38092256574352336, 225145619, 225145650, 31, 1440x900 
0x37CA2318, 38092256575120624, 225145717, 225145765, 48, 1440x900 
0x37CA2318, 38092256576084672, 225145792, 225145809, 17, 1440x900 
0x37CA2318, 38092256576613272, 225145848, 225145858, 10, 1440x900 
0x37CA2318, 38092256577203320, 225145916, 225145932, 16, 1440x900 
0x37CA2318, 38092256578009376, 225146040, 225146064, 24, 1440x900 
0x37CA2318, 38092256578846800, 225146076, 225146093, 17, 1440x900 
0x37CA2318, 38092256579444312, 225146128, 225146136, 8, 1440x900 
0x37CA2318, 38092256580198240, 225146205, 225146214, 9, 1440x900 
0x37CA2318, 38092256580782648, 225146276, 225146284, 8, 1440x900 
0x37CA2318, 38092256581451936, 225146329, 225146339, 10, 1440x900 
0x37CA2318, 38092256582165632, 225146422, 225146440, 18, 1440x900 
0x37CA2318, 38092256582721288, 225146460, 225146476, 16, 1440x900 
0x37CA2318, 38092256583377600, 225146529, 225146542, 13, 1440x900 
0x37CA2318, 38092256584042040, 225146592, 225146599, 7, 1440x900 
0x37CA2318, 38092256584865752, 225146672, 225146679, 7, 1440x900 
0x37CA2318, 38092256585334128, 225146717, 225146727, 10, 1440x900 
0x37CA2318, 38092256586001784, 225146787, 225146794, 7, 1440x900 
0x37CA2318, 38092256586658776, 225146852, 225146859, 7, 1440x900 
0x37CA2318, 38092256587318760, 225146917, 225146925, 8, 1440x900 
0x37CA2318, 38092256587980128, 225146983, 225146991, 8, 1440x900 
0x37CA2318, 38092256588654464, 225147051, 225147059, 8, 1440x900 
0x37CA2318, 38092256589489032, 225147133, 225147140, 7, 1440x900 
0x37CA2318, 38092256590158872, 225147202, 225147209, 7, 1440x900 
0x37CA2318, 38092256590818152, 225147276, 225147312, 36, 1440x900 
0x37CA2318, 38092256591336192, 225147318, 225147351, 33, 1440x900 
0x37CA2318, 38092256591970224, 225147383, 225147389, 6, 1440x900 
0x37CA2318, 38092256592809008, 225147467, 225147474, 7, 1440x900 
0x37CA2318, 38092256593468520, 225147533, 225147541, 8, 1440x900 
0x37CA2318, 38092256593971848, 225147600, 225147611, 11, 1440x900 
0x37CA2318, 38092256594637032, 225147648, 225147658, 10, 1440x900 
0x37CA2318, 38092256595279184, 225147713, 225147722, 9, 1440x900 
0x37CA2318, 38092256596082448, 225147800, 225147808, 8, 1440x900 
0x37CA2318, 38092256596704216, 225147859, 225147867, 8, 1440x900 
0x37CA2318, 38092256597383392, 225147931, 225147940, 9, 1440x900 
0x37CA2318, 38092256598027536, 225147999, 225148011, 12, 1440x900 
0x37CA2318, 38092256598687744, 225148057, 225148074, 17, 1440x900 
0x37CA2318, 38092256599346992, 225148123, 225148138, 15, 1440x900 
0x37CA2318, 38092256600024920, 225148188, 225148205, 17, 1440x900 
0x37CA2318, 38092256600695352, 225148261, 225148273, 12, 1440x900 
0x37CA2318, 38092256601453944, 225148348, 225148366, 18, 1440x900 
0x37CA2318, 38092256602042208, 225148403, 225148419, 16, 1440x900 
0x37CA2318, 38092256602836488, 225148487, 225148509, 22, 1440x900 
0x37CA2318, 38092256603385768, 225148527, 225148539, 12, 1440x900 
0x37CA2318, 38092256604086400, 225148619, 225148643, 24, 1440x900 
0x37CA2318, 38092256604845624, 225148669, 225148689, 20, 1440x900 
0x37CA2318, 38092256605506160, 225148734, 225148748, 14, 1440x900 
0x37CA2318, 38092256606054000, 225148792, 225148807, 15, 1440x900 
0x37CA2318, 38092256606712216, 225148858, 225148865, 7, 1440x900 
0x37CA2318, 38092256607527528, 225148969, 225148992, 23, 1440x900 
0x37CA2318, 38092256608088824, 225149014, 225149033, 19, 1440x900 
0x37CA2318, 38092256608732800, 225149058, 225149068, 10, 1440x900 
0x37CA2318, 38092256609401536, 225149133, 225149147, 14, 1440x900 
0x37CA2318, 38092256610058408, 225149201, 225149210, 9, 1440x900 
0x37CA2318, 38092256610722936, 225149268, 225149277, 9, 1440x900 
0x37CA2318, 38092256611375696, 225149323, 225149331, 8, 1440x900 
0x37CA2318, 38092256612018040, 225149388, 225149396, 8, 1440x900 
0x37CA2318, 38092256612678176, 225149454, 225149463, 9, 1440x900 
0x37CA2318, 38092256613343104, 225149526, 225149535, 9, 1440x900 
0x37CA2318, 38092256614020096, 225149588, 225149596, 8, 1440x900 
0x37CA2318, 38092256614685152, 225149653, 225149663, 10, 1440x900 
0x37CA2318, 38092256615352224, 225149722, 225149737, 15, 1440x900 
0x37CA2318, 38092256616014016, 225149788, 225149801, 13, 1440x900 
0x37CA2318, 38092256616678984, 225149853, 225149868, 15, 1440x900 
0x37CA2318, 38092256617354184, 225149922, 225149936, 14, 1440x900 
0x37CA2318, 38092256618005184, 225149987, 225150002, 15, 1440x900 
0x37CA2318, 38092256618670728, 225150054, 225150067, 13, 1440x900 
0x37CA2318, 38092256619336056, 225150118, 225150129, 11, 1440x900 
0x37CA2318, 38092256620000008, 225150187, 225150196, 9, 1440x900 
0x37CA2318, 38092256620651952, 225150253, 225150263, 10, 1440x900 
0x37CA2318, 38092256621320256, 225150317, 225150326, 9, 1440x900 
0x37CA2318, 38092256621932600, 225150383, 225150393, 10, 1440x900 
0x37CA2318, 38092256622591752, 225150448, 225150457, 9, 1440x900 
0x37CA2318, 38092256623558616, 225150543, 225150555, 12, 1440x900 
0x37CA2318, 38092256623914528, 225150577, 225150584, 7, 1440x900 
0x37CA2318, 38092256624787480, 225150663, 225150671, 8, 1440x900 
0x37CA2318, 38092256625448056, 225150731, 225150738, 7, 1440x900 
0x37CA2318, 38092256625910152, 225150780, 225150788, 8, 1440x900 
0x37CA2318, 38092256626570944, 225150843, 225150850, 7, 1440x900 
0x37CA2318, 38092256627231952, 225150908, 225150916, 8, 1440x900 
0x37CA2318, 38092256627893632, 225150980, 225150988, 8, 1440x900 
0x37CA2318, 38092256628553224, 225151043, 225151051, 8, 1440x900 
0x37CA2318, 38092256629215088, 225151108, 225151117, 9, 1440x900 
0x37CA2318, 38092256629877904, 225151178, 225151186, 8, 1440x900 
0x37CA2318, 38092256630534952, 225151243, 225151251, 8, 1440x900 
0x37CA2318, 38092256631205336, 225151309, 225151317, 8, 1440x900 
0x37CA2318, 38092256631853024, 225151372, 225151379, 7, 1440x900 
0x37CA2318, 38092256632513456, 225151437, 225151445, 8, 1440x900 
0x37CA2318, 38092256633173008, 225151503, 225151511, 8, 1440x900 
0x37CA2318, 38092256633866096, 225151572, 225151579, 7, 1440x900 
0x37CA2318, 38092256634504728, 225151637, 225151644, 7, 1440x900 
0x37CA2318, 38092256635162720, 225151701, 225151708, 7, 1440x900 
0x37CA2318, 38092256635822528, 225151768, 225151775, 7, 1440x900 
0x37CA2318, 38092256636482576, 225151833, 225151841, 8, 1440x900 
0x37CA2318, 38092256637143272, 225151898, 225151905, 7, 1440x900 
0x37CA2318, 38092256637807752, 225151967, 225151974, 7, 1440x900 
0x37CA2318, 38092256638464680, 225152033, 225152040, 7, 1440x900 
0x37CA2318, 38092256639126960, 225152097, 225152105, 8, 1440x900 
0x37CA2318, 38092256639784736, 225152166, 225152173, 7, 1440x900 
0x37CA2318, 38092256640463496, 225152230, 225152238, 8, 1440x900 
0x37CA2318, 38092256641105456, 225152297, 225152304, 7, 1440x900 
0x37CA2318, 38092256641764352, 225152362, 225152370, 8, 1440x900 
0x37CA2318, 38092256642460768, 225152432, 225152439, 7, 1440x900 
0x37CA2318, 38092256643091752, 225152493, 225152502, 9, 1440x900 
0x37CA2318, 38092256643773728, 225152563, 225152571, 8, 1440x900 
0x37CA2318, 38092256644414104, 225152628, 225152637, 9, 1440x900 
0x37CA2318, 38092256645073920, 225152693, 225152702, 9, 1440x900 
0x37CA2318, 38092256645736576, 225152762, 225152771, 9, 1440x900 
0x37CA2318, 38092256646394464, 225152827, 225152835, 8, 1440x900 
0x37CA2318, 38092256647053072, 225152893, 225152901, 8, 1440x900 
0x37CA2318, 38092256647716184, 225152962, 225152970, 8, 1440x900 
0x37CA2318, 38092256648581928, 225153048, 225153056, 8, 1440x900 
0x37CA2318, 38092256649241056, 225153112, 225153120, 8, 1440x900 
0x37CA2318, 38092256649895488, 225153178, 225153187, 9, 1440x900 
0x37CA2318, 38092256650564384, 225153247, 225153255, 8, 1440x900 
0x37CA2318, 38092256651023504, 225153292, 225153301, 9, 1440x900 
0x37CA2318, 38092256651681256, 225153357, 225153365, 8, 1440x900 
0x37CA2318, 38092256652344536, 225153421, 225153429, 8, 1440x900 
0x37CA2318, 38092256653007312, 225153488, 225153495, 7, 1440x900 
0x37CA2318, 38092256653691152, 225153558, 225153565, 7, 1440x900 
0x37CA2318, 38092256654326320, 225153619, 225153625, 6, 1440x900 
0x37CA2318, 38092256654993080, 225153684, 225153694, 10, 1440x900 
0x37CA2318, 38092256655656576, 225153752, 225153759, 7, 1440x900 
0x37CA2318, 38092256656311896, 225153817, 225153824, 7, 1440x900 
0x37CA2318, 38092256656974496, 225153883, 225153890, 7, 1440x900 
0x37CA2318, 38092256657636608, 225153948, 225153956, 8, 1440x900 
0x37CA2318, 38092256658295944, 225154017, 225154024, 7, 1440x900 
0x37CA2318, 38092256658953800, 225154081, 225154089, 8, 1440x900 
0x37CA2318, 38092256659613896, 225154148, 225154155, 7, 1440x900 
0x37CA2318, 38092256660274032, 225154212, 225154221, 9, 1440x900 
0x37CA2318, 38092256660937408, 225154282, 225154290, 8, 1440x900 
0x37CA2318, 38092256661596608, 225154343, 225154352, 9, 1440x900 
0x37CA2318, 38092256662263472, 225154412, 225154419, 7, 1440x900 
0x37CA2318, 38092256662924104, 225154478, 225154486, 8, 1440x900 
0x37CA2318, 38092256663607184, 225154547, 225154555, 8, 1440x900 
0x37CA2318, 38092256664269656, 225154612, 225154620, 8, 1440x900 
0x37CA2318, 38092256664904200, 225154676, 225154684, 8, 1440x900 
0x37CA2318, 38092256665563800, 225154742, 225154749, 7, 1440x900 
0x37CA2318, 38092256666883816, 225154873, 225154881, 8, 1440x900 
0x37CA2318, 38092256667650208, 225154952, 225154960, 8, 1440x900 
0x37CA2318, 38092256668204640, 225155007, 225155015, 8, 1440x900 
0x37CA2318, 38092256668865208, 225155072, 225155080, 8, 1440x900 
0x37CA2318, 38092256669524152, 225155138, 225155145, 7, 1440x900 
0x37CA2318, 38092256670322592, 225155217, 225155225, 8, 1440x900 
0x37CA2318, 38092256670853376, 225155272, 225155279, 7, 1440x900 
0x37CA2318, 38092256671513376, 225155338, 225155345, 7, 1440x900 
0x37CA2318, 38092256672323152, 225155418, 225155426, 8, 1440x900 
0x37CA2318, 38092256672836368, 225155468, 225155476, 8, 1440x900 
0x37CA2318, 38092256673518464, 225155540, 225155548, 8, 1440x900 
0x37CA2318, 38092256674181000, 225155602, 225155611, 9, 1440x900 
0x37CA2318, 38092256675019320, 225155692, 225155699, 7, 1440x900 
0x37CA2318, 38092256675671440, 225155758, 225155766, 8, 1440x900 
0x37CA2318, 38092256676341864, 225155823, 225155831, 8, 1440x900 
0x37CA2318, 38092256676993344, 225155887, 225155895, 8, 1440x900 
0x37CA2318, 38092256677664800, 225155954, 225155962, 8, 1440x900 
0x37CA2318, 38092256678326504, 225156022, 225156030, 8, 1440x900 
0x37CA2318, 38092256678977192, 225156087, 225156096, 9, 1440x900 
0x37CA2318, 38092256679656232, 225156157, 225156165, 8, 1440x900 
0x37CA2318, 38092256680325368, 225156222, 225156230, 8, 1440x900 
0x37CA2318, 38092256680977616, 225156288, 225156296, 8, 1440x900 
0x37CA2318, 38092256681645456, 225156357, 225156365, 8, 1440x900 
0x37CA2318, 38092256682296856, 225156418, 225156426, 8, 1440x900 
0x37CA2318, 38092256682967840, 225156488, 225156496, 8, 1440x900 
0x37CA2318, 38092256683626608, 225156555, 225156566, 11, 1440x900 
0x37CA2318, 38092256684111992, 225156597, 225156605, 8, 1440x900 
0x37CA2318, 38092256684946056, 225156681, 225156689, 8, 1440x900 
0x37CA2318, 38092256685606240, 225156747, 225156754, 7, 1440x900 
0x37CA2318, 38092256686274248, 225156813, 225156822, 9, 1440x900 
0x37CA2318, 38092256686933832, 225156879, 225156887, 8, 1440x900 
0x37CA2318, 38092256687603056, 225156948, 225156957, 9, 1440x900 
0x37CA2318, 38092256688261384, 225157012, 225157019, 7, 1440x900 
0x37CA2318, 38092256688930688, 225157077, 225157085, 8, 1440x900 
0x37CA2318, 38092256689590472, 225157142, 225157150, 8, 1440x900 
0x37CA2318, 38092256690250408, 225157212, 225157219, 7, 1440x900 
0x37CA2318, 38092256690910664, 225157282, 225157291, 9, 1440x900 
0x37CA2318, 38092256691576256, 225157347, 225157355, 8, 1440x900 
0x37CA2318, 38092256692235616, 225157412, 225157420, 8, 1440x900 
0x37CA2318, 38092256692897496, 225157478, 225157486, 8, 1440x900 
0x37CA2318, 38092256693555616, 225157542, 225157552, 10, 1440x900 
0x37CA2318, 38092256694209760, 225157607, 225157614, 7, 1440x900 
0x37CA2318, 38092256694880848, 225157673, 225157682, 9, 1440x900 
0x37CA2318, 38092256695535520, 225157743, 225157751, 8, 1440x900 
0x37CA2318, 38092256696204976, 225157809, 225157817, 8, 1440x900 
0x37CA2318, 38092256696875104, 225157873, 225157884, 11, 1440x900 
0x37CA2318, 38092256697526288, 225157942, 225157950, 8, 1440x900 
0x37CA2318, 38092256698187440, 225158007, 225158016, 9, 1440x900 
0x37CA2318, 38092256698857600, 225158074, 225158083, 9, 1440x900 
0x37CA2318, 38092256699511920, 225158142, 225158149, 7, 1440x900 
0x37CA2318, 38092256700169568, 225158203, 225158211, 8, 1440x900 
0x37CA2318, 38092256700830208, 225158273, 225158281, 8, 1440x900 
0x37CA2318, 38092256701486016, 225158338, 225158346, 8, 1440x900 
0x37CA2318, 38092256702155712, 225158407, 225158415, 8, 1440x900 
0x37CA2318, 38092256702817560, 225158473, 225158481, 8, 1440x900 
0x37CA2318, 38092256703469400, 225158538, 225158546, 8, 1440x900 
0x37CA2318, 38092256704139040, 225158602, 225158610, 8, 1440x900 
0x37CA2318, 38092256704801520, 225158706, 225158724, 18, 1440x900 
0x37CA2318, 38092256705649560, 225158752, 225158759, 7, 1440x900 
0x37CA2318, 38092256706300248, 225158816, 225158823, 7, 1440x900 
0x37CA2318, 38092256706961784, 225158883, 225158891, 8, 1440x900 
0x37CA2318, 38092256707561144, 225158948, 225158956, 8, 1440x900 
0x37CA2318, 38092256708259096, 225159017, 225159025, 8, 1440x900 
0x37CA2318, 38092256708758656, 225159062, 225159069, 7, 1440x900 
0x37CA2318, 38092256709419352, 225159128, 225159136, 8, 1440x900 
0x37CA2318, 38092256710078856, 225159193, 225159201, 8, 1440x900 
0x37CA2318, 38092256710738600, 225159261, 225159269, 8, 1440x900 
0x37CA2318, 38092256711399600, 225159327, 225159335, 8, 1440x900 
0x37CA2318, 38092256712065632, 225159398, 225159410, 12, 1440x900 
0x37CA2318, 38092256712745104, 225159462, 225159471, 9, 1440x900 
0x37CA2318, 38092256713928304, 225159587, 225159599, 12, 1440x900 
0x37CA2318, 38092256714443472, 225159632, 225159641, 9, 1440x900 
0x37CA2318, 38092256715092384, 225159697, 225159704, 7, 1440x900 
0x37CA2318, 38092256715748040, 225159761, 225159769, 8, 1440x900 
0x37CA2318, 38092256716409968, 225159828, 225159836, 8, 1440x900 
0x37CA2318, 38092256717079168, 225159898, 225159906, 8, 1440x900 
0x37CA2318, 38092256717737224, 225159962, 225159971, 9, 1440x900 
0x37CA2318, 38092256718396976, 225160027, 225160035, 8, 1440x900 
0x37CA2318, 38092256719253224, 225160113, 225160121, 8, 1440x900 
0x37CA2318, 38092256719721912, 225160158, 225160168, 10, 1440x900 
0x37CA2318, 38092256720377336, 225160228, 225160236, 8, 1440x900 
0x37CA2318, 38092256721049952, 225160292, 225160301, 9, 1440x900 
0x37CA2318, 38092256721709432, 225160357, 225160366, 9, 1440x900 
0x37CA2318, 38092256722369680, 225160423, 225160432, 9, 1440x900 
0x37CA2318, 38092256723028520, 225160494, 225160502, 8, 1440x900 
0x37CA2318, 38092256723688728, 225160558, 225160566, 8, 1440x900 
0x37CA2318, 38092256724351864, 225160624, 225160633, 9, 1440x900 
0x37CA2318, 38092256725009448, 225160688, 225160695, 7, 1440x900 
0x37CA2318, 38092256725670368, 225160754, 225160762, 8, 1440x900 
0x37CA2318, 38092256726333128, 225160823, 225160831, 8, 1440x900 
0x37CA2318, 38092256727200400, 225160912, 225160920, 8, 1440x900 
0x37CA2318, 38092256727851264, 225160977, 225160985, 8, 1440x900 
0x37CA2318, 38092256728316760, 225161022, 225161030, 8, 1440x900 
0x37CA2318, 38092256728977840, 225161089, 225161097, 8, 1440x900 
0x37CA2318, 38092256729842672, 225161173, 225161181, 8, 1440x900 
0x37CA2318, 38092256730494472, 225161239, 225161248, 9, 1440x900 
0x37CA2318, 38092256731155792, 225161303, 225161312, 9, 1440x900 
0x37CA2318, 38092256731630320, 225161352, 225161361, 9, 1440x900 
0x37CA2318, 38092256732277920, 225161413, 225161421, 8, 1440x900 
0x37CA2318, 38092256733137496, 225161504, 225161512, 8, 1440x900 
0x37CA2318, 38092256733807456, 225161572, 225161580, 8, 1440x900 
0x37CA2318, 38092256734261856, 225161613, 225161620, 7, 1440x900 
0x37CA2318, 38092256734923136, 225161677, 225161685, 8, 1440x900 
0x37CA2318, 38092256735789320, 225161768, 225161777, 9, 1440x900 
0x37CA2318, 38092256736443952, 225161829, 225161838, 9, 1440x900 
0x37CA2318, 38092256737114456, 225161898, 225161907, 9, 1440x900 
0x37CA2318, 38092256737774976, 225161967, 225161975, 8, 1440x900 
0x37CA2318, 38092256738428848, 225162032, 225162041, 9, 1440x900 
0x37CA2318, 38092256739088864, 225162093, 225162101, 8, 1440x900 
0x37CA2318, 38092256739746512, 225162161, 225162168, 7, 1440x900 
0x37CA2318, 38092256740239888, 225162208, 225162216, 8, 1440x900 
0x37CA2318, 38092256740912904, 225162277, 225162284, 7, 1440x900 
0x37CA2318, 38092256741531312, 225162339, 225162348, 9, 1440x900 
0x37CA2318, 38092256742209608, 225162407, 225162415, 8, 1440x900 
0x37CA2318, 38092256742861632, 225162472, 225162490, 18, 1440x900 
0x37CA2318, 38092256743550664, 225162542, 225162552, 10, 1440x900 
0x37CA2318, 38092256744179960, 225162603, 225162612, 9, 1440x900 
0x37CA2318, 38092256744839800, 225162672, 225162679, 7, 1440x900 
0x37CA2318, 38092256745506288, 225162737, 225162744, 7, 1440x900 
0x37CA2318, 38092256746194832, 225162808, 225162814, 6, 1440x900 
0x37CA2318, 38092256746832928, 225162868, 225162876, 8, 1440x900 
0x37CA2318, 38092256747491608, 225162938, 225162945, 7, 1440x900 
0x37CA2318, 38092256748166840, 225163003, 225163010, 7, 1440x900 
0x37CA2318, 38092256748810048, 225163067, 225163075, 8, 1440x900 
0x37CA2318, 38092256749501744, 225163137, 225163147, 10, 1440x900 
0x37CA2318, 38092256750197352, 225163207, 225163214, 7, 1440x900 
0x37CA2318, 38092256750793080, 225163263, 225163270, 7, 1440x900 
0x37CA2318, 38092256751465480, 225163332, 225163339, 7, 1440x900 
0x37CA2318, 38092256752111088, 225163397, 225163403, 6, 1440x900 
0x37CA2318, 38092256752774280, 225163463, 225163470, 7, 1440x900 
0x37CA2318, 38092256753477712, 225163537, 225163548, 11, 1440x900 
0x37CA2318, 38092256754122576, 225163598, 225163607, 9, 1440x900 
0x37CA2318, 38092256754793456, 225163663, 225163671, 8, 1440x900 
0x37CA2318, 38092256755731032, 225163757, 225163769, 12, 1440x900 
0x37CA2318, 38092256756113536, 225163799, 225163809, 10, 1440x900 
0x37CA2318, 38092256756795864, 225163863, 225163871, 8, 1440x900 
0x37CA2318, 38092256757401792, 225163928, 225163935, 7, 1440x900 
0x37CA2318, 38092256758059872, 225163993, 225164002, 9, 1440x900 
0x37CA2318, 38092256758746200, 225164058, 225164065, 7, 1440x900 
0x37CA2318, 38092256759574648, 225164147, 225164154, 7, 1440x900 
0x37CA2318, 38092256760232576, 225164213, 225164220, 7, 1440x900 
0x37CA2318, 38092256760892160, 225164277, 225164284, 7, 1440x900 
0x37CA2318, 38092256761554896, 225164343, 225164349, 6, 1440x900 
0x37CA2318, 38092256762206224, 225164408, 225164415, 7, 1440x900 
0x37CA2318, 38092256762876008, 225164474, 225164482, 8, 1440x900 
0x37CA2318, 38092256763395816, 225164527, 225164535, 8, 1440x900 
0x37CA2318, 38092256764004784, 225164588, 225164598, 10, 1440x900 
0x37CA2318, 38092256764679680, 225164660, 225164668, 8, 1440x900 
0x37CA2318, 38092256765336232, 225164721, 225164731, 10, 1440x900 
0x37CA2318, 38092256766003064, 225164787, 225164802, 15, 1440x900 
0x37CA2318, 38092256766688752, 225164854, 225164865, 11, 1440x900 
0x37CA2318, 38092256767406176, 225164928, 225164936, 8, 1440x900 
0x37CA2318, 38092256768016528, 225164987, 225164995, 8, 1440x900 
0x37CA2318, 38092256768705080, 225165057, 225165074, 17, 1440x900 
0x37CA2318, 38092256769406312, 225165131, 225165143, 12, 1440x900 
0x37CA2318, 38092256770002240, 225165188, 225165202, 14, 1440x900 
0x37CA2318, 38092256770657880, 225165252, 225165261, 9, 1440x900 
0x37CA2318, 38092256771337248, 225165322, 225165334, 12, 1440x900 
0x37CA2318, 38092256771983944, 225165386, 225165394, 8, 1440x900 
0x37CA2318, 38092256772643664, 225165452, 225165461, 9, 1440x900 
0x37CA2318, 38092256773282872, 225165513, 225165520, 7, 1440x900 
0x37CA2318, 38092256774591504, 225165652, 225165684, 32, 1440x900 
0x37CA2318, 38092256775290712, 225165713, 225165731, 18, 1440x900 
0x37CA2318, 38092256775936176, 225165782, 225165790, 8, 1440x900 
0x37CA2318, 38092256776598800, 225165847, 225165856, 9, 1440x900 
0x37CA2318, 38092256777245512, 225165913, 225165921, 8, 1440x900 
0x37CA2318, 38092256777914568, 225165982, 225165990, 8, 1440x900 
0x37CA2318, 38092256778575376, 225166045, 225166054, 9, 1440x900 
0x37CA2318, 38092256779233840, 225166108, 225166119, 11, 1440x900 
0x37CA2318, 38092256779895464, 225166173, 225166186, 13, 1440x900 
0x37CA2318, 38092256780564496, 225166242, 225166253, 11, 1440x900 
0x37CA2318, 38092256781215040, 225166308, 225166319, 11, 1440x900 
0x37CA2318, 38092256781884624, 225166373, 225166385, 12, 1440x900 
0x37CA2318, 38092256782535968, 225166445, 225166454, 9, 1440x900 
0x37CA2318, 38092256783203328, 225166508, 225166518, 10, 1440x900 
0x37CA2318, 38092256783859208, 225166572, 225166587, 15, 1440x900 
0x37CA2318, 38092256784538856, 225166644, 225166655, 11, 1440x900 
0x37CA2318, 38092256785215720, 225166707, 225166723, 16, 1440x900 
0x37CA2318, 38092256785866096, 225166772, 225166780, 8, 1440x900 
0x37CA2318, 38092256786559624, 225166842, 225166861, 19, 1440x900 
0x37CA2318, 38092256787182368, 225166902, 225166911, 9, 1440x900 
0x37CA2318, 38092256787849568, 225166972, 225166981, 9, 1440x900 
0x37CA2318, 38092256788548600, 225167039, 225167056, 17, 1440x900 
0x37CA2318, 38092256789213896, 225167106, 225167120, 14, 1440x900 
0x37CA2318, 38092256789870256, 225167172, 225167180, 8, 1440x900 
0x37CA2318, 38092256790653792, 225167250, 225167268, 18, 1440x900 
0x37CA2318, 38092256791167728, 225167303, 225167312, 9, 1440x900 
0x37CA2318, 38092256791882408, 225167373, 225167384, 11, 1440x900 
0x37CA2318, 38092256792546400, 225167439, 225167448, 9, 1440x900 
0x37CA2318, 38092256793203336, 225167507, 225167514, 7, 1440x900 
0x37CA2318, 38092256793870440, 225167572, 225167582, 10, 1440x900 
0x37CA2318, 38092256794501184, 225167638, 225167647, 9, 1440x900 
0x37CA2318, 38092256795133008, 225167703, 225167711, 8, 1440x900 
0x37CA2318, 38092256795812032, 225167769, 225167778, 9, 1440x900 
0x37CA2318, 38092256796469016, 225167832, 225167840, 8, 1440x900 
0x37CA2318, 38092256797118936, 225167898, 225167905, 7, 1440x900 
0x37CA2318, 38092256797775336, 225167963, 225167971, 8, 1440x900 
0x37CA2318, 38092256798435560, 225168028, 225168036, 8, 1440x900 
0x37CA2318, 38092256799095416, 225168097, 225168104, 7, 1440x900 
0x37CA2318, 38092256799755560, 225168162, 225168169, 7, 1440x900 
0x37CA2318, 38092256800607160, 225168247, 225168255, 8, 1440x900 
0x37CA2318, 38092256801268152, 225168318, 225168326, 8, 1440x900 
0x37CA2318, 38092256801939792, 225168388, 225168396, 8, 1440x900 
0x37CA2318, 38092256802405072, 225168428, 225168437, 9, 1440x900 
0x37CA2318, 38092256803063624, 225168493, 225168501, 8, 1440x900 
0x37CA2318, 38092256803919856, 225168583, 225168592, 9, 1440x900 
0x37CA2318, 38092256804573200, 225168643, 225168651, 8, 1440x900 
0x37CA2318, 38092256805043016, 225168692, 225168700, 8, 1440x900 
0x37CA2318, 38092256805895960, 225168783, 225168791, 8, 1440x900 
0x37CA2318, 38092256806372336, 225168829, 225168838, 9, 1440x900 
0x37CA2318, 38092256807029360, 225168888, 225168896, 8, 1440x900 
0x37CA2318, 38092256807886264, 225168977, 225168985, 8, 1440x900 
0x37CA2318, 38092256808542288, 225169043, 225169051, 8, 1440x900 
0x37CA2318, 38092256809212768, 225169113, 225169121, 8, 1440x900 
0x37CA2318, 38092256809881904, 225169177, 225169185, 8, 1440x900 
0x37CA2318, 38092256810543880, 225169243, 225169251, 8, 1440x900 
0x37CA2318, 38092256811204088, 225169309, 225169318, 9, 1440x900 
0x37CA2318, 38092256811867208, 225169378, 225169386, 8, 1440x900 
0x37CA2318, 38092256812516760, 225169442, 225169450, 8, 1440x900 
0x37CA2318, 38092256813023000, 225169487, 225169495, 8, 1440x900 
0x37CA2318, 38092256813839408, 225169572, 225169580, 8, 1440x900 
0x37CA2318, 38092256814492704, 225169642, 225169650, 8, 1440x900 
0x37CA2318, 38092256815157888, 225169707, 225169715, 8, 1440x900 
0x37CA2318, 38092256815824304, 225169773, 225169782, 9, 1440x900 
0x37CA2318, 38092256816475736, 225169837, 225169846, 9, 1440x900 
0x37CA2318, 38092256817139960, 225169903, 225169911, 8, 1440x900 
0x37CA2318, 38092256817797408, 225169963, 225169971, 8, 1440x900 
0x37CA2318, 38092256818262816, 225170012, 225170020, 8, 1440x900 
0x37CA2318, 38092256819206552, 225170113, 225170126, 13, 1440x900 
0x37CA2318, 38092256819593040, 225170147, 225170154, 7, 1440x900 
0x37CA2318, 38092256820442272, 225170231, 225170253, 22, 1440x900 
0x37CA2318, 38092256821038064, 225170288, 225170299, 11, 1440x900 
0x37CA2318, 38092256821592536, 225170347, 225170354, 7, 1440x900 
0x37CA2318, 38092256822231256, 225170408, 225170417, 9, 1440x900 
0x37CA2318, 38092256822892768, 225170473, 225170481, 8, 1440x900 
0x37CA2318, 38092256823748000, 225170558, 225170566, 8, 1440x900 
0x37CA2318, 38092256824399680, 225170627, 225170634, 7, 1440x900 
0x37CA2318, 38092256825062776, 225170693, 225170700, 7, 1440x900 
0x37CA2318, 38092256825533336, 225170738, 225170746, 8, 1440x900 
0x37CA2318, 38092256826385096, 225170828, 225170837, 9, 1440x900 
0x37CA2318, 38092256827054600, 225170893, 225170901, 8, 1440x900 
0x37CA2318, 38092256827715192, 225170963, 225170971, 8, 1440x900 
0x37CA2318, 38092256828371152, 225171027, 225171035, 8, 1440x900 
0x37CA2318, 38092256829025480, 225171093, 225171101, 8, 1440x900 
0x37CA2318, 38092256829686136, 225171158, 225171166, 8, 1440x900 
0x37CA2318, 38092256830348728, 225171222, 225171231, 9, 1440x900 
0x37CA2318, 38092256831008608, 225171293, 225171301, 8, 1440x900 
0x37CA2318, 38092256831669960, 225171358, 225171366, 8, 1440x900 
0x37CA2318, 38092256832331608, 225171418, 225171426, 8, 1440x900 
0x37CA2318, 38092256833001024, 225171487, 225171496, 9, 1440x900 
0x37CA2318, 38092256833659880, 225171557, 225171565, 8, 1440x900 
0x37CA2318, 38092256834315232, 225171623, 225171631, 8, 1440x900 
0x37CA2318, 38092256834976848, 225171687, 225171695, 8, 1440x900 
0x37CA2318, 38092256835470688, 225171743, 225171751, 8, 1440x900 
0x37CA2318, 38092256836299016, 225171818, 225171826, 8, 1440x900 
0x37CA2318, 38092256836959408, 225171887, 225171895, 8, 1440x900 
0x37CA2318, 38092256837620200, 225171952, 225171961, 9, 1440x900 
0x37CA2318, 38092256838288000, 225172017, 225172023, 6, 1440x900 
0x37CA2318, 38092256838957712, 225172080, 225172087, 7, 1440x900 
0x37CA2318, 38092256839685696, 225172153, 225172161, 8, 1440x900 
0x37CA2318, 38092256840073376, 225172192, 225172199, 7, 1440x900 
0x37CA2318, 38092256840730008, 225172258, 225172266, 8, 1440x900 
0x37CA2318, 38092256841390536, 225172323, 225172331, 8, 1440x900 
0x37CA2318, 38092256842050144, 225172391, 225172398, 7, 1440x900 
0x37CA2318, 38092256842710656, 225172457, 225172464, 7, 1440x900 
0x37CA2318, 38092256843370360, 225172522, 225172529, 7, 1440x900 
0x37CA2318, 38092256844239328, 225172611, 225172619, 8, 1440x900 
0x37CA2318, 38092256844899584, 225172677, 225172684, 7, 1440x900 
0x37CA2318, 38092256845392912, 225172726, 225172733, 7, 1440x900 
0x37CA2318, 38092256846048648, 225172792, 225172800, 8, 1440x900 
0x37CA2318, 38092256846688512, 225172858, 225172865, 7, 1440x900 
0x37CA2318, 38092256847334896, 225172917, 225172926, 9, 1440x900 
0x37CA2318, 38092256848009920, 225172987, 225172994, 7, 1440x900 
0x37CA2318, 38092256848657464, 225173053, 225173059, 6, 1440x900 
0x37CA2318, 38092256849977624, 225173183, 225173191, 8, 1440x900 
0x37CA2318, 38092256850641136, 225173248, 225173256, 8, 1440x900 
0x37CA2318, 38092256851320120, 225173318, 225173325, 7, 1440x900 
0x37CA2318, 38092256851977456, 225173387, 225173394, 7, 1440x900 
0x37CA2318, 38092256852651112, 225173448, 225173457, 9, 1440x900 
0x37CA2318, 38092256853315888, 225173518, 225173526, 8, 1440x900 
0x37CA2318, 38092256853971208, 225173582, 225173589, 7, 1440x900 
0x37CA2318, 38092256854630688, 225173648, 225173656, 8, 1440x900 
0x37CA2318, 38092256855292472, 225173713, 225173721, 8, 1440x900 
0x37CA2318, 38092256855951712, 225173782, 225173789, 7, 1440x900 
0x37CA2318, 38092256856611112, 225173847, 225173854, 7, 1440x900 
0x37CA2318, 38092256857271136, 225173912, 225173920, 8, 1440x900 
0x37CA2318, 38092256857931136, 225173978, 225173986, 8, 1440x900 
0x37CA2318, 38092256858595376, 225174046, 225174053, 7, 1440x900 
0x37CA2318, 38092256859253312, 225174112, 225174120, 8, 1440x900 
0x37CA2318, 38092256859914872, 225174182, 225174190, 8, 1440x900 
0x37CA2318, 38092256860574496, 225174247, 225174255, 8, 1440x900 
0x37CA2318, 38092256861237144, 225174313, 225174321, 8, 1440x900 
0x37CA2318, 38092256861903624, 225174378, 225174386, 8, 1440x900 
0x37CA2318, 38092256862568504, 225174443, 225174450, 7, 1440x900 
0x37CA2318, 38092256863226256, 225174512, 225174519, 7, 1440x900 
0x37CA2318, 38092256863892960, 225174578, 225174585, 7, 1440x900 
0x37CA2318, 38092256864553872, 225174642, 225174649, 7, 1440x900 
0x37CA2318, 38092256865201840, 225174706, 225174713, 7, 1440x900 
0x37CA2318, 38092256865862416, 225174772, 225174779, 7, 1440x900 
0x37CA2318, 38092256866521840, 225174838, 225174846, 8, 1440x900 
0x37CA2318, 38092256867184952, 225174907, 225174914, 7, 1440x900 
0x37CA2318, 38092256867847104, 225174973, 225174981, 8, 1440x900 
0x37CA2318, 38092256868505816, 225175037, 225175044, 7, 1440x900 
0x37CA2318, 38092256869164560, 225175103, 225175110, 7, 1440x900 
0x37CA2318, 38092256869822168, 225175168, 225175176, 8, 1440x900 
0x37CA2318, 38092256870492456, 225175233, 225175241, 8, 1440x900 
0x37CA2318, 38092256871152576, 225175302, 225175309, 7, 1440x900 
0x37CA2318, 38092256871813880, 225175367, 225175374, 7, 1440x900 
0x37CA2318, 38092256872472504, 225175432, 225175440, 8, 1440x900 
0x37CA2318, 38092256873132160, 225175498, 225175505, 7, 1440x900 
0x37CA2318, 38092256873792984, 225175563, 225175571, 8, 1440x900 
0x37CA2318, 38092256874452304, 225175631, 225175638, 7, 1440x900 
0x37CA2318, 38092256875112576, 225175697, 225175704, 7, 1440x900 
0x37CA2318, 38092256875773264, 225175762, 225175770, 8, 1440x900 
0x37CA2318, 38092256876432888, 225175828, 225175836, 8, 1440x900 
0x37CA2318, 38092256877094504, 225175896, 225175903, 7, 1440x900 
0x37CA2318, 38092256877752472, 225175962, 225175969, 7, 1440x900 
0x37CA2318, 38092256878412424, 225176027, 225176034, 7, 1440x900 
0x37CA2318, 38092256879087176, 225176092, 225176100, 8, 1440x900 
0x37CA2318, 38092256879751808, 225176162, 225176169, 7, 1440x900 
0x37CA2318, 38092256880416696, 225176228, 225176235, 7, 1440x900 
0x37CA2318, 38092256881072032, 225176293, 225176300, 7, 1440x900 
0x37CA2318, 38092256881741616, 225176362, 225176369, 7, 1440x900 
0x37CA2318, 38092256882399616, 225176427, 225176434, 7, 1440x900 
0x37CA2318, 38092256883059480, 225176492, 225176499, 7, 1440x900 
0x37CA2318, 38092256883721432, 225176558, 225176566, 8, 1440x900 
0x37CA2318, 38092256884381520, 225176623, 225176631, 8, 1440x900 
0x37CA2318, 38092256885041448, 225176691, 225176699, 8, 1440x900 
0x37CA2318, 38092256885905128, 225176782, 225176790, 8, 1440x900 
0x37CA2318, 38092256886371128, 225176828, 225176837, 9, 1440x900 
0x37CA2318, 38092256887043304, 225176898, 225176906, 8, 1440x900 
0x37CA2318, 38092256887696248, 225176963, 225176971, 8, 1440x900 
0x37CA2318, 38092256888351216, 225177019, 225177027, 8, 1440x900 
0x37CA2318, 38092256889015808, 225177085, 225177093, 8, 1440x900 
0x37CA2318, 38092256889671128, 225177152, 225177160, 8, 1440x900 
0x37CA2318, 38092256890537792, 225177238, 225177246, 8, 1440x900 
0x37CA2318, 38092256891189976, 225177303, 225177311, 8, 1440x900 
0x37CA2318, 38092256891850136, 225177372, 225177379, 7, 1440x900 
0x37CA2318, 38092256892511792, 225177438, 225177446, 8, 1440x900 
0x37CA2318, 38092256893180152, 225177507, 225177515, 8, 1440x900 
0x37CA2318, 38092256893839840, 225177573, 225177580, 7, 1440x900 
0x37CA2318, 38092256894491688, 225177638, 225177645, 7, 1440x900 
0x37CA2318, 38092256895153088, 225177703, 225177711, 8, 1440x900 
0x37CA2318, 38092256895808160, 225177768, 225177777, 9, 1440x900 
0x37CA2318, 38092256896470184, 225177837, 225177846, 9, 1440x900 
0x37CA2318, 38092256897149136, 225177903, 225177912, 9, 1440x900 
0x37CA2318, 38092256897809408, 225177972, 225177980, 8, 1440x900 
0x37CA2318, 38092256898273928, 225178017, 225178025, 8, 1440x900 
0x37CA2318, 38092256898930640, 225178078, 225178086, 8, 1440x900 
0x37CA2318, 38092256899784880, 225178169, 225178177, 8, 1440x900 
0x37CA2318, 38092256900444912, 225178232, 225178239, 7, 1440x900 
0x37CA2318, 38092256901107680, 225178302, 225178310, 8, 1440x900 
0x37CA2318, 38092256901769608, 225178368, 225178376, 8, 1440x900 
0x37CA2318, 38092256902439760, 225178433, 225178441, 8, 1440x900 
0x37CA2318, 38092256903089968, 225178497, 225178505, 8, 1440x900 
0x37CA2318, 38092256903751544, 225178563, 225178571, 8, 1440x900 
0x37CA2318, 38092256904406072, 225178629, 225178638, 9, 1440x900 
0x37CA2318, 38092256905077208, 225178698, 225178706, 8, 1440x900 
0x37CA2318, 38092256905740672, 225178762, 225178770, 8, 1440x900 
0x37CA2318, 38092256906396248, 225178832, 225178840, 8, 1440x900 
0x37CA2318, 38092256907055936, 225178893, 225178902, 9, 1440x900 
0x37CA2318, 38092256907715176, 225178963, 225178971, 8, 1440x900 
0x37CA2318, 38092256908375840, 225179027, 225179035, 8, 1440x900 
0x37CA2318, 38092256909036800, 225179093, 225179101, 8, 1440x900 
0x37CA2318, 38092256909688880, 225179158, 225179166, 8, 1440x900 
0x37CA2318, 38092256910360544, 225179227, 225179235, 8, 1440x900 
0x37CA2318, 38092256911030224, 225179292, 225179299, 7, 1440x900 
0x37CA2318, 38092256911679792, 225179353, 225179361, 8, 1440x900 
0x37CA2318, 38092256912342256, 225179423, 225179431, 8, 1440x900 
0x37CA2318, 38092256913003640, 225179487, 225179495, 8, 1440x900 
0x37CA2318, 38092256913658784, 225179558, 225179566, 8, 1440x900 
0x37CA2318, 38092256914332744, 225179623, 225179631, 8, 1440x900 
0x37CA2318, 38092256914999952, 225179688, 225179696, 8, 1440x900 
0x37CA2318, 38092256915650888, 225179753, 225179761, 8, 1440x900 
0x37CA2318, 38092256916312376, 225179822, 225179830, 8, 1440x900 
0x37CA2318, 38092256916964560, 225179883, 225179892, 9, 1440x900 
0x37CA2318, 38092256917626152, 225179953, 225179961, 8, 1440x900 
0x37CA2318, 38092256918298176, 225180018, 225180026, 8, 1440x900 
0x37CA2318, 38092256918950384, 225180083, 225180091, 8, 1440x900 
0x37CA2318, 38092256919621136, 225180148, 225180158, 10, 1440x900 
0x37CA2318, 38092256920290888, 225180218, 225180226, 8, 1440x900 
0x37CA2318, 38092256920942720, 225180283, 225180291, 8, 1440x900 
0x37CA2318, 38092256921601488, 225180347, 225180354, 7, 1440x900 
0x37CA2318, 38092256922256032, 225180413, 225180421, 8, 1440x900 
0x37CA2318, 38092256922922840, 225180483, 225180491, 8, 1440x900 
0x37CA2318, 38092256923583792, 225180548, 225180557, 9, 1440x900 
0x37CA2318, 38092256924246400, 225180618, 225180626, 8, 1440x900 
0x37CA2318, 38092256924903632, 225180678, 225180686, 8, 1440x900 
0x37CA2318, 38092256925558904, 225180743, 225180752, 9, 1440x900 
0x37CA2318, 38092256926221048, 225180813, 225180821, 8, 1440x900 
0x37CA2318, 38092256926900848, 225180879, 225180888, 9, 1440x900 
0x37CA2318, 38092256927558096, 225180947, 225180955, 8, 1440x900 
0x37CA2318, 38092256928218376, 225181008, 225181017, 9, 1440x900 
0x37CA2318, 38092256928879296, 225181079, 225181088, 9, 1440x900 
0x37CA2318, 38092256929548536, 225181142, 225181149, 7, 1440x900 
0x37CA2318, 38092256930200328, 225181207, 225181215, 8, 1440x900 
0x37CA2318, 38092256930861192, 225181272, 225181279, 7, 1440x900 
0x37CA2318, 38092256931522328, 225181338, 225181346, 8, 1440x900 
0x37CA2318, 38092256932183032, 225181408, 225181416, 8, 1440x900 
0x37CA2318, 38092256932843024, 225181472, 225181481, 9, 1440x900 
0x37CA2318, 38092256933512640, 225181544, 225181552, 8, 1440x900 
0x37CA2318, 38092256934165360, 225181609, 225181619, 10, 1440x900 
0x37CA2318, 38092256935287792, 225181717, 225181725, 8, 1440x900 
0x37CA2318, 38092256935961000, 225181782, 225181790, 8, 1440x900 
0x37CA2318, 38092256936615384, 225181847, 225181855, 8, 1440x900 
0x37CA2318, 38092256937271584, 225181913, 225181920, 7, 1440x900 
0x37CA2318, 38092256937931408, 225181978, 225181986, 8, 1440x900 
0x37CA2318, 38092256938593416, 225182043, 225182051, 8, 1440x900 
0x37CA2318, 38092256939256168, 225182112, 225182119, 7, 1440x900 
0x37CA2318, 38092256939916824, 225182178, 225182185, 7, 1440x900 
0x37CA2318, 38092256940578352, 225182243, 225182251, 8, 1440x900 
0x37CA2318, 38092256941439992, 225182331, 225182339, 8, 1440x900 
0x37CA2318, 38092256942092576, 225182397, 225182405, 8, 1440x900 
0x37CA2318, 38092256942561336, 225182442, 225182450, 8, 1440x900 
0x37CA2318, 38092256943404504, 225182527, 225182536, 9, 1440x900 
0x37CA2318, 38092256943957728, 225182588, 225182596, 8, 1440x900 
0x37CA2318, 38092256944542040, 225182644, 225182652, 8, 1440x900 
0x37CA2318, 38092256945200600, 225182707, 225182716, 9, 1440x900 
0x37CA2318, 38092256945860496, 225182773, 225182782, 9, 1440x900 
0x37CA2318, 38092256946520856, 225182842, 225182851, 9, 1440x900 
0x37CA2318, 38092256947180624, 225182909, 225182916, 7, 1440x900 
0x37CA2318, 38092256947840640, 225182974, 225182982, 8, 1440x900 
0x37CA2318, 38092256948695376, 225183057, 225183065, 8, 1440x900 
0x37CA2318, 38092256949356112, 225183127, 225183135, 8, 1440x900 
0x37CA2318, 38092256950016448, 225183192, 225183200, 8, 1440x900 
0x37CA2318, 38092256950678000, 225183258, 225183266, 8, 1440x900 
0x37CA2318, 38092256951339008, 225183323, 225183331, 8, 1440x900 
0x37CA2318, 38092256951992768, 225183387, 225183396, 9, 1440x900 
0x37CA2318, 38092256952663032, 225183457, 225183465, 8, 1440x900 
0x37CA2318, 38092256953323992, 225183518, 225183526, 8, 1440x900 
0x37CA2318, 38092256953984064, 225183584, 225183591, 7, 1440x900 
0x37CA2318, 38092256954651032, 225183653, 225183662, 9, 1440x900 
0x37CA2318, 38092256955116616, 225183706, 225183715, 9, 1440x900 
0x37CA2318, 38092256955773800, 225183763, 225183770, 7, 1440x900 
0x37CA2318, 38092256956429024, 225183828, 225183836, 8, 1440x900 
0x37CA2318, 38092256957091536, 225183897, 225183905, 8, 1440x900 
0x37CA2318, 38092256957765808, 225183968, 225183976, 8, 1440x900 
0x37CA2318, 38092256958422208, 225184028, 225184036, 8, 1440x900 
0x37CA2318, 38092256959083744, 225184098, 225184106, 8, 1440x900 
0x37CA2318, 38092256959932992, 225184182, 225184190, 8, 1440x900 
0x37CA2318, 38092256960602472, 225184248, 225184256, 8, 1440x900 
0x37CA2318, 38092256961254208, 225184313, 225184322, 9, 1440x900 
0x37CA2318, 38092256961733832, 225184364, 225184371, 7, 1440x900 
0x37CA2318, 38092256962381456, 225184428, 225184437, 9, 1440x900 
0x37CA2318, 38092256963049144, 225184492, 225184501, 9, 1440x900 
0x37CA2318, 38092256963710736, 225184556, 225184563, 7, 1440x900 
0x37CA2318, 38092256964369496, 225184622, 225184629, 7, 1440x900 
0x37CA2318, 38092256965027616, 225184689, 225184695, 6, 1440x900 
0x37CA2318, 38092256965685576, 225184753, 225184761, 8, 1440x900 
0x37CA2318, 38092256966345632, 225184822, 225184829, 7, 1440x900 
0x37CA2318, 38092256967011216, 225184888, 225184894, 6, 1440x900 
0x37CA2318, 38092256967679464, 225184953, 225184961, 8, 1440x900 
0x37CA2318, 38092256968335376, 225185021, 225185028, 7, 1440x900 
0x37CA2318, 38092256968999936, 225185087, 225185095, 8, 1440x900 
0x37CA2318, 38092256969668496, 225185153, 225185160, 7, 1440x900 
0x37CA2318, 38092256970318760, 225185217, 225185225, 8, 1440x900 
0x37CA2318, 38092256971175768, 225185303, 225185310, 7, 1440x900 
0x37CA2318, 38092256971826776, 225185368, 225185375, 7, 1440x900 
0x37CA2318, 38092256972497624, 225185437, 225185444, 7, 1440x900 
0x37CA2318, 38092256973168200, 225185504, 225185513, 9, 1440x900 
0x37CA2318, 38092256973818064, 225185572, 225185580, 8, 1440x900 
0x37CA2318, 38092256974487136, 225185633, 225185641, 8, 1440x900 
0x37CA2318, 38092256975150240, 225185703, 225185743, 40, 1440x900 
0x37CA2318, 38092256975971888, 225185791, 225185798, 7, 1440x900 
0x37CA2318, 38092256976499272, 225185837, 225185844, 7, 1440x900 
0x37CA2318, 38092256976963824, 225185882, 225185889, 7, 1440x900 
0x37CA2318, 38092256977813680, 225185967, 225185974, 7, 1440x900 
0x37CA2318, 38092256978478408, 225186033, 225186041, 8, 1440x900 
0x37CA2318, 38092256979150168, 225186107, 225186115, 8, 1440x900 
0x37CA2318, 38092256979801680, 225186168, 225186177, 9, 1440x900 
0x37CA2318, 38092256980267456, 225186214, 225186223, 9, 1440x900 
0x37CA2318, 38092256980927464, 225186282, 225186290, 8, 1440x900 
0x37CA2318, 38092256981594672, 225186347, 225186356, 9, 1440x900 
0x37CA2318, 38092256982257928, 225186412, 225186420, 8, 1440x900 
0x37CA2318, 38092256982915576, 225186482, 225186490, 8, 1440x900 
0x37CA2318, 38092256983574904, 225186543, 225186551, 8, 1440x900 
0x37CA2318, 38092256984247456, 225186612, 225186619, 7, 1440x900 
0x37CA2318, 38092256984895952, 225186678, 225186685, 7, 1440x900 
0x37CA2318, 38092256985555232, 225186746, 225186754, 8, 1440x900 
0x37CA2318, 38092256986216176, 225186808, 225186816, 8, 1440x900 
0x37CA2318, 38092256986876344, 225186873, 225186881, 8, 1440x900 
0x37CA2318, 38092256987538272, 225186943, 225186950, 7, 1440x900 
0x37CA2318, 38092256988197632, 225187004, 225187018, 14, 1440x900 
0x37CA2318, 38092256988861528, 225187085, 225187092, 7, 1440x900 
0x37CA2318, 38092256989885552, 225187178, 225187185, 7, 1440x900 
0x37CA2318, 38092256990600104, 225187250, 225187260, 10, 1440x900 
0x37CA2318, 38092256991145480, 225187306, 225187314, 8, 1440x900 
0x37CA2318, 38092256991800944, 225187368, 225187376, 8, 1440x900 
0x37CA2318, 38092256992458416, 225187433, 225187441, 8, 1440x900 
0x37CA2318, 38092256993116256, 225187497, 225187505, 8, 1440x900 
0x37CA2318, 38092256993786448, 225187563, 225187571, 8, 1440x900 
0x37CA2318, 38092256994447768, 225187632, 225187639, 7, 1440x900 
0x37CA2318, 38092256995106768, 225187697, 225187705, 8, 1440x900 
0x37CA2318, 38092256995767480, 225187762, 225187769, 7, 1440x900 
0x37CA2318, 38092256996432672, 225187827, 225187835, 8, 1440x900 
0x37CA2318, 38092256997102536, 225187907, 225187917, 10, 1440x900 
0x37CA2318, 38092256997938480, 225188003, 225188017, 14, 1440x900 
0x37CA2318, 38092256998539392, 225188047, 225188057, 10, 1440x900 
0x37CA2318, 38092256999093512, 225188097, 225188105, 8, 1440x900 
0x37CA2318, 38092256999760648, 225188163, 225188171, 8, 1440x900 
0x37CA2318, 38092257000414872, 225188227, 225188235, 8, 1440x900 
0x37CA2318, 38092257001078128, 225188293, 225188301, 8, 1440x900 
0x37CA2318, 38092257001746208, 225188362, 225188369, 7, 1440x900 
0x37CA2318, 38092257002401384, 225188427, 225188435, 8, 1440x900 
0x37CA2318, 38092257003139520, 225188507, 225188517, 10, 1440x900 
0x37CA2318, 38092257003820064, 225188568, 225188578, 10, 1440x900 
0x37CA2318, 38092257004446344, 225188629, 225188637, 8, 1440x900 
0x37CA2318, 38092257005110024, 225188697, 225188705, 8, 1440x900 
0x37CA2318, 38092257005789600, 225188768, 225188778, 10, 1440x900 
0x37CA2318, 38092257006443544, 225188832, 225188841, 9, 1440x900 
0x37CA2318, 38092257007093928, 225188896, 225188904, 8, 1440x900 
0x37CA2318, 38092257007747584, 225188958, 225188967, 9, 1440x900 
0x37CA2318, 38092257008413704, 225189027, 225189034, 7, 1440x900 
0x37CA2318, 38092257009078224, 225189093, 225189101, 8, 1440x900 
0x37CA2318, 38092257009739920, 225189162, 225189169, 7, 1440x900 
0x37CA2318, 38092257010393872, 225189227, 225189234, 7, 1440x900 
0x37CA2318, 38092257011060992, 225189293, 225189300, 7, 1440x900 
0x37CA2318, 38092257011714296, 225189358, 225189365, 7, 1440x900 
0x37CA2318, 38092257012387072, 225189427, 225189434, 7, 1440x900 
0x37CA2318, 38092257013107008, 225189498, 225189506, 8, 1440x900 
0x37CA2318, 38092257013789488, 225189563, 225189574, 11, 1440x900 
0x37CA2318, 38092257014453656, 225189630, 225189639, 9, 1440x900 
0x37CA2318, 38092257015147136, 225189699, 225189709, 10, 1440x900 
0x37CA2318, 38092257015790464, 225189768, 225189779, 11, 1440x900 
0x37CA2318, 38092257016487592, 225189837, 225189845, 8, 1440x900 
0x37CA2318, 38092257017292424, 225189913, 225189922, 9, 1440x900 
0x37CA2318, 38092257017755032, 225189959, 225189968, 9, 1440x900 
0x37CA2318, 38092257018414984, 225190027, 225190036, 9, 1440x900 
0x37CA2318, 38092257019074208, 225190093, 225190101, 8, 1440x900 
0x37CA2318, 38092257019740384, 225190158, 225190166, 8, 1440x900 
0x37CA2318, 38092257020400344, 225190226, 225190233, 7, 1440x900 
0x37CA2318, 38092257021062304, 225190292, 225190299, 7, 1440x900 
0x37CA2318, 38092257021722696, 225190357, 225190365, 8, 1440x900 
0x37CA2318, 38092257022382496, 225190423, 225190431, 8, 1440x900 
0x37CA2318, 38092257023042832, 225190488, 225190496, 8, 1440x900 
0x37CA2318, 38092257023702384, 225190556, 225190563, 7, 1440x900 
0x37CA2318, 38092257024362328, 225190622, 225190630, 8, 1440x900 
0x37CA2318, 38092257025022592, 225190687, 225190695, 8, 1440x900 
0x37CA2318, 38092257025690568, 225190754, 225190762, 8, 1440x900 
0x37CA2318, 38092257026353824, 225190822, 225190829, 7, 1440x900 
0x37CA2318, 38092257027010536, 225190887, 225190894, 7, 1440x900 
0x37CA2318, 38092257027680528, 225190953, 225190961, 8, 1440x900 
0x37CA2318, 38092257028339848, 225191022, 225191029, 7, 1440x900 
0x37CA2318, 38092257028999304, 225191087, 225191094, 7, 1440x900 
0x37CA2318, 38092257029741624, 225191162, 225191170, 8, 1440x900 
0x37CA2318, 38092257030319984, 225191217, 225191225, 8, 1440x900 
0x37CA2318, 38092257030979792, 225191283, 225191291, 8, 1440x900 
0x37CA2318, 38092257031639616, 225191348, 225191356, 8, 1440x900 
0x37CA2318, 38092257032311056, 225191417, 225191424, 7, 1440x900 
0x37CA2318, 38092257032970072, 225191483, 225191490, 7, 1440x900 
0x37CA2318, 38092257033795192, 225191567, 225191576, 9, 1440x900 
0x37CA2318, 38092257034500664, 225191637, 225191644, 7, 1440x900 
0x37CA2318, 38092257034964272, 225191683, 225191690, 7, 1440x900 
0x37CA2318, 38092257035624496, 225191747, 225191755, 8, 1440x900 
0x37CA2318, 38092257036284280, 225191813, 225191821, 8, 1440x900 
0x37CA2318, 38092257036942672, 225191879, 225191887, 8, 1440x900 
0x37CA2318, 38092257037765208, 225191963, 225191972, 9, 1440x900 
0x37CA2318, 38092257038274448, 225192013, 225192019, 6, 1440x900 
0x37CA2318, 38092257038934672, 225192078, 225192085, 7, 1440x900 
0x37CA2318, 38092257039595128, 225192144, 225192152, 8, 1440x900 
0x37CA2318, 38092257040254608, 225192213, 225192220, 7, 1440x900 
0x37CA2318, 38092257040914392, 225192278, 225192285, 7, 1440x900 
0x37CA2318, 38092257041766200, 225192363, 225192369, 6, 1440x900 
0x37CA2318, 38092257042445472, 225192432, 225192439, 7, 1440x900 
0x37CA2318, 38092257043104896, 225192497, 225192504, 7, 1440x900 
0x37CA2318, 38092257043774432, 225192562, 225192570, 8, 1440x900 
0x37CA2318, 38092257044443768, 225192628, 225192636, 8, 1440x900 
0x37CA2318, 38092257045113688, 225192699, 225192707, 8, 1440x900 
0x37CA2318, 38092257045772952, 225192762, 225192769, 7, 1440x900 
0x37CA2318, 38092257046434048, 225192833, 225192842, 9, 1440x900 
0x37CA2318, 38092257046953760, 225192881, 225192889, 8, 1440x900 
0x37CA2318, 38092257047550808, 225192940, 225192948, 8, 1440x900 
0x37CA2318, 38092257048210416, 225193007, 225193015, 8, 1440x900 
0x37CA2318, 38092257049079440, 225193092, 225193100, 8, 1440x900 
0x37CA2318, 38092257049739264, 225193157, 225193165, 8, 1440x900 
0x37CA2318, 38092257050408672, 225193227, 225193234, 7, 1440x900 
0x37CA2318, 38092257051068056, 225193293, 225193300, 7, 1440x900 
0x37CA2318, 38092257051729352, 225193363, 225193370, 7, 1440x900 
0x37CA2318, 38092257052389280, 225193423, 225193431, 8, 1440x900 
0x37CA2318, 38092257053058960, 225193492, 225193499, 7, 1440x900 
0x37CA2318, 38092257053711184, 225193557, 225193565, 8, 1440x900 
0x37CA2318, 38092257054369608, 225193623, 225193631, 8, 1440x900 
0x37CA2318, 38092257055031488, 225193688, 225193696, 8, 1440x900 
0x37CA2318, 38092257055690912, 225193753, 225193761, 8, 1440x900 
0x37CA2318, 38092257056360512, 225193822, 225193829, 7, 1440x900 
0x37CA2318, 38092257057011384, 225193888, 225193896, 8, 1440x900 
0x37CA2318, 38092257057682696, 225193958, 225193966, 8, 1440x900 
0x37CA2318, 38092257058333032, 225194018, 225194026, 8, 1440x900 
0x37CA2318, 38092257059001416, 225194088, 225194096, 8, 1440x900 
0x37CA2318, 38092257059653096, 225194152, 225194160, 8, 1440x900 
0x37CA2318, 38092257060315464, 225194218, 225194227, 9, 1440x900 
0x37CA2318, 38092257060976480, 225194287, 225194295, 8, 1440x900 
0x37CA2318, 38092257061636560, 225194352, 225194360, 8, 1440x900 
0x37CA2318, 38092257062290416, 225194418, 225194425, 7, 1440x900 
0x37CA2318, 38092257062961720, 225194483, 225194490, 7, 1440x900 
0x37CA2318, 38092257063624544, 225194554, 225194561, 7, 1440x900 
0x37CA2318, 38092257064290496, 225194618, 225194626, 8, 1440x900 
0x37CA2318, 38092257064950248, 225194683, 225194690, 7, 1440x900 
0x37CA2318, 38092257065619008, 225194748, 225194755, 7, 1440x900 
0x37CA2318, 38092257066280784, 225194818, 225194826, 8, 1440x900 
0x37CA2318, 38092257066940688, 225194883, 225194891, 8, 1440x900 
0x37CA2318, 38092257067590808, 225194943, 225194951, 8, 1440x900 
0x37CA2318, 38092257068118120, 225195003, 225195011, 8, 1440x900 
0x37CA2318, 38092257068821192, 225195072, 225195079, 7, 1440x900 
0x37CA2318, 38092257070035472, 225195187, 225195195, 8, 1440x900 
0x37CA2318, 38092257070833056, 225195273, 225195281, 8, 1440x900 
0x37CA2318, 38092257071366336, 225195324, 225195333, 9, 1440x900 
0x37CA2318, 38092257072025096, 225195388, 225195396, 8, 1440x900 
0x37CA2318, 38092257072684848, 225195453, 225195461, 8, 1440x900 
0x37CA2318, 38092257073553232, 225195543, 225195551, 8, 1440x900 
0x37CA2318, 38092257074014760, 225195587, 225195595, 8, 1440x900 
0x37CA2318, 38092257074682096, 225195653, 225195661, 8, 1440x900 
0x37CA2318, 38092257075344104, 225195721, 225195728, 7, 1440x900 
0x37CA2318, 38092257076000000, 225195784, 225195792, 8, 1440x900 
0x37CA2318, 38092257076662440, 225195853, 225195861, 8, 1440x900 
0x37CA2318, 38092257077320984, 225195918, 225195926, 8, 1440x900 
0x37CA2318, 38092257077989696, 225195988, 225195997, 9, 1440x900 
0x37CA2318, 38092257078648304, 225196058, 225196066, 8, 1440x900 
0x37CA2318, 38092257079304504, 225196122, 225196130, 8, 1440x900 
0x37CA2318, 38092257080197896, 225196217, 225196235, 18, 1440x900 
0x37CA2318, 38092257080860432, 225196272, 225196279, 7, 1440x900 
0x37CA2318, 38092257081524600, 225196338, 225196345, 7, 1440x900 
0x37CA2318, 38092257082189552, 225196403, 225196411, 8, 1440x900 
0x37CA2318, 38092257082846608, 225196472, 225196479, 7, 1440x900 
0x37CA2318, 38092257083507312, 225196538, 225196545, 7, 1440x900 
0x37CA2318, 38092257084165536, 225196602, 225196610, 8, 1440x900 
0x37CA2318, 38092257084827272, 225196668, 225196675, 7, 1440x900 
0x37CA2318, 38092257085487896, 225196737, 225196745, 8, 1440x900 
0x37CA2318, 38092257086151416, 225196802, 225196810, 8, 1440x900 
0x37CA2318, 38092257086850416, 225196894, 225196904, 10, 1440x900 
0x37CA2318, 38092257087507728, 225196937, 225196944, 7, 1440x900 
0x37CA2318, 38092257088171800, 225197004, 225197011, 7, 1440x900 
0x37CA2318, 38092257088827696, 225197070, 225197077, 7, 1440x900 
0x37CA2318, 38092257089487416, 225197133, 225197141, 8, 1440x900 
0x37CA2318, 38092257090147248, 225197202, 225197209, 7, 1440x900 
0x37CA2318, 38092257090807248, 225197267, 225197274, 7, 1440x900 
0x37CA2318, 38092257091467504, 225197332, 225197340, 8, 1440x900 
0x37CA2318, 38092257092127496, 225197398, 225197406, 8, 1440x900 
0x37CA2318, 38092257092787896, 225197463, 225197471, 8, 1440x900 
0x37CA2318, 38092257093447656, 225197528, 225197536, 8, 1440x900 
0x37CA2318, 38092257094190400, 225197608, 225197616, 8, 1440x900 
0x37CA2318, 38092257094772528, 225197662, 225197670, 8, 1440x900 
0x37CA2318, 38092257095429600, 225197728, 225197736, 8, 1440x900 
0x37CA2318, 38092257096090248, 225197797, 225197804, 7, 1440x900 
0x37CA2318, 38092257096758944, 225197863, 225197870, 7, 1440x900 
0x37CA2318, 38092257097421952, 225197932, 225197940, 8, 1440x900 
0x37CA2318, 38092257098085448, 225197998, 225198006, 8, 1440x900 
0x37CA2318, 38092257098742864, 225198062, 225198070, 8, 1440x900 
0x37CA2318, 38092257099403376, 225198128, 225198135, 7, 1440x900 
0x37CA2318, 38092257100066480, 225198193, 225198200, 7, 1440x900 
0x37CA2318, 38092257100730072, 225198261, 225198269, 8, 1440x900 
0x37CA2318, 38092257101386368, 225198327, 225198335, 8, 1440x900 
0x37CA2318, 38092257102047712, 225198393, 225198400, 7, 1440x900 
0x37CA2318, 38092257102707992, 225198458, 225198465, 7, 1440x900 
0x37CA2318, 38092257103369576, 225198523, 225198530, 7, 1440x900 
0x37CA2318, 38092257104028080, 225198588, 225198596, 8, 1440x900 
0x37CA2318, 38092257104689120, 225198656, 225198663, 7, 1440x900 
0x37CA2318, 38092257105348960, 225198722, 225198729, 7, 1440x900 
0x37CA2318, 38092257106018912, 225198787, 225198795, 8, 1440x900 
0x37CA2318, 38092257106670592, 225198852, 225198860, 8, 1440x900 
0x37CA2318, 38092257107351608, 225198923, 225198931, 8, 1440x900 
0x37CA2318, 38092257107999936, 225198992, 225199000, 8, 1440x900 
0x37CA2318, 38092257108659616, 225199053, 225199062, 9, 1440x900 
0x37CA2318, 38092257109516512, 225199138, 225199146, 8, 1440x900 
0x37CA2318, 38092257110173016, 225199207, 225199215, 8, 1440x900 
0x37CA2318, 38092257110835592, 225199273, 225199281, 8, 1440x900 
0x37CA2318, 38092257111529200, 225199341, 225199348, 7, 1440x900 
0x37CA2318, 38092257112161008, 225199403, 225199412, 9, 1440x900 
0x37CA2318, 38092257112773424, 225199465, 225199473, 8, 1440x900 
0x37CA2318, 38092257113282944, 225199513, 225199521, 8, 1440x900 
0x37CA2318, 38092257114135856, 225199601, 225199608, 7, 1440x900 
0x37CA2318, 38092257114796928, 225199667, 225199675, 8, 1440x900 
0x37CA2318, 38092257115453200, 225199732, 225199739, 7, 1440x900 
0x37CA2318, 38092257116121632, 225199803, 225199811, 8, 1440x900 
0x37CA2318, 38092257116780288, 225199866, 225199874, 8, 1440x900 
0x37CA2318, 38092257117449704, 225199934, 225199942, 8, 1440x900 
0x37CA2318, 38092257117913408, 225199982, 225199990, 8, 1440x900 
0x37CA2318, 38092257118772296, 225200067, 225200075, 8, 1440x900 
0x37CA2318, 38092257119421384, 225200133, 225200141, 8, 1440x900 
0x37CA2318, 38092257120001528, 225200187, 225200194, 7, 1440x900 
0x37CA2318, 38092257120761632, 225200263, 225200272, 9, 1440x900 
0x37CA2318, 38092257121412576, 225200328, 225200337, 9, 1440x900 
0x37CA2318, 38092257122032968, 225200388, 225200397, 9, 1440x900 
0x37CA2318, 38092257122539712, 225200442, 225200449, 7, 1440x900 
0x37CA2318, 38092257123211864, 225200508, 225200515, 7, 1440x900 
0x37CA2318, 38092257123859704, 225200572, 225200580, 8, 1440x900 
0x37CA2318, 38092257124713152, 225200663, 225200671, 8, 1440x900 
0x37CA2318, 38092257125186136, 225200708, 225200716, 8, 1440x900 
0x37CA2318, 38092257126025712, 225200793, 225200801, 8, 1440x900 
0x37CA2318, 38092257126700160, 225200858, 225200867, 9, 1440x900 
0x37CA2318, 38092257127350992, 225200927, 225200935, 8, 1440x900 
0x37CA2318, 38092257127828856, 225200973, 225200981, 8, 1440x900 
0x37CA2318, 38092257128677008, 225201058, 225201066, 8, 1440x900 
0x37CA2318, 38092257129334928, 225201122, 225201130, 8, 1440x900 
0x37CA2318, 38092257130006408, 225201188, 225201195, 7, 1440x900 
0x37CA2318, 38092257130464960, 225201237, 225201245, 8, 1440x900 
0x37CA2318, 38092257131317424, 225201318, 225201326, 8, 1440x900 
0x37CA2318, 38092257131983312, 225201383, 225201391, 8, 1440x900 
0x37CA2318, 38092257132636552, 225201452, 225201460, 8, 1440x900 
0x37CA2318, 38092257133316208, 225201539, 225201548, 9, 1440x900 
0x37CA2318, 38092257133997920, 225201587, 225201597, 10, 1440x900 
0x37CA2318, 38092257134555072, 225201643, 225201651, 8, 1440x900 
0x37CA2318, 38092257135121616, 225201697, 225201704, 7, 1440x900 
0x37CA2318, 38092257135973712, 225201783, 225201790, 7, 1440x900 
0x37CA2318, 38092257136652816, 225201852, 225201859, 7, 1440x900 
0x37CA2318, 38092257137312552, 225201917, 225201924, 7, 1440x900 
0x37CA2318, 38092257137787568, 225201963, 225201973, 10, 1440x900 
0x37CA2318, 38092257138462008, 225202032, 225202041, 9, 1440x900 
0x37CA2318, 38092257139294640, 225202117, 225202124, 7, 1440x900 
0x37CA2318, 38092257139964640, 225202186, 225202205, 19, 1440x900 
0x37CA2318, 38092257140453944, 225202233, 225202239, 6, 1440x900 
0x37CA2318, 38092257141085584, 225202294, 225202301, 7, 1440x900 
0x37CA2318, 38092257141747424, 225202362, 225202368, 6, 1440x900 
0x37CA2318, 38092257142405680, 225202427, 225202433, 6, 1440x900 
0x37CA2318, 38092257143070936, 225202493, 225202501, 8, 1440x900 
0x37CA2318, 38092257143735792, 225202561, 225202569, 8, 1440x900 
0x37CA2318, 38092257144387112, 225202628, 225202635, 7, 1440x900 
0x37CA2318, 38092257145051992, 225202691, 225202698, 7, 1440x900 
0x37CA2318, 38092257145716608, 225202758, 225202768, 10, 1440x900 
0x37CA2318, 38092257146376016, 225202822, 225202830, 8, 1440x900 
0x37CA2318, 38092257147029408, 225202891, 225202898, 7, 1440x900 
0x37CA2318, 38092257147688480, 225202956, 225202963, 7, 1440x900 
0x37CA2318, 38092257148349328, 225203022, 225203029, 7, 1440x900 
0x37CA2318, 38092257149010176, 225203088, 225203094, 6, 1440x900 
0x37CA2318, 38092257149668016, 225203152, 225203159, 7, 1440x900 
0x37CA2318, 38092257150333912, 225203218, 225203224, 6, 1440x900 
0x37CA2318, 38092257150994336, 225203286, 225203294, 8, 1440x900 
0x37CA2318, 38092257151852360, 225203378, 225203387, 9, 1440x900 
0x37CA2318, 38092257152522464, 225203438, 225203447, 9, 1440x900 
0x37CA2318, 38092257153181880, 225203507, 225203515, 8, 1440x900 
0x37CA2318, 38092257153832480, 225203573, 225203581, 8, 1440x900 
0x37CA2318, 38092257154493512, 225203638, 225203646, 8, 1440x900 
0x37CA2318, 38092257155161680, 225203707, 225203715, 8, 1440x900 
0x37CA2318, 38092257155824480, 225203773, 225203782, 9, 1440x900 
0x37CA2318, 38092257156477400, 225203836, 225203844, 8, 1440x900 
0x37CA2318, 38092257157139120, 225203902, 225203910, 8, 1440x900 
0x37CA2318, 38092257157792488, 225203967, 225203975, 8, 1440x900 
0x37CA2318, 38092257158461752, 225204037, 225204045, 8, 1440x900 
0x37CA2318, 38092257159113888, 225204098, 225204107, 9, 1440x900 
0x37CA2318, 38092257159788816, 225204167, 225204176, 9, 1440x900 
0x37CA2318, 38092257160446760, 225204232, 225204241, 9, 1440x900 
0x37CA2318, 38092257161105616, 225204303, 225204311, 8, 1440x900 
0x37CA2318, 38092257161767848, 225204368, 225204376, 8, 1440x900 
0x37CA2318, 38092257162429880, 225204432, 225204440, 8, 1440x900 
0x37CA2318, 38092257163089864, 225204496, 225204503, 7, 1440x900 
0x37CA2318, 38092257163750304, 225204562, 225204572, 10, 1440x900 
0x37CA2318, 38092257164400472, 225204627, 225204635, 8, 1440x900 
0x37CA2318, 38092257165064352, 225204698, 225204706, 8, 1440x900 
0x37CA2318, 38092257166205624, 225204807, 225204815, 8, 1440x900 
0x37CA2318, 38092257166867392, 225204877, 225204886, 9, 1440x900 
0x37CA2318, 38092257167522560, 225204943, 225204951, 8, 1440x900 
0x37CA2318, 38092257168182544, 225205012, 225205020, 8, 1440x900 
0x37CA2318, 38092257168847104, 225205077, 225205085, 8, 1440x900 
0x37CA2318, 38092257169500400, 225205138, 225205145, 7, 1440x900 
0x37CA2318, 38092257170163336, 225205208, 225205216, 8, 1440x900 
0x37CA2318, 38092257171019528, 225205292, 225205300, 8, 1440x900 
0x37CA2318, 38092257171494760, 225205337, 225205346, 9, 1440x900 
0x37CA2318, 38092257172145944, 225205403, 225205412, 9, 1440x900 
0x37CA2318, 38092257172804384, 225205467, 225205474, 7, 1440x900 
0x37CA2318, 38092257173461976, 225205533, 225205539, 6, 1440x900 
0x37CA2318, 38092257174127360, 225205598, 225205605, 7, 1440x900 
0x37CA2318, 38092257174928344, 225205676, 225205695, 19, 1440x900 
0x37CA2318, 38092257175591616, 225205743, 225205751, 8, 1440x900 
0x37CA2318, 38092257176250928, 225205811, 225205818, 7, 1440x900 
0x37CA2318, 38092257176910952, 225205877, 225205884, 7, 1440x900 
0x37CA2318, 38092257177571864, 225205942, 225205949, 7, 1440x900 
0x37CA2318, 38092257178233736, 225206008, 225206016, 8, 1440x900 
0x37CA2318, 38092257178890808, 225206073, 225206081, 8, 1440x900 
0x37CA2318, 38092257179551888, 225206142, 225206149, 7, 1440x900 
0x37CA2318, 38092257180213008, 225206208, 225206215, 7, 1440x900 
0x37CA2318, 38092257180875056, 225206273, 225206281, 8, 1440x900 
0x37CA2318, 38092257181535952, 225206342, 225206349, 7, 1440x900 
0x37CA2318, 38092257182195136, 225206407, 225206415, 8, 1440x900 
0x37CA2318, 38092257182869920, 225206473, 225206484, 11, 1440x900 
0x37CA2318, 38092257183545624, 225206542, 225206550, 8, 1440x900 
0x37CA2318, 38092257184190632, 225206607, 225206614, 7, 1440x900 
0x37CA2318, 38092257184850504, 225206672, 225206679, 7, 1440x900 
0x37CA2318, 38092257185510624, 225206737, 225206745, 8, 1440x900 
0x37CA2318, 38092257186170552, 225206803, 225206810, 7, 1440x900 
0x37CA2318, 38092257186830576, 225206868, 225206876, 8, 1440x900 
0x37CA2318, 38092257187499440, 225206937, 225206944, 7, 1440x900 
0x37CA2318, 38092257188358520, 225207022, 225207030, 8, 1440x900 
0x37CA2318, 38092257189009672, 225207088, 225207095, 7, 1440x900 
0x37CA2318, 38092257189688816, 225207157, 225207166, 9, 1440x900 
0x37CA2318, 38092257190152640, 225207202, 225207209, 7, 1440x900 
0x37CA2318, 38092257190812552, 225207267, 225207274, 7, 1440x900 
0x37CA2318, 38092257191472584, 225207332, 225207339, 7, 1440x900 
0x37CA2318, 38092257192171024, 225207402, 225207410, 8, 1440x900 
0x37CA2318, 38092257192998344, 225207487, 225207494, 7, 1440x900 
0x37CA2318, 38092257193659952, 225207558, 225207566, 8, 1440x900 
0x37CA2318, 38092257194319200, 225207618, 225207625, 7, 1440x900 
0x37CA2318, 38092257194972400, 225207683, 225207690, 7, 1440x900 
0x37CA2318, 38092257195446736, 225207732, 225207740, 8, 1440x900 
0x37CA2318, 38092257196106792, 225207797, 225207805, 8, 1440x900 
0x37CA2318, 38092257196780616, 225207862, 225207870, 8, 1440x900 
0x37CA2318, 38092257197432296, 225207928, 225207936, 8, 1440x900 
0x37CA2318, 38092257198288504, 225208017, 225208025, 8, 1440x900 
0x37CA2318, 38092257198957688, 225208089, 225208096, 7, 1440x900 
0x37CA2318, 38092257199605808, 225208148, 225208155, 7, 1440x900 
0x37CA2318, 38092257200275792, 225208217, 225208224, 7, 1440x900 
0x37CA2318, 38092257200766440, 225208262, 225208270, 8, 1440x900 
0x37CA2318, 38092257201429728, 225208328, 225208336, 8, 1440x900 
0x37CA2318, 38092257202257016, 225208413, 225208423, 10, 1440x900 
0x37CA2318, 38092257202926720, 225208477, 225208485, 8, 1440x900 
0x37CA2318, 38092257203577232, 225208543, 225208551, 8, 1440x900 
0x37CA2318, 38092257204240160, 225208613, 225208621, 8, 1440x900 
0x37CA2318, 38092257204906440, 225208677, 225208684, 7, 1440x900 
0x37CA2318, 38092257205559520, 225208743, 225208750, 7, 1440x900 
0x37CA2318, 38092257206219392, 225208808, 225208815, 7, 1440x900 
0x37CA2318, 38092257206881056, 225208873, 225208883, 10, 1440x900 
0x37CA2318, 38092257207346992, 225208922, 225208930, 8, 1440x900 
0x37CA2318, 38092257208006152, 225208987, 225208994, 7, 1440x900 
0x37CA2318, 38092257208668848, 225209052, 225209060, 8, 1440x900 
0x37CA2318, 38092257209330272, 225209118, 225209127, 9, 1440x900 
0x37CA2318, 38092257209986360, 225209183, 225209191, 8, 1440x900 
0x37CA2318, 38092257211019704, 225209288, 225209298, 10, 1440x900 
0x37CA2318, 38092257211344448, 225209318, 225209327, 9, 1440x900 
0x37CA2318, 38092257212136152, 225209397, 225209407, 10, 1440x900 
0x37CA2318, 38092257212827920, 225209467, 225209476, 9, 1440x900 
0x37CA2318, 38092257213315728, 225209517, 225209526, 9, 1440x900 
0x37CA2318, 38092257213965576, 225209582, 225209590, 8, 1440x900 
0x37CA2318, 38092257214616712, 225209645, 225209653, 8, 1440x900 
0x37CA2318, 38092257215335952, 225209718, 225209725, 7, 1440x900 
0x37CA2318, 38092257215989848, 225209783, 225209792, 9, 1440x900 
0x37CA2318, 38092257216642408, 225209848, 225209856, 8, 1440x900 
0x37CA2318, 38092257217298824, 225209917, 225209925, 8, 1440x900 
0x37CA2318, 38092257217961672, 225209982, 225209989, 7, 1440x900 
0x37CA2318, 38092257218615608, 225210053, 225210061, 8, 1440x900 
0x37CA2318, 38092257219280096, 225210117, 225210124, 7, 1440x900 
0x37CA2318, 38092257219940144, 225210182, 225210189, 7, 1440x900 
0x37CA2318, 38092257220607600, 225210247, 225210254, 7, 1440x900 
0x37CA2318, 38092257221279720, 225210317, 225210324, 7, 1440x900 
0x37CA2318, 38092257221939136, 225210382, 225210389, 7, 1440x900 
0x37CA2318, 38092257222608256, 225210453, 225210461, 8, 1440x900 
0x37CA2318, 38092257223260920, 225210517, 225210525, 8, 1440x900 
0x37CA2318, 38092257223923760, 225210582, 225210591, 9, 1440x900 
0x37CA2318, 38092257224580256, 225210646, 225210654, 8, 1440x900 
0x37CA2318, 38092257225232528, 225210712, 225210719, 7, 1440x900 
0x37CA2318, 38092257225898800, 225210777, 225210784, 7, 1440x900 
0x37CA2318, 38092257226589360, 225210846, 225210854, 8, 1440x900 
0x37CA2318, 38092257227216616, 225210907, 225210915, 8, 1440x900 
0x37CA2318, 38092257227899880, 225210978, 225210988, 10, 1440x900 
0x37CA2318, 38092257228536944, 225211038, 225211046, 8, 1440x900 
0x37CA2318, 38092257229200744, 225211107, 225211115, 8, 1440x900 
0x37CA2318, 38092257229890584, 225211177, 225211185, 8, 1440x900 
0x37CA2318, 38092257230712288, 225211258, 225211266, 8, 1440x900 
0x37CA2318, 38092257231258480, 225211317, 225211324, 7, 1440x900 
0x37CA2318, 38092257232035880, 225211394, 225211411, 17, 1440x900 
0x37CA2318, 38092257232686128, 225211453, 225211461, 8, 1440x900 
0x37CA2318, 38092257233357168, 225211522, 225211531, 9, 1440x900 
0x37CA2318, 38092257234018744, 225211588, 225211597, 9, 1440x900 
0x37CA2318, 38092257234678216, 225211657, 225211665, 8, 1440x900 
0x37CA2318, 38092257235340312, 225211722, 225211730, 8, 1440x900 
0x37CA2318, 38092257235992168, 225211828, 225211837, 9, 1440x900 
0x37CA2318, 38092257236625648, 225211848, 225211859, 11, 1440x900 
0x37CA2318, 38092257237215376, 225211908, 225211917, 9, 1440x900 
0x37CA2318, 38092257237839440, 225211968, 225211976, 8, 1440x900 
0x37CA2318, 38092257238499472, 225212033, 225212042, 9, 1440x900 
0x37CA2318, 38092257239159424, 225212103, 225212110, 7, 1440x900 
0x37CA2318, 38092257239820192, 225212167, 225212174, 7, 1440x900 
0x37CA2318, 38092257240519184, 225212237, 225212245, 8, 1440x900 
0x37CA2318, 38092257241151736, 225212299, 225212306, 7, 1440x900 
0x37CA2318, 38092257241810720, 225212367, 225212374, 7, 1440x900 
0x37CA2318, 38092257242629032, 225212453, 225212459, 6, 1440x900 
0x37CA2318, 38092257243154560, 225212503, 225212509, 6, 1440x900 
0x37CA2318, 38092257243796440, 225212568, 225212575, 7, 1440x900 
0x37CA2318, 38092257244469024, 225212633, 225212639, 6, 1440x900 
0x37CA2318, 38092257245117936, 225212698, 225212706, 8, 1440x900 
0x37CA2318, 38092257245778112, 225212766, 225212774, 8, 1440x900 
0x37CA2318, 38092257246453520, 225212832, 225212839, 7, 1440x900 
0x37CA2318, 38092257247295848, 225212916, 225212923, 7, 1440x900 
0x37CA2318, 38092257247958896, 225212983, 225212992, 9, 1440x900 
0x37CA2318, 38092257248608488, 225213052, 225213062, 10, 1440x900 
0x37CA2318, 38092257249094552, 225213097, 225213104, 7, 1440x900 
0x37CA2318, 38092257249766704, 225213163, 225213170, 7, 1440x900 
0x37CA2318, 38092257250423688, 225213228, 225213236, 8, 1440x900 
0x37CA2318, 38092257251073840, 225213293, 225213301, 8, 1440x900 
0x37CA2318, 38092257251734752, 225213362, 225213369, 7, 1440x900 
0x37CA2318, 38092257252402096, 225213429, 225213439, 10, 1440x900 
0x37CA2318, 38092257253074560, 225213494, 225213502, 8, 1440x900 
0x37CA2318, 38092257253734608, 225213563, 225213571, 8, 1440x900 
0x37CA2318, 38092257254574368, 225213648, 225213656, 8, 1440x900 
0x37CA2318, 38092257255043328, 225213703, 225213711, 8, 1440x900 
0x37CA2318, 38092257255718168, 225213757, 225213764, 7, 1440x900 
0x37CA2318, 38092257256367904, 225213822, 225213829, 7, 1440x900 
0x37CA2318, 38092257257153224, 225213902, 225213910, 8, 1440x900 
0x37CA2318, 38092257257712296, 225213957, 225213965, 8, 1440x900 
0x37CA2318, 38092257258541248, 225214043, 225214051, 8, 1440x900 
0x37CA2318, 38092257259676784, 225214158, 225214166, 8, 1440x900 
0x37CA2318, 38092257260330752, 225214223, 225214231, 8, 1440x900 
0x37CA2318, 38092257260999728, 225214293, 225214304, 11, 1440x900 
0x37CA2318, 38092257261680032, 225214358, 225214366, 8, 1440x900 
0x37CA2318, 38092257262513768, 225214443, 225214451, 8, 1440x900 
0x37CA2318, 38092257263077016, 225214498, 225214506, 8, 1440x900 
0x37CA2318, 38092257263651272, 225214557, 225214566, 9, 1440x900 
0x37CA2318, 38092257264315456, 225214617, 225214625, 8, 1440x900 
0x37CA2318, 38092257264961992, 225214682, 225214689, 7, 1440x900 
0x37CA2318, 38092257265812672, 225214768, 225214777, 9, 1440x900 
0x37CA2318, 38092257266484576, 225214838, 225214847, 9, 1440x900 
0x37CA2318, 38092257266954504, 225214882, 225214891, 9, 1440x900 
0x37CA2318, 38092257267812048, 225214967, 225214973, 6, 1440x900 
0x37CA2318, 38092257268463872, 225215033, 225215040, 7, 1440x900 
0x37CA2318, 38092257269126760, 225215098, 225215106, 8, 1440x900 
0x37CA2318, 38092257269782128, 225215166, 225215174, 8, 1440x900 
0x37CA2318, 38092257270443168, 225215233, 225215241, 8, 1440x900 
0x37CA2318, 38092257271114720, 225215299, 225215307, 8, 1440x900 
0x37CA2318, 38092257271769568, 225215364, 225215373, 9, 1440x900 
0x37CA2318, 38092257272436824, 225215433, 225215441, 8, 1440x900 
0x37CA2318, 38092257273086896, 225215498, 225215506, 8, 1440x900 
0x37CA2318, 38092257273748456, 225215562, 225215571, 9, 1440x900 
0x37CA2318, 38092257274411728, 225215630, 225215639, 9, 1440x900 
0x37CA2318, 38092257275072072, 225215693, 225215700, 7, 1440x900 
0x37CA2318, 38092257275726280, 225215762, 225215770, 8, 1440x900 
0x37CA2318, 38092257276399080, 225215828, 225215836, 8, 1440x900 
0x37CA2318, 38092257277058824, 225215893, 225215902, 9, 1440x900 
0x37CA2318, 38092257277718288, 225215958, 225215967, 9, 1440x900 
0x37CA2318, 38092257278378424, 225216023, 225216030, 7, 1440x900 
0x37CA2318, 38092257279038800, 225216088, 225216097, 9, 1440x900 
0x37CA2318, 38092257279697672, 225216156, 225216163, 7, 1440x900 
0x37CA2318, 38092257280363128, 225216223, 225216231, 8, 1440x900 
0x37CA2318, 38092257281014312, 225216293, 225216301, 8, 1440x900 
0x37CA2318, 38092257281686384, 225216358, 225216366, 8, 1440x900 
0x37CA2318, 38092257282348632, 225216423, 225216432, 9, 1440x900 
0x37CA2318, 38092257283017616, 225216490, 225216500, 10, 1440x900 
0x37CA2318, 38092257283474056, 225216537, 225216545, 8, 1440x900 
0x37CA2318, 38092257284129616, 225216598, 225216607, 9, 1440x900 
0x37CA2318, 38092257284800896, 225216666, 225216673, 7, 1440x900 
0x37CA2318, 38092257285460896, 225216732, 225216739, 7, 1440x900 
0x37CA2318, 38092257286122304, 225216803, 225216811, 8, 1440x900 
0x37CA2318, 38092257286790352, 225216868, 225216877, 9, 1440x900 
0x37CA2318, 38092257287455760, 225216933, 225216941, 8, 1440x900 
0x37CA2318, 38092257288110776, 225216997, 225217005, 8, 1440x900 
0x37CA2318, 38092257288769688, 225217063, 225217072, 9, 1440x900 
0x37CA2318, 38092257289446008, 225217129, 225217138, 9, 1440x900 
0x37CA2318, 38092257290093344, 225217194, 225217202, 8, 1440x900 
0x37CA2318, 38092257290755312, 225217262, 225217269, 7, 1440x900 
0x37CA2318, 38092257291415656, 225217327, 225217334, 7, 1440x900 
0x37CA2318, 38092257292075760, 225217392, 225217400, 8, 1440x900 
0x37CA2318, 38092257292736176, 225217461, 225217468, 7, 1440x900 
0x37CA2318, 38092257293396288, 225217524, 225217532, 8, 1440x900 
0x37CA2318, 38092257294056448, 225217592, 225217599, 7, 1440x900 
0x37CA2318, 38092257294717568, 225217657, 225217665, 8, 1440x900 
0x37CA2318, 38092257295378104, 225217723, 225217731, 8, 1440x900 
0x37CA2318, 38092257296036984, 225217788, 225217797, 9, 1440x900 
0x37CA2318, 38092257296895152, 225217877, 225217885, 8, 1440x900 
0x37CA2318, 38092257297557008, 225217947, 225217955, 8, 1440x900 
0x37CA2318, 38092257298209088, 225218013, 225218021, 8, 1440x900 
0x37CA2318, 38092257298875952, 225218077, 225218085, 8, 1440x900 
0x37CA2318, 38092257299340328, 225218122, 225218129, 7, 1440x900 
0x37CA2318, 38092257300205000, 225218208, 225218215, 7, 1440x900 
0x37CA2318, 38092257300752624, 225218263, 225218270, 7, 1440x900 
0x37CA2318, 38092257301523992, 225218339, 225218348, 9, 1440x900 
0x37CA2318, 38092257302177568, 225218408, 225218416, 8, 1440x900 
0x37CA2318, 38092257302645176, 225218453, 225218462, 9, 1440x900 
0x37CA2318, 38092257303305080, 225218523, 225218531, 8, 1440x900 
0x37CA2318, 38092257303966680, 225218583, 225218590, 7, 1440x900 
0x37CA2318, 38092257304821392, 225218673, 225218681, 8, 1440x900 
0x37CA2318, 38092257305480728, 225218737, 225218745, 8, 1440x900 
0x37CA2318, 38092257306150720, 225218803, 225218811, 8, 1440x900 
0x37CA2318, 38092257306800840, 225218868, 225218876, 8, 1440x900 
0x37CA2318, 38092257307396800, 225218932, 225218940, 8, 1440x900 
0x37CA2318, 38092257307928960, 225218984, 225218992, 8, 1440x900 
0x37CA2318, 38092257308589808, 225219048, 225219056, 8, 1440x900 
0x37CA2318, 38092257309248664, 225219113, 225219121, 8, 1440x900 
0x37CA2318, 38092257310116528, 225219197, 225219205, 8, 1440x900 
0x37CA2318, 38092257310777856, 225219263, 225219271, 8, 1440x900 
0x37CA2318, 38092257311428464, 225219328, 225219336, 8, 1440x900 
0x37CA2318, 38092257312090560, 225219393, 225219401, 8, 1440x900 
0x37CA2318, 38092257312743544, 225219463, 225219471, 8, 1440x900 
0x37CA2318, 38092257313406128, 225219527, 225219536, 9, 1440x900 
0x37CA2318, 38092257314069712, 225219597, 225219605, 8, 1440x900 
0x37CA2318, 38092257314737912, 225219662, 225219671, 9, 1440x900 
0x37CA2318, 38092257315206008, 225219713, 225219721, 8, 1440x900 
0x37CA2318, 38092257315874512, 225219777, 225219785, 8, 1440x900 
0x37CA2318, 38092257316537096, 225219848, 225219855, 7, 1440x900 
0x37CA2318, 38092257317197264, 225219908, 225219915, 7, 1440x900 
0x37CA2318, 38092257317852968, 225219972, 225219979, 7, 1440x900 
0x37CA2318, 38092257318711552, 225220058, 225220065, 7, 1440x900 
0x37CA2318, 38092257319366616, 225220127, 225220135, 8, 1440x900 
0x37CA2318, 38092257320503688, 225220242, 225220249, 7, 1440x900 
0x37CA2318, 38092257321160920, 225220302, 225220310, 8, 1440x900 
0x37CA2318, 38092257321819608, 225220367, 225220375, 8, 1440x900 
0x37CA2318, 38092257322482256, 225220433, 225220442, 9, 1440x900 
0x37CA2318, 38092257323145456, 225220503, 225220512, 9, 1440x900 
0x37CA2318, 38092257323806928, 225220568, 225220576, 8, 1440x900 
0x37CA2318, 38092257324465920, 225220636, 225220646, 10, 1440x900 
0x37CA2318, 38092257325122592, 225220698, 225220705, 7, 1440x900 
0x37CA2318, 38092257325790624, 225220766, 225220773, 7, 1440x900 
0x37CA2318, 38092257326640872, 225220853, 225220861, 8, 1440x900 
0x37CA2318, 38092257327312088, 225220918, 225220927, 9, 1440x900 
0x37CA2318, 38092257327944352, 225220982, 225220989, 7, 1440x900 
0x37CA2318, 38092257328630184, 225221048, 225221056, 8, 1440x900 
0x37CA2318, 38092257329096320, 225221097, 225221105, 8, 1440x900 
0x37CA2318, 38092257329774056, 225221163, 225221172, 9, 1440x900 
0x37CA2318, 38092257330432568, 225221232, 225221239, 7, 1440x900 
0x37CA2318, 38092257331095696, 225221298, 225221306, 8, 1440x900 
0x37CA2318, 38092257331778248, 225221362, 225221371, 9, 1440x900 
0x37CA2318, 38092257332439872, 225221432, 225221439, 7, 1440x900 
0x37CA2318, 38092257333087848, 225221497, 225221506, 9, 1440x900 
0x37CA2318, 38092257333738224, 225221563, 225221573, 10, 1440x900 
0x37CA2318, 38092257334395352, 225221632, 225221641, 9, 1440x900 
0x37CA2318, 38092257335059344, 225221692, 225221699, 7, 1440x900 
0x37CA2318, 38092257335718936, 225221760, 225221768, 8, 1440x900 
0x37CA2318, 38092257336378584, 225221824, 225221834, 10, 1440x900 
0x37CA2318, 38092257337038608, 225221888, 225221896, 8, 1440x900 
0x37CA2318, 38092257337699184, 225221958, 225221966, 8, 1440x900 
0x37CA2318, 38092257338359072, 225222022, 225222029, 7, 1440x900 
0x37CA2318, 38092257339010272, 225222087, 225222094, 7, 1440x900 
0x37CA2318, 38092257339675640, 225222154, 225222162, 8, 1440x900 
0x37CA2318, 38092257340330528, 225222217, 225222225, 8, 1440x900 
0x37CA2318, 38092257341197496, 225222303, 225222311, 8, 1440x900 
0x37CA2318, 38092257341867112, 225222372, 225222380, 8, 1440x900 
0x37CA2318, 38092257342526776, 225222437, 225222445, 8, 1440x900 
0x37CA2318, 38092257343183640, 225222503, 225222510, 7, 1440x900 
0x37CA2318, 38092257343845248, 225222572, 225222579, 7, 1440x900 
0x37CA2318, 38092257344497736, 225222638, 225222646, 8, 1440x900 
0x37CA2318, 38092257345177072, 225222703, 225222711, 8, 1440x900 
0x37CA2318, 38092257345630896, 225222752, 225222760, 8, 1440x900 
0x37CA2318, 38092257346289712, 225222816, 225222823, 7, 1440x900 
0x37CA2318, 38092257346951600, 225222882, 225222889, 7, 1440x900 
0x37CA2318, 38092257347611224, 225222947, 225222954, 7, 1440x900 
0x37CA2318, 38092257348271584, 225223012, 225223020, 8, 1440x900 
0x37CA2318, 38092257348931248, 225223078, 225223086, 8, 1440x900 
0x37CA2318, 38092257349592296, 225223143, 225223151, 8, 1440x900 
0x37CA2318, 38092257350251184, 225223211, 225223218, 7, 1440x900 
0x37CA2318, 38092257350911624, 225223277, 225223284, 7, 1440x900 
0x37CA2318, 38092257351579912, 225223343, 225223351, 8, 1440x900 
0x37CA2318, 38092257352239832, 225223408, 225223416, 8, 1440x900 
0x37CA2318, 38092257352899832, 225223476, 225223483, 7, 1440x900 
0x37CA2318, 38092257353559896, 225223542, 225223550, 8, 1440x900 
0x37CA2318, 38092257354422664, 225223628, 225223636, 8, 1440x900 
0x37CA2318, 38092257354882752, 225223677, 225223685, 8, 1440x900 
0x37CA2318, 38092257355749192, 225223762, 225223770, 8, 1440x900 
0x37CA2318, 38092257356401040, 225223828, 225223836, 8, 1440x900 
0x37CA2318, 38092257357062352, 225223893, 225223902, 9, 1440x900 
0x37CA2318, 38092257357526760, 225223943, 225223951, 8, 1440x900 
0x37CA2318, 38092257358183944, 225224008, 225224015, 7, 1440x900 
0x37CA2318, 38092257358845648, 225224073, 225224080, 7, 1440x900 
0x37CA2318, 38092257359504712, 225224137, 225224146, 9, 1440x900 
0x37CA2318, 38092257360164504, 225224207, 225224215, 8, 1440x900 
0x37CA2318, 38092257360826152, 225224268, 225224276, 8, 1440x900 
0x37CA2318, 38092257361484584, 225224337, 225224345, 8, 1440x900 
0x37CA2318, 38092257362145256, 225224402, 225224410, 8, 1440x900 
0x37CA2318, 38092257362804912, 225224469, 225224476, 7, 1440x900 
0x37CA2318, 38092257363465288, 225224534, 225224542, 8, 1440x900 
0x37CA2318, 38092257364326880, 225224622, 225224630, 8, 1440x900 
0x37CA2318, 38092257364995776, 225224687, 225224696, 9, 1440x900 
0x37CA2318, 38092257365467256, 225224732, 225224741, 9, 1440x900 
0x37CA2318, 38092257366117184, 225224803, 225224811, 8, 1440x900 
0x37CA2318, 38092257366798528, 225224867, 225224875, 8, 1440x900 
0x37CA2318, 38092257367460688, 225224933, 225224941, 8, 1440x900 
0x37CA2318, 38092257368131880, 225224998, 225225006, 8, 1440x900 
0x37CA2318, 38092257368772208, 225225062, 225225070, 8, 1440x900 
0x37CA2318, 38092257369438904, 225225133, 225225142, 9, 1440x900 
0x37CA2318, 38092257370101080, 225225202, 225225210, 8, 1440x900 
0x37CA2318, 38092257370760440, 225225267, 225225275, 8, 1440x900 
0x37CA2318, 38092257371614784, 225225353, 225225360, 7, 1440x900 
0x37CA2318, 38092257372275336, 225225416, 225225424, 8, 1440x900 
0x37CA2318, 38092257372932536, 225225481, 225225489, 8, 1440x900 
0x37CA2318, 38092257373593744, 225225548, 225225556, 8, 1440x900 
0x37CA2318, 38092257374254848, 225225612, 225225619, 7, 1440x900 
0x37CA2318, 38092257374916328, 225225678, 225225685, 7, 1440x900 
0x37CA2318, 38092257375576640, 225225743, 225225751, 8, 1440x900 
0x37CA2318, 38092257376236696, 225225811, 225225819, 8, 1440x900 
0x37CA2318, 38092257376900592, 225225877, 225225884, 7, 1440x900 
0x37CA2318, 38092257377559248, 225225947, 225225955, 8, 1440x900 
0x37CA2318, 38092257378035456, 225225992, 225226001, 9, 1440x900 
0x37CA2318, 38092257378683344, 225226058, 225226066, 8, 1440x900 
0x37CA2318, 38092257379341128, 225226122, 225226130, 8, 1440x900 
0x37CA2318, 38092257380001296, 225226188, 225226195, 7, 1440x900 
0x37CA2318, 38092257380671992, 225226253, 225226259, 6, 1440x900 
0x37CA2318, 38092257381328640, 225226317, 225226325, 8, 1440x900 
0x37CA2318, 38092257381982320, 225226383, 225226391, 8, 1440x900 
0x37CA2318, 38092257383308832, 225226517, 225226524, 7, 1440x900 
0x37CA2318, 38092257383978728, 225226582, 225226590, 8, 1440x900 
0x37CA2318, 38092257384630992, 225226648, 225226656, 8, 1440x900 
0x37CA2318, 38092257385297584, 225226717, 225226724, 7, 1440x900 
0x37CA2318, 38092257385955288, 225226783, 225226790, 7, 1440x900 
0x37CA2318, 38092257386618080, 225226847, 225226856, 9, 1440x900 
0x37CA2318, 38092257387276008, 225226913, 225226921, 8, 1440x900 
0x37CA2318, 38092257387955488, 225226983, 225226990, 7, 1440x900 
0x37CA2318, 38092257388606144, 225227047, 225227054, 7, 1440x900 
0x37CA2318, 38092257389270392, 225227118, 225227125, 7, 1440x900 
0x37CA2318, 38092257389927752, 225227178, 225227187, 9, 1440x900 
0x37CA2318, 38092257390594160, 225227247, 225227254, 7, 1440x900 
0x37CA2318, 38092257391256512, 225227313, 225227320, 7, 1440x900 
0x37CA2318, 38092257391920080, 225227378, 225227385, 7, 1440x900 
0x37CA2318, 38092257392582856, 225227443, 225227451, 8, 1440x900 
0x37CA2318, 38092257393244976, 225227511, 225227518, 7, 1440x900 
0x37CA2318, 38092257393935360, 225227578, 225227588, 10, 1440x900 
0x37CA2318, 38092257394574080, 225227648, 225227656, 8, 1440x900 
0x37CA2318, 38092257395339768, 225227722, 225227731, 9, 1440x900 
0x37CA2318, 38092257395901088, 225227779, 225227787, 8, 1440x900 
0x37CA2318, 38092257396563744, 225227848, 225227856, 8, 1440x900 
0x37CA2318, 38092257397211544, 225227907, 225227915, 8, 1440x900 
0x37CA2318, 38092257398073184, 225227998, 225228006, 8, 1440x900 
0x37CA2318, 38092257398533648, 225228043, 225228052, 9, 1440x900 
0x37CA2318, 38092257399397176, 225228134, 225228143, 9, 1440x900 
0x37CA2318, 38092257399873048, 225228173, 225228181, 8, 1440x900 
0x37CA2318, 38092257400716736, 225228257, 225228264, 7, 1440x900 
0x37CA2318, 38092257401377344, 225228323, 225228330, 7, 1440x900 
0x37CA2318, 38092257401839104, 225228368, 225228376, 8, 1440x900 
0x37CA2318, 38092257402539616, 225228438, 225228446, 8, 1440x900 
0x37CA2318, 38092257403166672, 225228502, 225228510, 8, 1440x900 
0x37CA2318, 38092257403863256, 225228572, 225228579, 7, 1440x900 
0x37CA2318, 38092257404497480, 225228637, 225228647, 10, 1440x900 
0x37CA2318, 38092257405157880, 225228702, 225228709, 7, 1440x900 
0x37CA2318, 38092257405822128, 225228768, 225228777, 9, 1440x900 
0x37CA2318, 38092257406470928, 225228838, 225228846, 8, 1440x900 
0x37CA2318, 38092257407328624, 225228922, 225228931, 9, 1440x900 
0x37CA2318, 38092257407797184, 225228968, 225228977, 9, 1440x900 
0x37CA2318, 38092257408452936, 225229033, 225229041, 8, 1440x900 
0x37CA2318, 38092257409118072, 225229098, 225229107, 9, 1440x900 
0x37CA2318, 38092257409785832, 225229167, 225229174, 7, 1440x900 
0x37CA2318, 38092257410446232, 225229232, 225229240, 8, 1440x900 
0x37CA2318, 38092257411101208, 225229297, 225229305, 8, 1440x900 
0x37CA2318, 38092257411760728, 225229362, 225229370, 8, 1440x900 
0x37CA2318, 38092257412420680, 225229428, 225229436, 8, 1440x900 
0x37CA2318, 38092257413081232, 225229493, 225229501, 8, 1440x900 
0x37CA2318, 38092257413741440, 225229562, 225229570, 8, 1440x900 
0x37CA2318, 38092257414401144, 225229627, 225229635, 8, 1440x900 
0x37CA2318, 38092257415061480, 225229692, 225229700, 8, 1440x900 
0x37CA2318, 38092257415723496, 225229763, 225229771, 8, 1440x900 
0x37CA2318, 38092257416383792, 225229827, 225229835, 8, 1440x900 
0x37CA2318, 38092257417044168, 225229892, 225229901, 9, 1440x900 
0x37CA2318, 38092257417703856, 225229962, 225229972, 10, 1440x900 
0x37CA2318, 38092257418366296, 225230022, 225230030, 8, 1440x900 
0x37CA2318, 38092257419034416, 225230091, 225230099, 8, 1440x900 
0x37CA2318, 38092257419692368, 225230157, 225230164, 7, 1440x900 
0x37CA2318, 38092257420355984, 225230222, 225230230, 8, 1440x900 
0x37CA2318, 38092257421018784, 225230288, 225230296, 8, 1440x900 
0x37CA2318, 38092257421868520, 225230377, 225230385, 8, 1440x900 
0x37CA2318, 38092257422537152, 225230444, 225230452, 8, 1440x900 
0x37CA2318, 38092257422993832, 225230488, 225230497, 9, 1440x900 
0x37CA2318, 38092257423653088, 225230557, 225230565, 8, 1440x900 
0x37CA2318, 38092257424324456, 225230622, 225230630, 8, 1440x900 
0x37CA2318, 38092257425170544, 225230707, 225230715, 8, 1440x900 
0x37CA2318, 38092257425647368, 225230748, 225230759, 11, 1440x900 
0x37CA2318, 38092257426336440, 225230818, 225230826, 8, 1440x900 
0x37CA2318, 38092257426951624, 225230882, 225230889, 7, 1440x900 
0x37CA2318, 38092257427611632, 225230947, 225230954, 7, 1440x900 
0x37CA2318, 38092257428278944, 225231013, 225231021, 8, 1440x900 
0x37CA2318, 38092257428943224, 225231082, 225231089, 7, 1440x900 
0x37CA2318, 38092257429605096, 225231146, 225231155, 9, 1440x900 
0x37CA2318, 38092257430266080, 225231212, 225231220, 8, 1440x900 
0x37CA2318, 38092257430926592, 225231278, 225231286, 8, 1440x900 
0x37CA2318, 38092257431585104, 225231342, 225231350, 8, 1440x900 
0x37CA2318, 38092257432245848, 225231409, 225231417, 8, 1440x900 
0x37CA2318, 38092257432908160, 225231477, 225231484, 7, 1440x900 
0x37CA2318, 38092257433566016, 225231542, 225231550, 8, 1440x900 
0x37CA2318, 38092257434224760, 225231608, 225231615, 7, 1440x900 
0x37CA2318, 38092257434884072, 225231673, 225231681, 8, 1440x900 
0x37CA2318, 38092257435540504, 225231738, 225231746, 8, 1440x900 
0x37CA2318, 38092257436214168, 225231807, 225231815, 8, 1440x900 
0x37CA2318, 38092257436874464, 225231873, 225231881, 8, 1440x900 
0x37CA2318, 38092257437535448, 225231938, 225231946, 8, 1440x900 
0x37CA2318, 38092257438197840, 225232007, 225232014, 7, 1440x900 
0x37CA2318, 38092257438852640, 225232068, 225232077, 9, 1440x900 
0x37CA2318, 38092257439513016, 225232137, 225232145, 8, 1440x900 
0x37CA2318, 38092257440174840, 225232202, 225232210, 8, 1440x900 
0x37CA2318, 38092257440834288, 225232268, 225232276, 8, 1440x900 
0x37CA2318, 38092257441496552, 225232337, 225232344, 7, 1440x900 
0x37CA2318, 38092257442163392, 225232403, 225232410, 7, 1440x900 
0x37CA2318, 38092257442818376, 225232468, 225232475, 7, 1440x900 
0x37CA2318, 38092257443478560, 225232533, 225232541, 8, 1440x900 
0x37CA2318, 38092257444140416, 225232601, 225232608, 7, 1440x900 
0x37CA2318, 38092257444798704, 225232667, 225232674, 7, 1440x900 
0x37CA2318, 38092257445465480, 225232732, 225232740, 8, 1440x900 
0x37CA2318, 38092257446122800, 225232797, 225232805, 8, 1440x900 
0x37CA2318, 38092257446785120, 225232863, 225232871, 8, 1440x900 
0x37CA2318, 38092257447442568, 225232928, 225232936, 8, 1440x900 
0x37CA2318, 38092257448305216, 225233017, 225233025, 8, 1440x900 
0x37CA2318, 38092257448763696, 225233068, 225233076, 8, 1440x900 
0x37CA2318, 38092257449424808, 225233133, 225233142, 9, 1440x900 
0x37CA2318, 38092257450087200, 225233197, 225233206, 9, 1440x900 
0x37CA2318, 38092257450744904, 225233263, 225233272, 9, 1440x900 
0x37CA2318, 38092257451414312, 225233333, 225233341, 8, 1440x900 
0x37CA2318, 38092257452078784, 225233397, 225233405, 8, 1440x900 
0x37CA2318, 38092257452916624, 225233483, 225233491, 8, 1440x900 
0x37CA2318, 38092257454269032, 225233615, 225233625, 10, 1440x900 
0x37CA2318, 38092257454730536, 225233658, 225233666, 8, 1440x900 
0x37CA2318, 38092257455386584, 225233726, 225233733, 7, 1440x900 
0x37CA2318, 38092257456252096, 225233809, 225233819, 10, 1440x900 
0x37CA2318, 38092257456711688, 225233855, 225233863, 8, 1440x900 
0x37CA2318, 38092257457440744, 225233932, 225233944, 12, 1440x900 
0x37CA2318, 38092257458027744, 225233988, 225233996, 8, 1440x900 
0x37CA2318, 38092257458693008, 225234053, 225234062, 9, 1440x900 
0x37CA2318, 38092257459352992, 225234121, 225234129, 8, 1440x900 
0x37CA2318, 38092257460208848, 225234208, 225234217, 9, 1440x900 
0x37CA2318, 38092257460870328, 225234278, 225234286, 8, 1440x900 
0x37CA2318, 38092257461333536, 225234322, 225234331, 9, 1440x900 
0x37CA2318, 38092257461993816, 225234387, 225234396, 9, 1440x900 
0x37CA2318, 38092257462653864, 225234454, 225234462, 8, 1440x900 
0x37CA2318, 38092257463316128, 225234523, 225234532, 9, 1440x900 
0x37CA2318, 38092257463973048, 225234582, 225234590, 8, 1440x900 
0x37CA2318, 38092257464634000, 225234652, 225234660, 8, 1440x900 
0x37CA2318, 38092257465293528, 225234716, 225234724, 8, 1440x900 
0x37CA2318, 38092257465953336, 225234782, 225234790, 8, 1440x900 
0x37CA2318, 38092257466613704, 225234847, 225234855, 8, 1440x900 
0x37CA2318, 38092257467276624, 225234913, 225234921, 8, 1440x900 
0x37CA2318, 38092257467936512, 225234982, 225234989, 7, 1440x900 
0x37CA2318, 38092257468596592, 225235047, 225235055, 8, 1440x900 
0x37CA2318, 38092257469260064, 225235117, 225235125, 8, 1440x900 
0x37CA2318, 38092257469919832, 225235179, 225235188, 9, 1440x900 
0x37CA2318, 38092257470580104, 225235245, 225235254, 9, 1440x900 
0x37CA2318, 38092257471239168, 225235311, 225235319, 8, 1440x900 
0x37CA2318, 38092257472095240, 225235398, 225235407, 9, 1440x900 
0x37CA2318, 38092257472560328, 225235448, 225235456, 8, 1440x900 
0x37CA2318, 38092257473222448, 225235512, 225235520, 8, 1440x900 
0x37CA2318, 38092257473882432, 225235577, 225235585, 8, 1440x900 
0x37CA2318, 38092257474543472, 225235644, 225235653, 9, 1440x900 
0x37CA2318, 38092257475201288, 225235707, 225235715, 8, 1440x900 
0x37CA2318, 38092257475869744, 225235772, 225235780, 8, 1440x900 
0x37CA2318, 38092257476521424, 225235838, 225235846, 8, 1440x900 
0x37CA2318, 38092257477374344, 225235924, 225235931, 7, 1440x900 
0x37CA2318, 38092257478035568, 225235997, 225236005, 8, 1440x900 
0x37CA2318, 38092257478697256, 225236057, 225236066, 9, 1440x900 
0x37CA2318, 38092257479177800, 225236108, 225236116, 8, 1440x900 
0x37CA2318, 38092257479836144, 225236173, 225236181, 8, 1440x900 
0x37CA2318, 38092257480503848, 225236238, 225236247, 9, 1440x900 
0x37CA2318, 38092257481166000, 225236308, 225236316, 8, 1440x900 
0x37CA2318, 38092257481827376, 225236373, 225236381, 8, 1440x900 
0x37CA2318, 38092257482486008, 225236438, 225236446, 8, 1440x900 
0x37CA2318, 38092257483147912, 225236504, 225236513, 9, 1440x900 
0x37CA2318, 38092257483815824, 225236573, 225236581, 8, 1440x900 
0x37CA2318, 38092257484470248, 225236638, 225236646, 8, 1440x900 
0x37CA2318, 38092257485137840, 225236703, 225236712, 9, 1440x900 
0x37CA2318, 38092257485797632, 225236768, 225236776, 8, 1440x900 
0x37CA2318, 38092257486457696, 225236833, 225236842, 9, 1440x900 
0x37CA2318, 38092257487122256, 225236903, 225236913, 10, 1440x900 
0x37CA2318, 38092257487786496, 225236967, 225236975, 8, 1440x900 
0x37CA2318, 38092257488446808, 225237032, 225237041, 9, 1440x900 
0x37CA2318, 38092257489103728, 225237103, 225237111, 8, 1440x900 
0x37CA2318, 38092257489780440, 225237167, 225237176, 9, 1440x900 
0x37CA2318, 38092257490428224, 225237228, 225237236, 8, 1440x900 
0x37CA2318, 38092257491087912, 225237294, 225237302, 8, 1440x900 
0x37CA2318, 38092257491747880, 225237362, 225237369, 7, 1440x900 
0x37CA2318, 38092257492408040, 225237427, 225237433, 6, 1440x900 
0x37CA2318, 38092257493152736, 225237502, 225237510, 8, 1440x900 
0x37CA2318, 38092257493740336, 225237561, 225237569, 8, 1440x900 
0x37CA2318, 38092257494399736, 225237627, 225237634, 7, 1440x900 
0x37CA2318, 38092257495060896, 225237697, 225237705, 8, 1440x900 
0x37CA2318, 38092257495724592, 225237758, 225237766, 8, 1440x900 
0x37CA2318, 38092257496384176, 225237823, 225237831, 8, 1440x900 
0x37CA2318, 38092257497049280, 225237891, 225237898, 7, 1440x900 
0x37CA2318, 38092257497713936, 225237958, 225237965, 7, 1440x900 
0x37CA2318, 38092257498377824, 225238022, 225238030, 8, 1440x900 
0x37CA2318, 38092257499037936, 225238088, 225238097, 9, 1440x900 
0x37CA2318, 38092257499701296, 225238157, 225238165, 8, 1440x900 
0x37CA2318, 38092257500361064, 225238222, 225238230, 8, 1440x900 
0x37CA2318, 38092257501020584, 225238288, 225238296, 8, 1440x900 
0x37CA2318, 38092257501680792, 225238358, 225238365, 7, 1440x900 
0x37CA2318, 38092257502350600, 225238422, 225238430, 8, 1440x900 
0x37CA2318, 38092257503008880, 225238487, 225238495, 8, 1440x900 
0x37CA2318, 38092257503669088, 225238552, 225238560, 8, 1440x900 
0x37CA2318, 38092257504328976, 225238621, 225238629, 8, 1440x900 
0x37CA2318, 38092257504989816, 225238686, 225238694, 8, 1440x900 
0x37CA2318, 38092257505656120, 225238753, 225238760, 7, 1440x900 
0x37CA2318, 38092257506322000, 225238818, 225238825, 7, 1440x900 
0x37CA2318, 38092257506981216, 225238883, 225238891, 8, 1440x900 
0x37CA2318, 38092257507642560, 225238951, 225238958, 7, 1440x900 
0x37CA2318, 38092257508303072, 225239016, 225239023, 7, 1440x900 
0x37CA2318, 38092257508963768, 225239082, 225239089, 7, 1440x900 
0x37CA2318, 38092257509623472, 225239147, 225239155, 8, 1440x900 
0x37CA2318, 38092257510282952, 225239213, 225239220, 7, 1440x900 
0x37CA2318, 38092257511136256, 225239301, 225239308, 7, 1440x900 
0x37CA2318, 38092257511806224, 225239367, 225239375, 8, 1440x900 
0x37CA2318, 38092257512468784, 225239433, 225239440, 7, 1440x900 
0x37CA2318, 38092257513121296, 225239498, 225239505, 7, 1440x900 
0x37CA2318, 38092257513792696, 225239567, 225239574, 7, 1440x900 
0x37CA2318, 38092257514461552, 225239633, 225239641, 8, 1440x900 
0x37CA2318, 38092257515112112, 225239698, 225239705, 7, 1440x900 
0x37CA2318, 38092257516242616, 225239813, 225239822, 9, 1440x900 
0x37CA2318, 38092257516897832, 225239878, 225239885, 7, 1440x900 
0x37CA2318, 38092257517558048, 225239943, 225239951, 8, 1440x900 
0x37CA2318, 38092257518218896, 225240007, 225240015, 8, 1440x900 
0x37CA2318, 38092257518875120, 225240073, 225240081, 8, 1440x900 
0x37CA2318, 38092257519537824, 225240143, 225240151, 8, 1440x900 
0x37CA2318, 38092257520199888, 225240212, 225240220, 8, 1440x900 
0x37CA2318, 38092257520861504, 225240278, 225240286, 8, 1440x900 
0x37CA2318, 38092257521524336, 225240342, 225240350, 8, 1440x900 
0x37CA2318, 38092257522180032, 225240403, 225240411, 8, 1440x900 
0x37CA2318, 38092257522840576, 225240472, 225240480, 8, 1440x900 
0x37CA2318, 38092257523510360, 225240542, 225240551, 9, 1440x900 
0x37CA2318, 38092257524161864, 225240602, 225240609, 7, 1440x900 
0x37CA2318, 38092257524829728, 225240672, 225240680, 8, 1440x900 
0x37CA2318, 38092257525486488, 225240738, 225240746, 8, 1440x900 
0x37CA2318, 38092257526146568, 225240803, 225240811, 8, 1440x900 
0x37CA2318, 38092257527011552, 225240888, 225240897, 9, 1440x900 
0x37CA2318, 38092257527663856, 225240957, 225240965, 8, 1440x900 
0x37CA2318, 38092257528324840, 225241023, 225241031, 8, 1440x900 
0x37CA2318, 38092257528985776, 225241088, 225241096, 8, 1440x900 
0x37CA2318, 38092257529654768, 225241153, 225241160, 7, 1440x900 
0x37CA2318, 38092257530124376, 225241202, 225241210, 8, 1440x900 
0x37CA2318, 38092257530774408, 225241269, 225241277, 8, 1440x900 
0x37CA2318, 38092257531429840, 225241331, 225241339, 8, 1440x900 
0x37CA2318, 38092257532097776, 225241397, 225241404, 7, 1440x900 
0x37CA2318, 38092257532757640, 225241462, 225241470, 8, 1440x900 
0x37CA2318, 38092257533418864, 225241528, 225241535, 7, 1440x900 
0x37CA2318, 38092257534077848, 225241593, 225241601, 8, 1440x900 
0x37CA2318, 38092257534740336, 225241658, 225241666, 8, 1440x900 
0x37CA2318, 38092257535397832, 225241728, 225241735, 7, 1440x900 
0x37CA2318, 38092257536257472, 225241813, 225241821, 8, 1440x900 
0x37CA2318, 38092257536725680, 225241863, 225241871, 8, 1440x900 
0x37CA2318, 38092257537476016, 225241938, 225241946, 8, 1440x900 
0x37CA2318, 38092257538048528, 225241993, 225242001, 8, 1440x900 
0x37CA2318, 38092257538704576, 225242059, 225242067, 8, 1440x900 
0x37CA2318, 38092257539364528, 225242128, 225242136, 8, 1440x900 
0x37CA2318, 38092257540028608, 225242187, 225242195, 8, 1440x900 
0x37CA2318, 38092257540683432, 225242256, 225242263, 7, 1440x900 
0x37CA2318, 38092257541343448, 225242318, 225242326, 8, 1440x900 
0x37CA2318, 38092257542003624, 225242386, 225242393, 7, 1440x900 
0x37CA2318, 38092257542677424, 225242453, 225242460, 7, 1440x900 
0x37CA2318, 38092257543333544, 225242518, 225242525, 7, 1440x900 
0x37CA2318, 38092257543994848, 225242587, 225242594, 7, 1440x900 
0x37CA2318, 38092257544656728, 225242654, 225242662, 8, 1440x900 
0x37CA2318, 38092257545316376, 225242717, 225242726, 9, 1440x900 
0x37CA2318, 38092257545988224, 225242788, 225242795, 7, 1440x900 
0x37CA2318, 38092257546650824, 225242852, 225242860, 8, 1440x900 
0x37CA2318, 38092257547313240, 225242917, 225242925, 8, 1440x900 
0x37CA2318, 38092257547972328, 225242983, 225242992, 9, 1440x900 
0x37CA2318, 38092257548632376, 225243052, 225243059, 7, 1440x900 
0x37CA2318, 38092257549290776, 225243116, 225243124, 8, 1440x900 
0x37CA2318, 38092257549951432, 225243182, 225243190, 8, 1440x900 
0x37CA2318, 38092257550610760, 225243248, 225243255, 7, 1440x900 
0x37CA2318, 38092257551280640, 225243313, 225243321, 8, 1440x900 
0x37CA2318, 38092257551940392, 225243378, 225243386, 8, 1440x900 
0x37CA2318, 38092257552750480, 225243459, 225243467, 8, 1440x900 
0x37CA2318, 38092257553271112, 225243513, 225243521, 8, 1440x900 
0x37CA2318, 38092257553937768, 225243578, 225243586, 8, 1440x900 
0x37CA2318, 38092257554598416, 225243648, 225243655, 7, 1440x900 
0x37CA2318, 38092257555262016, 225243712, 225243720, 8, 1440x900 
0x37CA2318, 38092257555929008, 225243778, 225243786, 8, 1440x900 
0x37CA2318, 38092257556777672, 225243863, 225243871, 8, 1440x900 
0x37CA2318, 38092257557447632, 225243932, 225243940, 8, 1440x900 
0x37CA2318, 38092257557902152, 225243976, 225243984, 8, 1440x900 
0x37CA2318, 38092257558562232, 225244042, 225244050, 8, 1440x900 
0x37CA2318, 38092257559416656, 225244128, 225244135, 7, 1440x900 
0x37CA2318, 38092257560081744, 225244193, 225244201, 8, 1440x900 
0x37CA2318, 38092257560742808, 225244262, 225244270, 8, 1440x900 
0x37CA2318, 38092257561412176, 225244327, 225244335, 8, 1440x900 
0x37CA2318, 38092257562063032, 225244398, 225244406, 8, 1440x900 
0x37CA2318, 38092257562531512, 225244443, 225244451, 8, 1440x900 
0x37CA2318, 38092257563190912, 225244507, 225244516, 9, 1440x900 
0x37CA2318, 38092257563851768, 225244574, 225244582, 8, 1440x900 
0x37CA2318, 38092257564515640, 225244638, 225244647, 9, 1440x900 
0x37CA2318, 38092257565175072, 225244708, 225244716, 8, 1440x900 
0x37CA2318, 38092257565838848, 225244772, 225244780, 8, 1440x900 
0x37CA2318, 38092257566496248, 225244837, 225244846, 9, 1440x900 
0x37CA2318, 38092257567153280, 225244902, 225244909, 7, 1440x900 
0x37CA2318, 38092257567815104, 225244968, 225244976, 8, 1440x900 
0x37CA2318, 38092257568475400, 225245036, 225245044, 8, 1440x900 
0x37CA2318, 38092257569135152, 225245101, 225245109, 8, 1440x900 
0x37CA2318, 38092257569798264, 225245168, 225245176, 8, 1440x900 
0x37CA2318, 38092257570455424, 225245232, 225245240, 8, 1440x900 
0x37CA2318, 38092257571113664, 225245297, 225245304, 7, 1440x900 
0x37CA2318, 38092257571779432, 225245368, 225245376, 8, 1440x900 
0x37CA2318, 38092257572448968, 225245432, 225245440, 8, 1440x900 
0x37CA2318, 38092257573103776, 225245496, 225245503, 7, 1440x900 
0x37CA2318, 38092257573960624, 225245582, 225245590, 8, 1440x900 
0x37CA2318, 38092257574435552, 225245633, 225245641, 8, 1440x900 
0x37CA2318, 38092257575086824, 225245697, 225245706, 9, 1440x900 
0x37CA2318, 38092257575746904, 225245762, 225245771, 9, 1440x900 
0x37CA2318, 38092257576416312, 225245828, 225245838, 10, 1440x900 
0x37CA2318, 38092257577077608, 225245898, 225245906, 8, 1440x900 
0x37CA2318, 38092257577739032, 225245963, 225245971, 8, 1440x900 
0x37CA2318, 38092257578398136, 225246028, 225246036, 8, 1440x900 
0x37CA2318, 38092257579058336, 225246097, 225246105, 8, 1440x900 
0x37CA2318, 38092257579921744, 225246178, 225246188, 10, 1440x900 
0x37CA2318, 38092257580379736, 225246228, 225246236, 8, 1440x900 
0x37CA2318, 38092257581042808, 225246292, 225246300, 8, 1440x900 
0x37CA2318, 38092257581698568, 225246356, 225246363, 7, 1440x900 
0x37CA2318, 38092257582359824, 225246424, 225246433, 9, 1440x900 
0x37CA2318, 38092257583020320, 225246492, 225246500, 8, 1440x900 
0x37CA2318, 38092257583681808, 225246558, 225246566, 8, 1440x900 
0x37CA2318, 38092257585000360, 225246693, 225246701, 8, 1440x900 
0x37CA2318, 38092257585663608, 225246757, 225246765, 8, 1440x900 
0x37CA2318, 38092257586322560, 225246822, 225246831, 9, 1440x900 
0x37CA2318, 38092257586981312, 225246884, 225246892, 8, 1440x900 
0x37CA2318, 38092257587788760, 225246963, 225246971, 8, 1440x900 
0x37CA2318, 38092257588305000, 225247017, 225247025, 8, 1440x900 
0x37CA2318, 38092257588965296, 225247082, 225247090, 8, 1440x900 
0x37CA2318, 38092257589625056, 225247148, 225247157, 9, 1440x900 
0x37CA2318, 38092257590286400, 225247213, 225247222, 9, 1440x900 
0x37CA2318, 38092257590945440, 225247283, 225247290, 7, 1440x900 
0x37CA2318, 38092257591608072, 225247344, 225247352, 8, 1440x900 
0x37CA2318, 38092257592269800, 225247412, 225247419, 7, 1440x900 
0x37CA2318, 38092257592928536, 225247478, 225247485, 7, 1440x900 
0x37CA2318, 38092257593597552, 225247543, 225247551, 8, 1440x900 
0x37CA2318, 38092257594267888, 225247612, 225247618, 6, 1440x900 
0x37CA2318, 38092257594927120, 225247679, 225247686, 7, 1440x900 
0x37CA2318, 38092257595587184, 225247744, 225247752, 8, 1440x900 
0x37CA2318, 38092257596249184, 225247812, 225247819, 7, 1440x900 
0x37CA2318, 38092257596911144, 225247878, 225247885, 7, 1440x900 
0x37CA2318, 38092257597570992, 225247947, 225247954, 7, 1440x900 
0x37CA2318, 38092257598232880, 225248012, 225248020, 8, 1440x900 
0x37CA2318, 38092257599088584, 225248097, 225248105, 8, 1440x900 
0x37CA2318, 38092257599714760, 225248163, 225248171, 8, 1440x900 
0x37CA2318, 38092257600215216, 225248213, 225248221, 8, 1440x900 
0x37CA2318, 38092257600871296, 225248272, 225248279, 7, 1440x900 
0x37CA2318, 38092257601531200, 225248338, 225248346, 8, 1440x900 
0x37CA2318, 38092257602192544, 225248403, 225248411, 8, 1440x900 
0x37CA2318, 38092257602856304, 225248472, 225248480, 8, 1440x900 
0x37CA2318, 38092257603513856, 225248537, 225248544, 7, 1440x900 
0x37CA2318, 38092257604173184, 225248603, 225248610, 7, 1440x900 
0x37CA2318, 38092257604833832, 225248668, 225248677, 9, 1440x900 
0x37CA2318, 38092257605507384, 225248737, 225248746, 9, 1440x900 
0x37CA2318, 38092257606168984, 225248806, 225248814, 8, 1440x900 
0x37CA2318, 38092257606829704, 225248871, 225248879, 8, 1440x900 
0x37CA2318, 38092257607490656, 225248936, 225248945, 9, 1440x900 
0x37CA2318, 38092257608147824, 225249000, 225249009, 9, 1440x900 
0x37CA2318, 38092257608807232, 225249068, 225249075, 7, 1440x900 
0x37CA2318, 38092257609470104, 225249133, 225249143, 10, 1440x900 
0x37CA2318, 38092257610134832, 225249197, 225249205, 8, 1440x900 
0x37CA2318, 38092257610795088, 225249267, 225249274, 7, 1440x900 
0x37CA2318, 38092257611452928, 225249333, 225249340, 7, 1440x900 
0x37CA2318, 38092257612137288, 225249404, 225249411, 7, 1440x900 
0x37CA2318, 38092257612800848, 225249464, 225249473, 9, 1440x900 
0x37CA2318, 38092257613455664, 225249529, 225249538, 9, 1440x900 
0x37CA2318, 38092257614119160, 225249598, 225249606, 8, 1440x900 
0x37CA2318, 38092257614794152, 225249667, 225249674, 7, 1440x900 
0x37CA2318, 38092257615444904, 225249729, 225249738, 9, 1440x900 
0x37CA2318, 38092257616104192, 225249797, 225249804, 7, 1440x900 
0x37CA2318, 38092257616804896, 225249879, 225249888, 9, 1440x900 
0x37CA2318, 38092257617458712, 225249933, 225249944, 11, 1440x900 
0x37CA2318, 38092257618119904, 225249998, 225250005, 7, 1440x900 
0x37CA2318, 38092257618751936, 225250062, 225250069, 7, 1440x900 
0x37CA2318, 38092257619416496, 225250127, 225250135, 8, 1440x900 
0x37CA2318, 38092257620072560, 225250193, 225250200, 7, 1440x900 
0x37CA2318, 38092257620731456, 225250257, 225250264, 7, 1440x900 
0x37CA2318, 38092257621394696, 225250326, 225250333, 7, 1440x900 
0x37CA2318, 38092257622054264, 225250395, 225250404, 9, 1440x900 
0x37CA2318, 38092257622723064, 225250457, 225250465, 8, 1440x900 
0x37CA2318, 38092257623378776, 225250523, 225250531, 8, 1440x900 
0x37CA2318, 38092257624046576, 225250590, 225250600, 10, 1440x900 
0x37CA2318, 38092257624707440, 225250655, 225250664, 9, 1440x900 
0x37CA2318, 38092257625369408, 225250723, 225250730, 7, 1440x900 
0x37CA2318, 38092257626026960, 225250788, 225250796, 8, 1440x900 
0x37CA2318, 38092257626692424, 225250853, 225250861, 8, 1440x900 
0x37CA2318, 38092257627351432, 225250922, 225250929, 7, 1440x900 
0x37CA2318, 38092257628006328, 225250987, 225250994, 7, 1440x900 
0x37CA2318, 38092257628666736, 225251052, 225251060, 8, 1440x900 
0x37CA2318, 38092257629328008, 225251118, 225251126, 8, 1440x900 
0x37CA2318, 38092257629993584, 225251188, 225251195, 7, 1440x900 
0x37CA2318, 38092257630648040, 225251252, 225251259, 7, 1440x900 
0x37CA2318, 38092257631311336, 225251317, 225251325, 8, 1440x900 
0x37CA2318, 38092257631970680, 225251383, 225251391, 8, 1440x900 
0x37CA2318, 38092257632639112, 225251448, 225251457, 9, 1440x900 
0x37CA2318, 38092257633292720, 225251513, 225251522, 9, 1440x900 
0x37CA2318, 38092257633952512, 225251582, 225251590, 8, 1440x900 
0x37CA2318, 38092257634612544, 225251647, 225251655, 8, 1440x900 
0x37CA2318, 38092257635273352, 225251713, 225251720, 7, 1440x900 
0x37CA2318, 38092257636135552, 225251802, 225251810, 8, 1440x900 
0x37CA2318, 38092257636795480, 225251870, 225251879, 9, 1440x900 
0x37CA2318, 38092257637456128, 225251933, 225251943, 10, 1440x900 
0x37CA2318, 38092257638126312, 225252003, 225252011, 8, 1440x900 
0x37CA2318, 38092257638777320, 225252068, 225252076, 8, 1440x900 
0x37CA2318, 38092257639438104, 225252137, 225252145, 8, 1440x900 
0x37CA2318, 38092257640109928, 225252198, 225252205, 7, 1440x900 
0x37CA2318, 38092257640563280, 225252242, 225252257, 15, 1440x900 
0x37CA2318, 38092257641221856, 225252307, 225252315, 8, 1440x900 
0x37CA2318, 38092257641948800, 225252379, 225252388, 9, 1440x900 
0x37CA2318, 38092257642631304, 225252464, 225252475, 11, 1440x900 
0x37CA2318, 38092257643264720, 225252513, 225252521, 8, 1440x900 
0x37CA2318, 38092257643889416, 225252574, 225252581, 7, 1440x900 
0x37CA2318, 38092257644550008, 225252640, 225252648, 8, 1440x900 
0x37CA2318, 38092257645218104, 225252708, 225252714, 6, 1440x900 
0x37CA2318, 38092257645880584, 225252773, 225252782, 9, 1440x900 
0x37CA2318, 38092257646549176, 225252847, 225252855, 8, 1440x900 
0x37CA2318, 38092257647202008, 225252908, 225252914, 6, 1440x900 
0x37CA2318, 38092257647862728, 225252972, 225252979, 7, 1440x900 
0x37CA2318, 38092257648519032, 225253037, 225253045, 8, 1440x900 
0x37CA2318, 38092257649179168, 225253103, 225253112, 9, 1440x900 
0x37CA2318, 38092257649846360, 225253169, 225253177, 8, 1440x900 
0x37CA2318, 38092257650507616, 225253237, 225253244, 7, 1440x900 
0x37CA2318, 38092257651167264, 225253302, 225253309, 7, 1440x900 
0x37CA2318, 38092257651827032, 225253368, 225253375, 7, 1440x900 
0x37CA2318, 38092257652630392, 225253447, 225253455, 8, 1440x900 
0x37CA2318, 38092257653179392, 225253503, 225253510, 7, 1440x900 
0x37CA2318, 38092257653812136, 225253568, 225253575, 7, 1440x900 
0x37CA2318, 38092257654475120, 225253633, 225253640, 7, 1440x900 
0x37CA2318, 38092257655321048, 225253718, 225253725, 7, 1440x900 
0x37CA2318, 38092257656000416, 225253787, 225253794, 7, 1440x900 
0x37CA2318, 38092257656651728, 225253852, 225253859, 7, 1440x900 
0x37CA2318, 38092257657307824, 225253917, 225253924, 7, 1440x900 
0x37CA2318, 38092257657969256, 225253983, 225253993, 10, 1440x900 
0x37CA2318, 38092257658629736, 225254048, 225254055, 7, 1440x900 
0x37CA2318, 38092257659295208, 225254116, 225254123, 7, 1440x900 
0x37CA2318, 38092257659947904, 225254183, 225254192, 9, 1440x900 
0x37CA2318, 38092257660620648, 225254253, 225254261, 8, 1440x900 
0x37CA2318, 38092257661288104, 225254313, 225254320, 7, 1440x900 
0x37CA2318, 38092257661956080, 225254383, 225254390, 7, 1440x900 
0x37CA2318, 38092257663112000, 225254498, 225254508, 10, 1440x900 
0x37CA2318, 38092257663937232, 225254578, 225254588, 10, 1440x900 
0x37CA2318, 38092257664607000, 225254648, 225254656, 8, 1440x900 
0x37CA2318, 38092257665072384, 225254692, 225254702, 10, 1440x900 
0x37CA2318, 38092257665735360, 225254762, 225254769, 7, 1440x900 
0x37CA2318, 38092257666590376, 225254848, 225254855, 7, 1440x900 
0x37CA2318, 38092257667051736, 225254893, 225254901, 8, 1440x900 
0x37CA2318, 38092257667717152, 225254957, 225254965, 8, 1440x900 
0x37CA2318, 38092257668375904, 225255023, 225255031, 8, 1440x900 
0x37CA2318, 38092257669029480, 225255088, 225255096, 8, 1440x900 
0x37CA2318, 38092257669690416, 225255153, 225255160, 7, 1440x900 
0x37CA2318, 38092257670452728, 225255232, 225255238, 6, 1440x900 
0x37CA2318, 38092257671015080, 225255288, 225255295, 7, 1440x900 
0x37CA2318, 38092257671677104, 225255353, 225255361, 8, 1440x900 
0x37CA2318, 38092257672337400, 225255418, 225255426, 8, 1440x900 
0x37CA2318, 38092257672995384, 225255483, 225255490, 7, 1440x900 
0x37CA2318, 38092257673650360, 225255552, 225255559, 7, 1440x900 
0x37CA2318, 38092257674310896, 225255617, 225255624, 7, 1440x900 
0x37CA2318, 38092257674973096, 225255683, 225255689, 6, 1440x900 
0x37CA2318, 38092257675632912, 225255748, 225255755, 7, 1440x900 
0x37CA2318, 38092257676301904, 225255817, 225255824, 7, 1440x900 
0x37CA2318, 38092257676965312, 225255882, 225255889, 7, 1440x900 
0x37CA2318, 38092257677619944, 225255947, 225255954, 7, 1440x900 
0x37CA2318, 38092257678280736, 225256013, 225256020, 7, 1440x900 
0x37CA2318, 38092257678940272, 225256078, 225256085, 7, 1440x900 
0x37CA2318, 38092257679609432, 225256147, 225256154, 7, 1440x900 
0x37CA2318, 38092257680271336, 225256212, 225256219, 7, 1440x900 
0x37CA2318, 38092257680930040, 225256277, 225256284, 7, 1440x900 
0x37CA2318, 38092257681589888, 225256343, 225256350, 7, 1440x900 
0x37CA2318, 38092257682251168, 225256409, 225256416, 7, 1440x900 
0x37CA2318, 38092257682916968, 225256478, 225256489, 11, 1440x900 
0x37CA2318, 38092257683601520, 225256546, 225256553, 7, 1440x900 
0x37CA2318, 38092257684232240, 225256609, 225256617, 8, 1440x900 
0x37CA2318, 38092257684999664, 225256692, 225256699, 7, 1440x900 
0x37CA2318, 38092257685609520, 225256747, 225256758, 11, 1440x900 
0x37CA2318, 38092257686242048, 225256808, 225256815, 7, 1440x900 
0x37CA2318, 38092257686869592, 225256872, 225256879, 7, 1440x900 
0x37CA2318, 38092257687529672, 225256937, 225256945, 8, 1440x900 
0x37CA2318, 38092257688190104, 225257002, 225257010, 8, 1440x900 
0x37CA2318, 38092257688849608, 225257072, 225257079, 7, 1440x900 
0x37CA2318, 38092257689509696, 225257137, 225257144, 7, 1440x900 
0x37CA2318, 38092257690169720, 225257202, 225257209, 7, 1440x900 
0x37CA2318, 38092257690829952, 225257267, 225257274, 7, 1440x900 
0x37CA2318, 38092257691492208, 225257333, 225257341, 8, 1440x900 
0x37CA2318, 38092257692152904, 225257402, 225257409, 7, 1440x900 
0x37CA2318, 38092257692812408, 225257467, 225257474, 7, 1440x900 
0x37CA2318, 38092257693481816, 225257533, 225257541, 8, 1440x900 
0x37CA2318, 38092257694151448, 225257602, 225257609, 7, 1440x900 
0x37CA2318, 38092257694814696, 225257668, 225257675, 7, 1440x900 
0x37CA2318, 38092257695473328, 225257733, 225257740, 7, 1440x900 
0x37CA2318, 38092257696133288, 225257798, 225257806, 8, 1440x900 
0x37CA2318, 38092257696792912, 225257867, 225257875, 8, 1440x900 
0x37CA2318, 38092257697457472, 225257932, 225257940, 8, 1440x900 
0x37CA2318, 38092257698113248, 225257997, 225258005, 8, 1440x900 
0x37CA2318, 38092257698773216, 225258063, 225258071, 8, 1440x900 
0x37CA2318, 38092257699436040, 225258132, 225258140, 8, 1440x900 
0x37CA2318, 38092257700296928, 225258217, 225258226, 9, 1440x900 
0x37CA2318, 38092257700967544, 225258288, 225258297, 9, 1440x900 
0x37CA2318, 38092257701616816, 225258353, 225258361, 8, 1440x900 
0x37CA2318, 38092257702285832, 225258418, 225258427, 9, 1440x900 
0x37CA2318, 38092257702945592, 225258482, 225258490, 8, 1440x900 
0x37CA2318, 38092257703612408, 225258553, 225258562, 9, 1440x900 
0x37CA2318, 38092257704281688, 225258617, 225258624, 7, 1440x900 
0x37CA2318, 38092257704941624, 225258682, 225258689, 7, 1440x900 
0x37CA2318, 38092257705592592, 225258743, 225258751, 8, 1440x900 
0x37CA2318, 38092257706256736, 225258812, 225258819, 7, 1440x900 
0x37CA2318, 38092257706913552, 225258877, 225258884, 7, 1440x900 
0x37CA2318, 38092257707519904, 225258937, 225258948, 11, 1440x900 
0x37CA2318, 38092257708415360, 225259033, 225259052, 19, 1440x900 
0x37CA2318, 38092257708770184, 225259068, 225259083, 15, 1440x900 
0x37CA2318, 38092257709469712, 225259146, 225259173, 27, 1440x900 
0x37CA2318, 38092257710332424, 225259223, 225259263, 40, 1440x900 
0x37CA2318, 38092257710849296, 225259273, 225259311, 38, 1440x900 
0x37CA2318, 38092257711550128, 225259345, 225259361, 16, 1440x900 
0x37CA2318, 38092257712149168, 225259399, 225259407, 8, 1440x900 
0x37CA2318, 38092257712861888, 225259478, 225259496, 18, 1440x900 
0x37CA2318, 38092257713458296, 225259533, 225259540, 7, 1440x900 
0x37CA2318, 38092257714143512, 225259601, 225259622, 21, 1440x900 
0x37CA2318, 38092257714779768, 225259662, 225259674, 12, 1440x900 
0x37CA2318, 38092257715446512, 225259732, 225259749, 17, 1440x900 
0x37CA2318, 38092257716108112, 225259797, 225259805, 8, 1440x900 
0x37CA2318, 38092257716791024, 225259870, 225259888, 18, 1440x900 
0x37CA2318, 38092257717456656, 225259933, 225259950, 17, 1440x900 
0x37CA2318, 38092257718105872, 225259998, 225260007, 9, 1440x900 
0x37CA2318, 38092257718776952, 225260063, 225260072, 9, 1440x900 
0x37CA2318, 38092257719448592, 225260132, 225260150, 18, 1440x900 
0x37CA2318, 38092257720055960, 225260199, 225260206, 7, 1440x900 
0x37CA2318, 38092257720716872, 225260263, 225260270, 7, 1440x900 
0x37CA2318, 38092257721347496, 225260319, 225260326, 7, 1440x900 
0x37CA2318, 38092257722013432, 225260386, 225260397, 11, 1440x900 
0x37CA2318, 38092257722680368, 225260455, 225260463, 8, 1440x900 
0x37CA2318, 38092257723340936, 225260522, 225260529, 7, 1440x900 
0x37CA2318, 38092257723980288, 225260583, 225260591, 8, 1440x900 
0x37CA2318, 38092257724635808, 225260647, 225260655, 8, 1440x900 
0x37CA2318, 38092257725295888, 225260717, 225260723, 6, 1440x900 
0x37CA2318, 38092257725963080, 225260783, 225260790, 7, 1440x900 
0x37CA2318, 38092257726620592, 225260848, 225260855, 7, 1440x900 
0x37CA2318, 38092257727286920, 225260919, 225260926, 7, 1440x900 
0x37CA2318, 38092257727947864, 225260979, 225260987, 8, 1440x900 
0x37CA2318, 38092257729261520, 225261112, 225261120, 8, 1440x900 
0x37CA2318, 38092257729921888, 225261178, 225261185, 7, 1440x900 
0x37CA2318, 38092257730584168, 225261244, 225261252, 8, 1440x900 
0x37CA2318, 38092257731243960, 225261308, 225261316, 8, 1440x900 
0x37CA2318, 38092257731902304, 225261377, 225261384, 7, 1440x900 
0x37CA2318, 38092257732556664, 225261442, 225261449, 7, 1440x900 
0x37CA2318, 38092257733227984, 225261509, 225261517, 8, 1440x900 
0x37CA2318, 38092257733890824, 225261574, 225261582, 8, 1440x900 
0x37CA2318, 38092257734548744, 225261641, 225261648, 7, 1440x900 
0x37CA2318, 38092257735215024, 225261708, 225261715, 7, 1440x900 
0x37CA2318, 38092257735873424, 225261774, 225261781, 7, 1440x900 
0x37CA2318, 38092257736531248, 225261837, 225261845, 8, 1440x900 
0x37CA2318, 38092257737208080, 225261908, 225261916, 8, 1440x900 
0x37CA2318, 38092257737868040, 225261974, 225261982, 8, 1440x900 
0x37CA2318, 38092257738527608, 225262042, 225262050, 8, 1440x900 
0x37CA2318, 38092257739186160, 225262107, 225262114, 7, 1440x900 
0x37CA2318, 38092257739847264, 225262172, 225262179, 7, 1440x900 
0x37CA2318, 38092257740505888, 225262237, 225262244, 7, 1440x900 
0x37CA2318, 38092257741357904, 225262322, 225262329, 7, 1440x900 
0x37CA2318, 38092257742027344, 225262387, 225262395, 8, 1440x900 
0x37CA2318, 38092257742677136, 225262452, 225262460, 8, 1440x900 
0x37CA2318, 38092257743226960, 225262507, 225262515, 8, 1440x900 
0x37CA2318, 38092257743808664, 225262567, 225262574, 7, 1440x900 
0x37CA2318, 38092257744472256, 225262632, 225262639, 7, 1440x900 
0x37CA2318, 38092257745132744, 225262698, 225262706, 8, 1440x900 
0x37CA2318, 38092257745793136, 225262766, 225262773, 7, 1440x900 
0x37CA2318, 38092257746453624, 225262832, 225262840, 8, 1440x900 
0x37CA2318, 38092257747114488, 225262897, 225262904, 7, 1440x900 
0x37CA2318, 38092257747773976, 225262963, 225262971, 8, 1440x900 
0x37CA2318, 38092257748434568, 225263028, 225263036, 8, 1440x900 
0x37CA2318, 38092257749099912, 225263098, 225263106, 8, 1440x900 
0x37CA2318, 38092257749758808, 225263162, 225263169, 7, 1440x900 
0x37CA2318, 38092257750420472, 225263228, 225263236, 8, 1440x900 
0x37CA2318, 38092257751079880, 225263293, 225263301, 8, 1440x900 
0x37CA2318, 38092257751738608, 225263362, 225263370, 8, 1440x900 
0x37CA2318, 38092257752396904, 225263427, 225263434, 7, 1440x900 
0x37CA2318, 38092257753059872, 225263492, 225263499, 7, 1440x900 
0x37CA2318, 38092257753721968, 225263558, 225263565, 7, 1440x900 
0x37CA2318, 38092257754380000, 225263623, 225263632, 9, 1440x900 
0x37CA2318, 38092257755039704, 225263692, 225263699, 7, 1440x900 
0x37CA2318, 38092257755700704, 225263756, 225263764, 8, 1440x900 
0x37CA2318, 38092257756360312, 225263822, 225263830, 8, 1440x900 
0x37CA2318, 38092257757018864, 225263887, 225263895, 8, 1440x900 
0x37CA2318, 38092257757678768, 225263953, 225263961, 8, 1440x900 
0x37CA2318, 38092257758536344, 225264043, 225264052, 9, 1440x900 
0x37CA2318, 38092257759005264, 225264088, 225264097, 9, 1440x900 
0x37CA2318, 38092257759856864, 225264174, 225264182, 8, 1440x900 
0x37CA2318, 38092257760321200, 225264218, 225264226, 8, 1440x900 
0x37CA2318, 38092257760982256, 225264283, 225264291, 8, 1440x900 
0x37CA2318, 38092257761836104, 225264368, 225264376, 8, 1440x900 
0x37CA2318, 38092257762388960, 225264423, 225264432, 9, 1440x900 
0x37CA2318, 38092257763156232, 225264502, 225264509, 7, 1440x900 
0x37CA2318, 38092257763814536, 225264568, 225264576, 8, 1440x900 
0x37CA2318, 38092257764475568, 225264638, 225264646, 8, 1440x900 
0x37CA2318, 38092257765145544, 225264703, 225264710, 7, 1440x900 
0x37CA2318, 38092257765805224, 225264767, 225264775, 8, 1440x900 
0x37CA2318, 38092257766263912, 225264812, 225264820, 8, 1440x900 
0x37CA2318, 38092257766932640, 225264878, 225264886, 8, 1440x900 
0x37CA2318, 38092257767591456, 225264943, 225264952, 9, 1440x900 
0x37CA2318, 38092257768260056, 225265018, 225265027, 9, 1440x900 
0x37CA2318, 38092257768924472, 225265077, 225265086, 9, 1440x900 
0x37CA2318, 38092257769570640, 225265142, 225265150, 8, 1440x900 
0x37CA2318, 38092257770229064, 225265208, 225265216, 8, 1440x900 
0x37CA2318, 38092257770888304, 225265273, 225265281, 8, 1440x900 
0x37CA2318, 38092257771567496, 225265348, 225265357, 9, 1440x900 
0x37CA2318, 38092257772211000, 225265408, 225265417, 9, 1440x900 
0x37CA2318, 38092257772868600, 225265473, 225265481, 8, 1440x900 
0x37CA2318, 38092257773530912, 225265538, 225265547, 9, 1440x900 
0x37CA2318, 38092257774199824, 225265607, 225265614, 7, 1440x900 
0x37CA2318, 38092257774864496, 225265672, 225265679, 7, 1440x900 
0x37CA2318, 38092257775525456, 225265739, 225265747, 8, 1440x900 
0x37CA2318, 38092257776185528, 225265803, 225265811, 8, 1440x900 
0x37CA2318, 38092257776846288, 225265868, 225265877, 9, 1440x900 
0x37CA2318, 38092257777505608, 225265938, 225265944, 6, 1440x900 
0x37CA2318, 38092257778168008, 225266004, 225266011, 7, 1440x900 
0x37CA2318, 38092257778833840, 225266073, 225266080, 7, 1440x900 
0x37CA2318, 38092257779682928, 225266153, 225266161, 8, 1440x900 
0x37CA2318, 38092257780341128, 225266218, 225266226, 8, 1440x900 
0x37CA2318, 38092257781002208, 225266288, 225266296, 8, 1440x900 
0x37CA2318, 38092257781653864, 225266352, 225266361, 9, 1440x900 
0x37CA2318, 38092257782323800, 225266419, 225266427, 8, 1440x900 
0x37CA2318, 38092257782993976, 225266487, 225266496, 9, 1440x900 
0x37CA2318, 38092257783645072, 225266554, 225266563, 9, 1440x900 
0x37CA2318, 38092257784121760, 225266603, 225266611, 8, 1440x900 
0x37CA2318, 38092257784784624, 225266665, 225266674, 9, 1440x900 
0x37CA2318, 38092257785433392, 225266728, 225266736, 8, 1440x900 
0x37CA2318, 38092257786092312, 225266796, 225266804, 8, 1440x900 
0x37CA2318, 38092257786751840, 225266859, 225266867, 8, 1440x900 
0x37CA2318, 38092257787414824, 225266928, 225266936, 8, 1440x900 
0x37CA2318, 38092257788077616, 225266998, 225267006, 8, 1440x900 
0x37CA2318, 38092257788739056, 225267063, 225267071, 8, 1440x900 
0x37CA2318, 38092257789397936, 225267127, 225267136, 9, 1440x900 
0x37CA2318, 38092257790059968, 225267197, 225267205, 8, 1440x900 
0x37CA2318, 38092257790713232, 225267257, 225267265, 8, 1440x900 
0x37CA2318, 38092257791371680, 225267322, 225267330, 8, 1440x900 
0x37CA2318, 38092257792032752, 225267388, 225267396, 8, 1440x900 
0x37CA2318, 38092257792894456, 225267477, 225267484, 7, 1440x900 
0x37CA2318, 38092257793361024, 225267524, 225267532, 8, 1440x900 
0x37CA2318, 38092257794684320, 225267652, 225267660, 8, 1440x900 
0x37CA2318, 38092257795343472, 225267718, 225267726, 8, 1440x900 
0x37CA2318, 38092257796004240, 225267787, 225267794, 7, 1440x900 
0x37CA2318, 38092257796660216, 225267852, 225267859, 7, 1440x900 
0x37CA2318, 38092257797321208, 225267918, 225267926, 8, 1440x900 
0x37CA2318, 38092257797984792, 225267982, 225267990, 8, 1440x900 
0x37CA2318, 38092257798641088, 225268048, 225268057, 9, 1440x900 
0x37CA2318, 38092257799304296, 225268117, 225268125, 8, 1440x900 
0x37CA2318, 38092257799965592, 225268183, 225268191, 8, 1440x900 
0x37CA2318, 38092257800624832, 225268248, 225268256, 8, 1440x900 
0x37CA2318, 38092257801292720, 225268317, 225268324, 7, 1440x900 
0x37CA2318, 38092257801955736, 225268383, 225268390, 7, 1440x900 
0x37CA2318, 38092257802612736, 225268449, 225268457, 8, 1440x900 
0x37CA2318, 38092257803272640, 225268513, 225268522, 9, 1440x900 
0x37CA2318, 38092257803944464, 225268584, 225268592, 8, 1440x900 
0x37CA2318, 38092257804603040, 225268647, 225268655, 8, 1440x900 
0x37CA2318, 38092257805261944, 225268719, 225268750, 31, 1440x900 
0x37CA2318, 38092257805949696, 225268789, 225268798, 9, 1440x900 
0x37CA2318, 38092257806609200, 225268845, 225268867, 22, 1440x900 
0x37CA2318, 38092257807271840, 225268914, 225268932, 18, 1440x900 
0x37CA2318, 38092257807933240, 225268984, 225269001, 17, 1440x900 
0x37CA2318, 38092257808589696, 225269043, 225269065, 22, 1440x900 
0x37CA2318, 38092257809248672, 225269108, 225269119, 11, 1440x900 
0x37CA2318, 38092257809907024, 225269177, 225269185, 8, 1440x900 
0x37CA2318, 38092257810852520, 225269272, 225269282, 10, 1440x900 
0x37CA2318, 38092257811364472, 225269322, 225269331, 9, 1440x900 
0x37CA2318, 38092257811895288, 225269376, 225269385, 9, 1440x900 
0x37CA2318, 38092257812805368, 225269471, 225269479, 8, 1440x900 
0x37CA2318, 38092257813261104, 225269518, 225269530, 12, 1440x900 
0x37CA2318, 38092257813893824, 225269575, 225269584, 9, 1440x900 
0x37CA2318, 38092257814669232, 225269652, 225269661, 9, 1440x900 
0x37CA2318, 38092257815218648, 225269707, 225269714, 7, 1440x900 
0x37CA2318, 38092257816060880, 225269793, 225269801, 8, 1440x900 
0x37CA2318, 38092257816720704, 225269862, 225269870, 8, 1440x900 
0x37CA2318, 38092257817372576, 225269927, 225269935, 8, 1440x900 
0x37CA2318, 38092257818040448, 225269993, 225270001, 8, 1440x900 
0x37CA2318, 38092257818702592, 225270059, 225270067, 8, 1440x900 
0x37CA2318, 38092257819365424, 225270127, 225270135, 8, 1440x900 
0x37CA2318, 38092257820026112, 225270192, 225270201, 9, 1440x900 
0x37CA2318, 38092257820686328, 225270258, 225270266, 8, 1440x900 
0x37CA2318, 38092257821441240, 225270334, 225270355, 21, 1440x900 
0x37CA2318, 38092257821925488, 225270379, 225270388, 9, 1440x900 
0x37CA2318, 38092257822513568, 225270444, 225270456, 12, 1440x900 
0x37CA2318, 38092257823165992, 225270502, 225270509, 7, 1440x900 
0x37CA2318, 38092257824000440, 225270587, 225270595, 8, 1440x900 
0x37CA2318, 38092257824652736, 225270652, 225270659, 7, 1440x900 
0x37CA2318, 38092257825323200, 225270723, 225270731, 8, 1440x900 
0x37CA2318, 38092257825958272, 225270782, 225270789, 7, 1440x900 
0x37CA2318, 38092257826438776, 225270828, 225270836, 8, 1440x900 
0x37CA2318, 38092257827095968, 225270894, 225270902, 8, 1440x900 
0x37CA2318, 38092257827756008, 225270963, 225270971, 8, 1440x900 
0x37CA2318, 38092257828452704, 225271032, 225271039, 7, 1440x900 
0x37CA2318, 38092257829093024, 225271098, 225271105, 7, 1440x900 
0x37CA2318, 38092257829754448, 225271163, 225271170, 7, 1440x900 
0x37CA2318, 38092257830451080, 225271233, 225271242, 9, 1440x900 
0x37CA2318, 38092257831086848, 225271293, 225271302, 9, 1440x900 
0x37CA2318, 38092257831749168, 225271362, 225271371, 9, 1440x900 
0x37CA2318, 38092257832411680, 225271428, 225271436, 8, 1440x900 
0x37CA2318, 38092257833079632, 225271493, 225271502, 9, 1440x900 
0x37CA2318, 38092257833724176, 225271558, 225271565, 7, 1440x900 
0x37CA2318, 38092257834385360, 225271627, 225271635, 8, 1440x900 
0x37CA2318, 38092257835054288, 225271693, 225271702, 9, 1440x900 
0x37CA2318, 38092257835719680, 225271763, 225271770, 7, 1440x900 
0x37CA2318, 38092257836380992, 225271827, 225271835, 8, 1440x900 
0x37CA2318, 38092257837052592, 225271897, 225271906, 9, 1440x900 
0x37CA2318, 38092257837697296, 225271957, 225271965, 8, 1440x900 
0x37CA2318, 38092257838356320, 225272023, 225272031, 8, 1440x900 
0x37CA2318, 38092257839018064, 225272088, 225272096, 8, 1440x900 
0x37CA2318, 38092257839677648, 225272153, 225272161, 8, 1440x900 
0x37CA2318, 38092257840336752, 225272218, 225272226, 8, 1440x900 
0x37CA2318, 38092257840989888, 225272288, 225272295, 7, 1440x900 
0x37CA2318, 38092257841654656, 225272352, 225272360, 8, 1440x900 
0x37CA2318, 38092257842346104, 225272423, 225272431, 8, 1440x900 
0x37CA2318, 38092257842994896, 225272487, 225272495, 8, 1440x900 
0x37CA2318, 38092257843658488, 225272554, 225272562, 8, 1440x900 
0x37CA2318, 38092257844320576, 225272618, 225272627, 9, 1440x900 
0x37CA2318, 38092257844977800, 225272686, 225272697, 11, 1440x900 
0x37CA2318, 38092257845634824, 225272751, 225272759, 8, 1440x900 
0x37CA2318, 38092257846486112, 225272838, 225272846, 8, 1440x900 
0x37CA2318, 38092257846986176, 225272895, 225272904, 9, 1440x900 
0x37CA2318, 38092257847615320, 225272948, 225272955, 7, 1440x900 
0x37CA2318, 38092257848274360, 225273013, 225273022, 9, 1440x900 
0x37CA2318, 38092257848937560, 225273083, 225273090, 7, 1440x900 
0x37CA2318, 38092257849597584, 225273147, 225273156, 9, 1440x900 
0x37CA2318, 38092257850268048, 225273213, 225273221, 8, 1440x900 
0x37CA2318, 38092257850928328, 225273278, 225273286, 8, 1440x900 
0x37CA2318, 38092257851586352, 225273344, 225273353, 9, 1440x900 
0x37CA2318, 38092257852254560, 225273411, 225273420, 9, 1440x900 
0x37CA2318, 38092257852935176, 225273483, 225273492, 9, 1440x900 
0x37CA2318, 38092257853587504, 225273546, 225273554, 8, 1440x900 
0x37CA2318, 38092257854445048, 225273628, 225273637, 9, 1440x900 
0x37CA2318, 38092257854909872, 225273688, 225273696, 8, 1440x900 
0x37CA2318, 38092257855593328, 225273746, 225273754, 8, 1440x900 
0x37CA2318, 38092257856237792, 225273813, 225273820, 7, 1440x900 
0x37CA2318, 38092257856908048, 225273879, 225273888, 9, 1440x900 
0x37CA2318, 38092257857561872, 225273948, 225273956, 8, 1440x900 
0x37CA2318, 38092257858408360, 225274030, 225274038, 8, 1440x900 
0x37CA2318, 38092257858873840, 225274074, 225274082, 8, 1440x900 
0x37CA2318, 38092257859542032, 225274139, 225274147, 8, 1440x900 
0x37CA2318, 38092257860210192, 225274208, 225274216, 8, 1440x900 
0x37CA2318, 38092257860877712, 225274273, 225274282, 9, 1440x900 
0x37CA2318, 38092257861536368, 225274342, 225274350, 8, 1440x900 
0x37CA2318, 38092257862195184, 225274403, 225274411, 8, 1440x900 
0x37CA2318, 38092257863502192, 225274538, 225274545, 7, 1440x900 
0x37CA2318, 38092257864163688, 225274602, 225274611, 9, 1440x900 
0x37CA2318, 38092257864834608, 225274672, 225274680, 8, 1440x900 
0x37CA2318, 38092257865491608, 225274738, 225274746, 8, 1440x900 
0x37CA2318, 38092257866161856, 225274807, 225274814, 7, 1440x900 
0x37CA2318, 38092257866821840, 225274872, 225274880, 8, 1440x900 
0x37CA2318, 38092257867479736, 225274938, 225274946, 8, 1440x900 
0x37CA2318, 38092257868326320, 225275018, 225275026, 8, 1440x900 
0x37CA2318, 38092257868793520, 225275063, 225275071, 8, 1440x900 
0x37CA2318, 38092257869456024, 225275132, 225275141, 9, 1440x900 
0x37CA2318, 38092257870117904, 225275197, 225275207, 10, 1440x900 
0x37CA2318, 38092257870775600, 225275263, 225275270, 7, 1440x900 
0x37CA2318, 38092257871438128, 225275328, 225275337, 9, 1440x900 
0x37CA2318, 38092257872094504, 225275397, 225275404, 7, 1440x900 
0x37CA2318, 38092257872757664, 225275462, 225275469, 7, 1440x900 
0x37CA2318, 38092257873417456, 225275527, 225275535, 8, 1440x900 
0x37CA2318, 38092257874079800, 225275593, 225275601, 8, 1440x900 
0x37CA2318, 38092257874741088, 225275663, 225275671, 8, 1440x900 
0x37CA2318, 38092257875396936, 225275728, 225275736, 8, 1440x900 
0x37CA2318, 38092257876060736, 225275792, 225275800, 8, 1440x900 
0x37CA2318, 38092257876720944, 225275858, 225275866, 8, 1440x900 
0x37CA2318, 38092257877377464, 225275923, 225275931, 8, 1440x900 
0x37CA2318, 38092257878038440, 225275988, 225275996, 8, 1440x900 
0x37CA2318, 38092257878697584, 225276057, 225276064, 7, 1440x900 
0x37CA2318, 38092257879357664, 225276122, 225276129, 7, 1440x900 
0x37CA2318, 38092257880028336, 225276188, 225276197, 9, 1440x900 
0x37CA2318, 38092257880686144, 225276253, 225276262, 9, 1440x900 
0x37CA2318, 38092257881350496, 225276323, 225276330, 7, 1440x900 
0x37CA2318, 38092257882007656, 225276388, 225276396, 8, 1440x900 
0x37CA2318, 38092257882666688, 225276453, 225276460, 7, 1440x900 
0x37CA2318, 38092257883328080, 225276518, 225276526, 8, 1440x900 
0x37CA2318, 38092257883987256, 225276583, 225276591, 8, 1440x900 
0x37CA2318, 38092257884754832, 225276668, 225276676, 8, 1440x900 
0x37CA2318, 38092257885452400, 225276736, 225276744, 8, 1440x900 
0x37CA2318, 38092257885971896, 225276788, 225276796, 8, 1440x900 
0x37CA2318, 38092257886631072, 225276853, 225276861, 8, 1440x900 
0x37CA2318, 38092257887488704, 225276938, 225276947, 9, 1440x900 
0x37CA2318, 38092257888150496, 225277002, 225277011, 9, 1440x900 
0x37CA2318, 38092257888618832, 225277053, 225277061, 8, 1440x900 
0x37CA2318, 38092257889274896, 225277118, 225277127, 9, 1440x900 
0x37CA2318, 38092257889934872, 225277183, 225277192, 9, 1440x900 
0x37CA2318, 38092257890619224, 225277249, 225277258, 9, 1440x900 
0x37CA2318, 38092257891274056, 225277312, 225277320, 8, 1440x900 
0x37CA2318, 38092257891934128, 225277379, 225277387, 8, 1440x900 
0x37CA2318, 38092257892601832, 225277449, 225277458, 9, 1440x900 
0x37CA2318, 38092257893258944, 225277514, 225277523, 9, 1440x900 
0x37CA2318, 38092257893919200, 225277583, 225277591, 8, 1440x900 
0x37CA2318, 38092257894594360, 225277652, 225277660, 8, 1440x900 
0x37CA2318, 38092257895241520, 225277717, 225277726, 9, 1440x900 
0x37CA2318, 38092257895896880, 225277777, 225277785, 8, 1440x900 
0x37CA2318, 38092257896758368, 225277863, 225277872, 9, 1440x900 
0x37CA2318, 38092257897420104, 225277932, 225277940, 8, 1440x900 
0x37CA2318, 38092257898089360, 225277998, 225278006, 8, 1440x900 
0x37CA2318, 38092257898545608, 225278047, 225278056, 9, 1440x900 
0x37CA2318, 38092257899210088, 225278108, 225278115, 7, 1440x900 
0x37CA2318, 38092257899879568, 225278176, 225278184, 8, 1440x900 
0x37CA2318, 38092257900536872, 225278239, 225278249, 10, 1440x900 
0x37CA2318, 38092257901188496, 225278303, 225278312, 9, 1440x900 
0x37CA2318, 38092257901851712, 225278368, 225278377, 9, 1440x900 
0x37CA2318, 38092257902523792, 225278437, 225278447, 10, 1440x900 
0x37CA2318, 38092257903170040, 225278502, 225278511, 9, 1440x900 
0x37CA2318, 38092257903830992, 225278568, 225278578, 10, 1440x900 
0x37CA2318, 38092257904489464, 225278634, 225278642, 8, 1440x900 
0x37CA2318, 38092257905151016, 225278703, 225278712, 9, 1440x900 
0x37CA2318, 38092257905817296, 225278773, 225278782, 9, 1440x900 
0x37CA2318, 38092257906476944, 225278839, 225278848, 9, 1440x900 
0x37CA2318, 38092257907130280, 225278898, 225278906, 8, 1440x900 
0x37CA2318, 38092257907790696, 225278967, 225278975, 8, 1440x900 
0x37CA2318, 38092257908449304, 225279031, 225279038, 7, 1440x900 
0x37CA2318, 38092257909122472, 225279102, 225279111, 9, 1440x900 
0x37CA2318, 38092257909773464, 225279162, 225279170, 8, 1440x900 
0x37CA2318, 38092257910439984, 225279228, 225279236, 8, 1440x900 
0x37CA2318, 38092257911098728, 225279294, 225279302, 8, 1440x900 
0x37CA2318, 38092257911758864, 225279362, 225279370, 8, 1440x900 
0x37CA2318, 38092257912419400, 225279427, 225279435, 8, 1440x900 
0x37CA2318, 38092257913083696, 225279492, 225279500, 8, 1440x900 
0x37CA2318, 38092257913743792, 225279561, 225279568, 7, 1440x900 
0x37CA2318, 38092257914403616, 225279624, 225279632, 8, 1440x900 
0x37CA2318, 38092257915063936, 225279692, 225279699, 7, 1440x900 
0x37CA2318, 38092257915725968, 225279757, 225279765, 8, 1440x900 
0x37CA2318, 38092257916398952, 225279827, 225279834, 7, 1440x900 
0x37CA2318, 38092257917051968, 225279889, 225279899, 10, 1440x900 
0x37CA2318, 38092257917711280, 225279954, 225279963, 9, 1440x900 
0x37CA2318, 38092257918365800, 225280022, 225280030, 8, 1440x900 
0x37CA2318, 38092257919027168, 225280087, 225280095, 8, 1440x900 
0x37CA2318, 38092257919682328, 225280153, 225280161, 8, 1440x900 
0x37CA2318, 38092257920351496, 225280222, 225280230, 8, 1440x900 
0x37CA2318, 38092257921014312, 225280287, 225280294, 7, 1440x900 
0x37CA2318, 38092257921673248, 225280353, 225280360, 7, 1440x900 
0x37CA2318, 38092257922334112, 225280418, 225280426, 8, 1440x900 
0x37CA2318, 38092257922998976, 225280487, 225280494, 7, 1440x900 
0x37CA2318, 38092257924314736, 225280618, 225280626, 8, 1440x900 
0x37CA2318, 38092257924975592, 225280682, 225280690, 8, 1440x900 
0x37CA2318, 38092257925635128, 225280749, 225280757, 8, 1440x900 
0x37CA2318, 38092257926487432, 225280837, 225280844, 7, 1440x900 
0x37CA2318, 38092257926955024, 225280882, 225280890, 8, 1440x900 
0x37CA2318, 38092257927614912, 225280952, 225280961, 9, 1440x900 
0x37CA2318, 38092257928273728, 225281013, 225281021, 8, 1440x900 
0x37CA2318, 38092257928935072, 225281078, 225281086, 8, 1440x900 
0x37CA2318, 38092257929787464, 225281166, 225281174, 8, 1440x900 
0x37CA2318, 38092257930457984, 225281232, 225281240, 8, 1440x900 
0x37CA2318, 38092257931120448, 225281297, 225281305, 8, 1440x900 
0x37CA2318, 38092257931772072, 225281363, 225281372, 9, 1440x900 
0x37CA2318, 38092257932244208, 225281412, 225281420, 8, 1440x900 
0x37CA2318, 38092257932909416, 225281477, 225281486, 9, 1440x900 
0x37CA2318, 38092257933566576, 225281543, 225281552, 9, 1440x900 
0x37CA2318, 38092257934229680, 225281613, 225281621, 8, 1440x900 
0x37CA2318, 38092257935088000, 225281697, 225281706, 9, 1440x900 
0x37CA2318, 38092257935546568, 225281741, 225281749, 8, 1440x900 
0x37CA2318, 38092257936211496, 225281807, 225281815, 8, 1440x900 
0x37CA2318, 38092257936870672, 225281873, 225281881, 8, 1440x900 
0x37CA2318, 38092257937730704, 225281962, 225281970, 8, 1440x900 
0x37CA2318, 38092257938352800, 225282027, 225282036, 9, 1440x900 
0x37CA2318, 38092257938854240, 225282077, 225282087, 10, 1440x900 
0x37CA2318, 38092257939514912, 225282143, 225282152, 9, 1440x900 
0x37CA2318, 38092257940181280, 225282208, 225282217, 9, 1440x900 
0x37CA2318, 38092257940847336, 225282272, 225282281, 9, 1440x900 
0x37CA2318, 38092257941506168, 225282343, 225282351, 8, 1440x900 
0x37CA2318, 38092257942221208, 225282408, 225282415, 7, 1440x900 
0x37CA2318, 38092257942817000, 225282467, 225282475, 8, 1440x900 
0x37CA2318, 38092257943480248, 225282533, 225282542, 9, 1440x900 
0x37CA2318, 38092257944145872, 225282602, 225282610, 8, 1440x900 
0x37CA2318, 38092257944798216, 225282667, 225282675, 8, 1440x900 
0x37CA2318, 38092257945457976, 225282732, 225282740, 8, 1440x900 
0x37CA2318, 38092257946119648, 225282798, 225282806, 8, 1440x900 
0x37CA2318, 38092257946779416, 225282862, 225282870, 8, 1440x900 
0x37CA2318, 38092257947438584, 225282932, 225282940, 8, 1440x900 
0x37CA2318, 38092257948097976, 225282998, 225283006, 8, 1440x900 
0x37CA2318, 38092257948760640, 225283066, 225283074, 8, 1440x900 
0x37CA2318, 38092257949421848, 225283132, 225283139, 7, 1440x900 
0x37CA2318, 38092257950083088, 225283197, 225283206, 9, 1440x900 
0x37CA2318, 38092257950746336, 225283262, 225283270, 8, 1440x900 
0x37CA2318, 38092257951406568, 225283327, 225283335, 8, 1440x900 
0x37CA2318, 38092257952067824, 225283393, 225283401, 8, 1440x900 
0x37CA2318, 38092257952868520, 225283472, 225283481, 9, 1440x900 
0x37CA2318, 38092257953385088, 225283526, 225283534, 8, 1440x900 
0x37CA2318, 38092257954045384, 225283592, 225283600, 8, 1440x900 
0x37CA2318, 38092257954706304, 225283657, 225283665, 8, 1440x900 
0x37CA2318, 38092257955369808, 225283723, 225283731, 8, 1440x900 
0x37CA2318, 38092257956027648, 225283788, 225283795, 7, 1440x900 
0x37CA2318, 38092257956686976, 225283853, 225283861, 8, 1440x900 
0x37CA2318, 38092257957350592, 225283922, 225283928, 6, 1440x900 
0x37CA2318, 38092257958109712, 225283997, 225284006, 9, 1440x900 
0x37CA2318, 38092257958676416, 225284055, 225284063, 8, 1440x900 
0x37CA2318, 38092257959342128, 225284118, 225284126, 8, 1440x900 
0x37CA2318, 38092257959996064, 225284184, 225284191, 7, 1440x900 
0x37CA2318, 38092257960659656, 225284254, 225284262, 8, 1440x900 
0x37CA2318, 38092257961379560, 225284328, 225284336, 8, 1440x900 
0x37CA2318, 38092257961979008, 225284383, 225284391, 8, 1440x900 
0x37CA2318, 38092257962656056, 225284450, 225284459, 9, 1440x900 
0x37CA2318, 38092257963325624, 225284519, 225284526, 7, 1440x900 
0x37CA2318, 38092257963971568, 225284583, 225284590, 7, 1440x900 
0x37CA2318, 38092257964630688, 225284648, 225284657, 9, 1440x900 
0x37CA2318, 38092257965301960, 225284717, 225284724, 7, 1440x900 
0x37CA2318, 38092257965955648, 225284782, 225284789, 7, 1440x900 
0x37CA2318, 38092257966628816, 225284853, 225284865, 12, 1440x900 
0x37CA2318, 38092257967283616, 225284913, 225284922, 9, 1440x900 
0x37CA2318, 38092257967944072, 225284979, 225284988, 9, 1440x900 
0x37CA2318, 38092257968606064, 225285045, 225285058, 13, 1440x900 
0x37CA2318, 38092257969273872, 225285112, 225285121, 9, 1440x900 
0x37CA2318, 38092257969931120, 225285178, 225285186, 8, 1440x900 
0x37CA2318, 38092257970596960, 225285247, 225285254, 7, 1440x900 
0x37CA2318, 38092257971256800, 225285313, 225285321, 8, 1440x900 
0x37CA2318, 38092257971916480, 225285377, 225285386, 9, 1440x900 
0x37CA2318, 38092257972591392, 225285450, 225285460, 10, 1440x900 
0x37CA2318, 38092257973247400, 225285513, 225285520, 7, 1440x900 
0x37CA2318, 38092257973908464, 225285578, 225285587, 9, 1440x900 
0x37CA2318, 38092257974584488, 225285643, 225285652, 9, 1440x900 
0x37CA2318, 38092257975245080, 225285713, 225285724, 11, 1440x900 
0x37CA2318, 38092257975886216, 225285773, 225285781, 8, 1440x900 
0x37CA2318, 38092257976549616, 225285842, 225285850, 8, 1440x900 
0x37CA2318, 38092257977209880, 225285908, 225285915, 7, 1440x900 
0x37CA2318, 38092257977879984, 225285974, 225285981, 7, 1440x900 
0x37CA2318, 38092257978529120, 225286038, 225286046, 8, 1440x900 
0x37CA2318, 38092257979192792, 225286108, 225286116, 8, 1440x900 
0x37CA2318, 38092257979853032, 225286178, 225286186, 8, 1440x900 
0x37CA2318, 38092257980513584, 225286239, 225286248, 9, 1440x900 
0x37CA2318, 38092257981176472, 225286308, 225286316, 8, 1440x900 
0x37CA2318, 38092257981952520, 225286387, 225286396, 9, 1440x900 
0x37CA2318, 38092257982529088, 225286437, 225286446, 9, 1440x900 
0x37CA2318, 38092257983335880, 225286524, 225286543, 19, 1440x900 
0x37CA2318, 38092257983845120, 225286587, 225286611, 24, 1440x900 
0x37CA2318, 38092257984552952, 225286649, 225286658, 9, 1440x900 
0x37CA2318, 38092257985378032, 225286723, 225286749, 26, 1440x900 
0x37CA2318, 38092257985917032, 225286784, 225286795, 11, 1440x900 
0x37CA2318, 38092257986580512, 225286850, 225286869, 19, 1440x900 
0x37CA2318, 38092257987288320, 225286918, 225286961, 43, 1440x900 
0x37CA2318, 38092257987826704, 225286968, 225287011, 43, 1440x900 
0x37CA2318, 38092257989310968, 225287118, 225287125, 7, 1440x900 
0x37CA2318, 38092257989964056, 225287185, 225287194, 9, 1440x900 
0x37CA2318, 38092257990634784, 225287251, 225287259, 8, 1440x900 
0x37CA2318, 38092257991294664, 225287313, 225287325, 12, 1440x900 
0x37CA2318, 38092257991954768, 225287385, 225287392, 7, 1440x900 
0x37CA2318, 38092257992619296, 225287447, 225287454, 7, 1440x900 
0x37CA2318, 38092257993282568, 225287518, 225287524, 6, 1440x900 
0x37CA2318, 38092257993944864, 225287585, 225287592, 7, 1440x900 
0x37CA2318, 38092257994409696, 225287628, 225287639, 11, 1440x900 
0x37CA2318, 38092257995072000, 225287693, 225287702, 9, 1440x900 
0x37CA2318, 38092257995733680, 225287758, 225287767, 9, 1440x900 
0x37CA2318, 38092257996398280, 225287827, 225287839, 12, 1440x900 
0x37CA2318, 38092257997061240, 225287892, 225287901, 9, 1440x900 
0x37CA2318, 38092257997733728, 225287958, 225287967, 9, 1440x900 
0x37CA2318, 38092257998407520, 225288027, 225288040, 13, 1440x900 
0x37CA2318, 38092257999079184, 225288093, 225288108, 15, 1440x900 
0x37CA2318, 38092257999804160, 225288163, 225288186, 23, 1440x900 
0x37CA2318, 38092258000475296, 225288236, 225288254, 18, 1440x900 
0x37CA2318, 38092258001133264, 225288298, 225288320, 22, 1440x900 
0x37CA2318, 38092258001796496, 225288363, 225288385, 22, 1440x900 
0x37CA2318, 38092258002393056, 225288428, 225288439, 11, 1440x900 
0x37CA2318, 38092258003111960, 225288497, 225288514, 17, 1440x900 
0x37CA2318, 38092258003711424, 225288563, 225288578, 15, 1440x900 
0x37CA2318, 38092258004350368, 225288624, 225288637, 13, 1440x900 
0x37CA2318, 38092258005007464, 225288685, 225288703, 18, 1440x900 
0x37CA2318, 38092258005665240, 225288753, 225288760, 7, 1440x900 
0x37CA2318, 38092258006326096, 225288818, 225288835, 17, 1440x900 
0x37CA2318, 38092258006985584, 225288884, 225288892, 8, 1440x900 
0x37CA2318, 38092258007833424, 225288971, 225288979, 8, 1440x900 
0x37CA2318, 38092258008494608, 225289038, 225289046, 8, 1440x900 
0x37CA2318, 38092258008960568, 225289083, 225289089, 6, 1440x900 
0x37CA2318, 38092258009617680, 225289151, 225289159, 8, 1440x900 
0x37CA2318, 38092258010285064, 225289217, 225289225, 8, 1440x900 
0x37CA2318, 38092258010940832, 225289283, 225289292, 9, 1440x900 
0x37CA2318, 38092258011647632, 225289357, 225289365, 8, 1440x900 
0x37CA2318, 38092258012313208, 225289422, 225289430, 8, 1440x900 
0x37CA2318, 38092258012932608, 225289481, 225289489, 8, 1440x900 
0x37CA2318, 38092258013592944, 225289547, 225289554, 7, 1440x900 
0x37CA2318, 38092258014254184, 225289613, 225289620, 7, 1440x900 
0x37CA2318, 38092258014953400, 225289681, 225289688, 7, 1440x900 
0x37CA2318, 38092258015574704, 225289742, 225289750, 8, 1440x900 
0x37CA2318, 38092258016234416, 225289808, 225289816, 8, 1440x900 
0x37CA2318, 38092258016895176, 225289873, 225289881, 8, 1440x900 
0x37CA2318, 38092258017566152, 225289942, 225289949, 7, 1440x900 
0x37CA2318, 38092258018227848, 225290013, 225290021, 8, 1440x900 
0x37CA2318, 38092258018887568, 225290078, 225290088, 10, 1440x900 
0x37CA2318, 38092258019549520, 225290144, 225290152, 8, 1440x900 
0x37CA2318, 38092258020210488, 225290212, 225290221, 9, 1440x900 
0x37CA2318, 38092258020881776, 225290277, 225290286, 9, 1440x900 
0x37CA2318, 38092258021530536, 225290342, 225290351, 9, 1440x900 
0x37CA2318, 38092258022384584, 225290429, 225290437, 8, 1440x900 
0x37CA2318, 38092258023038240, 225290493, 225290501, 8, 1440x900 
0x37CA2318, 38092258023513448, 225290539, 225290548, 9, 1440x900 
0x37CA2318, 38092258024174824, 225290603, 225290611, 8, 1440x900 
0x37CA2318, 38092258025035592, 225290707, 225290717, 10, 1440x900 
0x37CA2318, 38092258025499008, 225290742, 225290749, 7, 1440x900 
0x37CA2318, 38092258026157688, 225290803, 225290811, 8, 1440x900 
0x37CA2318, 38092258026816984, 225290869, 225290876, 7, 1440x900 
0x37CA2318, 38092258027486384, 225290934, 225290941, 7, 1440x900 
0x37CA2318, 38092258028345312, 225291021, 225291029, 8, 1440x900 
0x37CA2318, 38092258028811568, 225291068, 225291076, 8, 1440x900 
0x37CA2318, 38092258029469904, 225291137, 225291144, 7, 1440x900 
0x37CA2318, 38092258030323560, 225291222, 225291230, 8, 1440x900 
0x37CA2318, 38092258030799272, 225291273, 225291281, 8, 1440x900 
0x37CA2318, 38092258031456768, 225291332, 225291339, 7, 1440x900 
0x37CA2318, 38092258032120904, 225291398, 225291406, 8, 1440x900 
0x37CA2318, 38092258032780720, 225291463, 225291471, 8, 1440x900 
0x37CA2318, 38092258033438888, 225291531, 225291539, 8, 1440x900 
0x37CA2318, 38092258034210608, 225291609, 225291617, 8, 1440x900 
0x37CA2318, 38092258034759008, 225291664, 225291671, 7, 1440x900 
0x37CA2318, 38092258035450816, 225291737, 225291747, 10, 1440x900 
0x37CA2318, 38092258036076864, 225291792, 225291800, 8, 1440x900 
0x37CA2318, 38092258036738968, 225291858, 225291866, 8, 1440x900 
0x37CA2318, 38092258037590184, 225291946, 225291954, 8, 1440x900 
0x37CA2318, 38092258038064304, 225291993, 225292000, 7, 1440x900 
0x37CA2318, 38092258038722832, 225292057, 225292065, 8, 1440x900 
0x37CA2318, 38092258039383432, 225292122, 225292129, 7, 1440x900 
0x37CA2318, 38092258040053600, 225292197, 225292205, 8, 1440x900 
0x37CA2318, 38092258040706440, 225292257, 225292266, 9, 1440x900 
0x37CA2318, 38092258041563648, 225292342, 225292351, 9, 1440x900 
0x37CA2318, 38092258042223008, 225292409, 225292417, 8, 1440x900 
0x37CA2318, 38092258042688696, 225292459, 225292467, 8, 1440x900 
0x37CA2318, 38092258043349968, 225292523, 225292531, 8, 1440x900 
0x37CA2318, 38092258044009912, 225292593, 225292601, 8, 1440x900 
0x37CA2318, 38092258044677512, 225292659, 225292667, 8, 1440x900 
0x37CA2318, 38092258045525800, 225292743, 225292751, 8, 1440x900 
0x37CA2318, 38092258046195280, 225293448, 225293457, 9, 1440x900 
0x37CA2318, 38092258052703016, 225293458, 225293468, 10, 1440x900 
0x37CA2318, 38092258053039936, 225293488, 225293497, 9, 1440x900 
0x37CA2318, 38092258053570576, 225293543, 225293551, 8, 1440x900 
0x37CA2318, 38092258054230088, 225293608, 225293616, 8, 1440x900 
0x37CA2318, 38092258054713400, 225293657, 225293664, 7, 1440x900 
0x37CA2318, 38092258056014000, 225293787, 225293794, 7, 1440x900 
0x37CA2318, 38092258056677232, 225293857, 225293865, 8, 1440x900 
0x37CA2318, 38092258057523632, 225293943, 225293951, 8, 1440x900 
0x37CA2318, 38092258057996920, 225293989, 225293997, 8, 1440x900 
0x37CA2318, 38092258058672608, 225294053, 225294062, 9, 1440x900 
0x37CA2318, 38092258059334240, 225294118, 225294128, 10, 1440x900 
0x37CA2318, 38092258059994880, 225294183, 225294193, 10, 1440x900 
0x37CA2318, 38092258060785584, 225294277, 225294294, 17, 1440x900 
0x37CA2318, 38092258061534976, 225294337, 225294354, 17, 1440x900 
0x37CA2318, 38092258062124008, 225294413, 225294427, 14, 1440x900 
0x37CA2318, 38092258062933264, 225294485, 225294500, 15, 1440x900 
0x37CA2318, 38092258063438504, 225294532, 225294540, 8, 1440x900 
0x37CA2318, 38092258064097760, 225294597, 225294603, 6, 1440x900 
0x37CA2318, 38092258064761384, 225294665, 225294683, 18, 1440x900 
0x37CA2318, 38092258065426648, 225294735, 225294746, 11, 1440x900 
0x37CA2318, 38092258066087376, 225294800, 225294814, 14, 1440x900 
0x37CA2318, 38092258066747240, 225294864, 225294878, 14, 1440x900 
0x37CA2318, 38092258067418472, 225294929, 225294947, 18, 1440x900 
0x37CA2318, 38092258068064704, 225294993, 225295012, 19, 1440x900 
0x37CA2318, 38092258068735216, 225295064, 225295084, 20, 1440x900 
0x37CA2318, 38092258069504432, 225295138, 225295146, 8, 1440x900 
0x37CA2318, 38092258070174648, 225295212, 225295220, 8, 1440x900 
0x37CA2318, 38092258070741144, 225295258, 225295267, 9, 1440x900 
0x37CA2318, 38092258071443168, 225295333, 225295355, 22, 1440x900 
0x37CA2318, 38092258072039504, 225295389, 225295396, 7, 1440x900 
0x37CA2318, 38092258072895240, 225295477, 225295485, 8, 1440x900 
0x37CA2318, 38092258073538056, 225295542, 225295549, 7, 1440x900 
0x37CA2318, 38092258074207664, 225295613, 225295622, 9, 1440x900 
0x37CA2318, 38092258074723608, 225295662, 225295675, 13, 1440x900 
0x37CA2318, 38092258075399680, 225295727, 225295736, 9, 1440x900 
0x37CA2318, 38092258076131840, 225295798, 225295811, 13, 1440x900 
0x37CA2318, 38092258076727120, 225295869, 225295900, 31, 1440x900 
0x37CA2318, 38092258077481840, 225295939, 225295961, 22, 1440x900 
0x37CA2318, 38092258078039312, 225295987, 225295998, 11, 1440x900 
0x37CA2318, 38092258078807448, 225296069, 225296097, 28, 1440x900 
0x37CA2318, 38092258079506608, 225296137, 225296150, 13, 1440x900 
0x37CA2318, 38092258080091336, 225296196, 225296234, 38, 1440x900 
0x37CA2318, 38092258080798136, 225296275, 225296285, 10, 1440x900 
0x37CA2318, 38092258081415216, 225296335, 225296362, 27, 1440x900 
0x37CA2318, 38092258082014424, 225296387, 225296394, 7, 1440x900 
0x37CA2318, 38092258082646800, 225296452, 225296459, 7, 1440x900 
0x37CA2318, 38092258083344368, 225296522, 225296532, 10, 1440x900 
0x37CA2318, 38092258083998864, 225296587, 225296595, 8, 1440x900 
0x37CA2318, 38092258084639016, 225296651, 225296659, 8, 1440x900 
0x37CA2318, 38092258085297592, 225296713, 225296721, 8, 1440x900 
0x37CA2318, 38092258085956648, 225296782, 225296789, 7, 1440x900 
0x37CA2318, 38092258086636760, 225296848, 225296856, 8, 1440x900 
0x37CA2318, 38092258087289472, 225296913, 225296921, 8, 1440x900 
0x37CA2318, 38092258087960136, 225296982, 225296989, 7, 1440x900 
0x37CA2318, 38092258088621304, 225297047, 225297056, 9, 1440x900 
0x37CA2318, 38092258089262664, 225297112, 225297120, 8, 1440x900 
0x37CA2318, 38092258089922256, 225297179, 225297187, 8, 1440x900 
0x37CA2318, 38092258090583488, 225297244, 225297252, 8, 1440x900 
0x37CA2318, 38092258091249072, 225297314, 225297322, 8, 1440x900 
0x37CA2318, 38092258091909808, 225297378, 225297386, 8, 1440x900 
0x37CA2318, 38092258092568832, 225297447, 225297454, 7, 1440x900 
0x37CA2318, 38092258093225040, 225297513, 225297520, 7, 1440x900 
0x37CA2318, 38092258093893592, 225297583, 225297591, 8, 1440x900 
0x37CA2318, 38092258094547184, 225297642, 225297649, 7, 1440x900 
0x37CA2318, 38092258095410576, 225297727, 225297735, 8, 1440x900 
0x37CA2318, 38092258095867056, 225297772, 225297780, 8, 1440x900 
0x37CA2318, 38092258096528192, 225297837, 225297845, 8, 1440x900 
0x37CA2318, 38092258097188160, 225297903, 225297912, 9, 1440x900 
0x37CA2318, 38092258097848104, 225297969, 225297976, 7, 1440x900 
0x37CA2318, 38092258098512288, 225298037, 225298046, 9, 1440x900 
0x37CA2318, 38092258099172896, 225298103, 225298112, 9, 1440x900 
0x37CA2318, 38092258099833688, 225298169, 225298177, 8, 1440x900 
0x37CA2318, 38092258100497056, 225298236, 225298244, 8, 1440x900 
0x37CA2318, 38092258101165208, 225298303, 225298311, 8, 1440x900 
0x37CA2318, 38092258101819000, 225298373, 225298383, 10, 1440x900 
0x37CA2318, 38092258102470784, 225298433, 225298440, 7, 1440x900 
0x37CA2318, 38092258103145384, 225298507, 225298515, 8, 1440x900 
0x37CA2318, 38092258103805896, 225298572, 225298580, 8, 1440x900 
0x37CA2318, 38092258104649904, 225298653, 225298661, 8, 1440x900 
0x37CA2318, 38092258105310936, 225298718, 225298726, 8, 1440x900 
0x37CA2318, 38092258105972416, 225298787, 225298795, 8, 1440x900 
0x37CA2318, 38092258106632216, 225298853, 225298861, 8, 1440x900 
0x37CA2318, 38092258107294352, 225298917, 225298926, 9, 1440x900 
0x37CA2318, 38092258107954232, 225298983, 225298990, 7, 1440x900 
0x37CA2318, 38092258108606920, 225299046, 225299054, 8, 1440x900 
0x37CA2318, 38092258109277056, 225299116, 225299124, 8, 1440x900 
0x37CA2318, 38092258109868488, 225299173, 225299181, 8, 1440x900 
0x37CA2318, 38092258110405520, 225299228, 225299236, 8, 1440x900 
0x37CA2318, 38092258111066280, 225299292, 225299302, 10, 1440x900 
0x37CA2318, 38092258111916808, 225299383, 225299392, 9, 1440x900 
0x37CA2318, 38092258112577808, 225299448, 225299456, 8, 1440x900 
0x37CA2318, 38092258113238336, 225299512, 225299520, 8, 1440x900 
0x37CA2318, 38092258113907392, 225299583, 225299591, 8, 1440x900 
0x37CA2318, 38092258114370584, 225299623, 225299632, 9, 1440x900 
0x37CA2318, 38092258115041400, 225299692, 225299701, 9, 1440x900 
0x37CA2318, 38092258115693992, 225299763, 225299773, 10, 1440x900 
0x37CA2318, 38092258116357752, 225299822, 225299830, 8, 1440x900 
0x37CA2318, 38092258117022488, 225299887, 225299896, 9, 1440x900 
0x37CA2318, 38092258117683184, 225299958, 225299966, 8, 1440x900 
0x37CA2318, 38092258118334280, 225300022, 225300031, 9, 1440x900 
0x37CA2318, 38092258119001480, 225300086, 225300093, 7, 1440x900 
0x37CA2318, 38092258119659792, 225300152, 225300159, 7, 1440x900 
0x37CA2318, 38092258120328176, 225300223, 225300231, 8, 1440x900 
0x37CA2318, 38092258120986768, 225300288, 225300296, 8, 1440x900 
0x37CA2318, 38092258121836288, 225300378, 225300386, 8, 1440x900 
0x37CA2318, 38092258122487856, 225300438, 225300446, 8, 1440x900 
0x37CA2318, 38092258123148872, 225300507, 225300515, 8, 1440x900 
0x37CA2318, 38092258123792792, 225300573, 225300581, 8, 1440x900 
0x37CA2318, 38092258124283528, 225300613, 225300622, 9, 1440x900 
0x37CA2318, 38092258124942192, 225300682, 225300690, 8, 1440x900 
0x37CA2318, 38092258125601728, 225300746, 225300753, 7, 1440x900 
0x37CA2318, 38092258126270264, 225300813, 225300822, 9, 1440x900 
0x37CA2318, 38092258127592496, 225300947, 225300955, 8, 1440x900 
0x37CA2318, 38092258128256392, 225301017, 225301025, 8, 1440x900 
0x37CA2318, 38092258128917240, 225301082, 225301090, 8, 1440x900 
0x37CA2318, 38092258129633648, 225301153, 225301162, 9, 1440x900 
0x37CA2318, 38092258130230832, 225301207, 225301216, 9, 1440x900 
0x37CA2318, 38092258130891488, 225301278, 225301285, 7, 1440x900 
0x37CA2318, 38092258131755872, 225301363, 225301370, 7, 1440x900 
0x37CA2318, 38092258132411704, 225301432, 225301440, 8, 1440x900 
0x37CA2318, 38092258133071824, 225301498, 225301507, 9, 1440x900 
0x37CA2318, 38092258133538504, 225301538, 225301546, 8, 1440x900 
0x37CA2318, 38092258134199880, 225301606, 225301614, 8, 1440x900 
0x37CA2318, 38092258134862048, 225301672, 225301680, 8, 1440x900 
0x37CA2318, 38092258135547184, 225301742, 225301750, 8, 1440x900 
0x37CA2318, 38092258136188400, 225301803, 225301811, 8, 1440x900 
0x37CA2318, 38092258137039232, 225301892, 225301900, 8, 1440x900 
0x37CA2318, 38092258137629360, 225301948, 225301957, 9, 1440x900 
0x37CA2318, 38092258138177776, 225302007, 225302015, 8, 1440x900 
0x37CA2318, 38092258138839736, 225302069, 225302077, 8, 1440x900 
0x37CA2318, 38092258139498568, 225302138, 225302145, 7, 1440x900 
0x37CA2318, 38092258140166848, 225302203, 225302210, 7, 1440x900 
0x37CA2318, 38092258140820592, 225302268, 225302276, 8, 1440x900 
0x37CA2318, 38092258141662808, 225302353, 225302361, 8, 1440x900 
0x37CA2318, 38092258142194840, 225302407, 225302415, 8, 1440x900 
0x37CA2318, 38092258142995696, 225302488, 225302496, 8, 1440x900 
0x37CA2318, 38092258143470272, 225302536, 225302544, 8, 1440x900 
0x37CA2318, 38092258144124848, 225302598, 225302606, 8, 1440x900 
0x37CA2318, 38092258144909312, 225302678, 225302686, 8, 1440x900 
0x37CA2318, 38092258145445400, 225302733, 225302740, 7, 1440x900 
0x37CA2318, 38092258146102584, 225302797, 225302806, 9, 1440x900 
0x37CA2318, 38092258146763144, 225302862, 225302869, 7, 1440x900 
0x37CA2318, 38092258147427688, 225302928, 225302936, 8, 1440x900 
0x37CA2318, 38092258148088008, 225302993, 225303002, 9, 1440x900 
0x37CA2318, 38092258148749520, 225303062, 225303071, 9, 1440x900 
0x37CA2318, 38092258149409056, 225303127, 225303136, 9, 1440x900 
0x37CA2318, 38092258150072352, 225303193, 225303201, 8, 1440x900 
0x37CA2318, 38092258150730496, 225303258, 225303266, 8, 1440x900 
0x37CA2318, 38092258151385464, 225303327, 225303336, 9, 1440x900 
0x37CA2318, 38092258152049392, 225303392, 225303400, 8, 1440x900 
0x37CA2318, 38092258152714640, 225303457, 225303465, 8, 1440x900 
0x37CA2318, 38092258153374808, 225303523, 225303530, 7, 1440x900 
0x37CA2318, 38092258154034792, 225303588, 225303596, 8, 1440x900 
0x37CA2318, 38092258154702176, 225303657, 225303664, 7, 1440x900 
0x37CA2318, 38092258155361272, 225303722, 225303730, 8, 1440x900 
0x37CA2318, 38092258156020944, 225303788, 225303795, 7, 1440x900 
0x37CA2318, 38092258156867488, 225303873, 225303880, 7, 1440x900 
0x37CA2318, 38092258157467872, 225303933, 225303942, 9, 1440x900 
0x37CA2318, 38092258158009744, 225303989, 225303997, 8, 1440x900 
0x37CA2318, 38092258158681392, 225304058, 225304068, 10, 1440x900 
0x37CA2318, 38092258159330952, 225304118, 225304128, 10, 1440x900 
0x37CA2318, 38092258159989072, 225304186, 225304194, 8, 1440x900 
0x37CA2318, 38092258160644328, 225304252, 225304261, 9, 1440x900 
0x37CA2318, 38092258161326032, 225304323, 225304333, 10, 1440x900 
0x37CA2318, 38092258161979064, 225304383, 225304393, 10, 1440x900 
0x37CA2318, 38092258162635616, 225304448, 225304457, 9, 1440x900 
0x37CA2318, 38092258163295456, 225304517, 225304524, 7, 1440x900 
0x37CA2318, 38092258163948600, 225304582, 225304590, 8, 1440x900 
0x37CA2318, 38092258164609552, 225304647, 225304654, 7, 1440x900 
0x37CA2318, 38092258165265744, 225304712, 225304719, 7, 1440x900 
0x37CA2318, 38092258165926008, 225304778, 225304785, 7, 1440x900 
0x37CA2318, 38092258166591592, 225304848, 225304856, 8, 1440x900 
0x37CA2318, 38092258167248600, 225304912, 225304920, 8, 1440x900 
0x37CA2318, 38092258167915248, 225304977, 225304985, 8, 1440x900 
0x37CA2318, 38092258168567096, 225305042, 225305050, 8, 1440x900 
0x37CA2318, 38092258169227072, 225305108, 225305116, 8, 1440x900 
0x37CA2318, 38092258169887120, 225305173, 225305181, 8, 1440x900 
0x37CA2318, 38092258170547152, 225305242, 225305250, 8, 1440x900 
0x37CA2318, 38092258171210360, 225305307, 225305316, 9, 1440x900 
0x37CA2318, 38092258171870448, 225305378, 225305386, 8, 1440x900 
0x37CA2318, 38092258172529472, 225305441, 225305449, 8, 1440x900 
0x37CA2318, 38092258173188944, 225305507, 225305514, 7, 1440x900 
0x37CA2318, 38092258173849376, 225305573, 225305580, 7, 1440x900 
0x37CA2318, 38092258174531392, 225305643, 225305651, 8, 1440x900 
0x37CA2318, 38092258175183800, 225305708, 225305716, 8, 1440x900 
0x37CA2318, 38092258175858944, 225305777, 225305785, 8, 1440x900 
0x37CA2318, 38092258176513560, 225305843, 225305851, 8, 1440x900 
0x37CA2318, 38092258177160144, 225305919, 225305930, 11, 1440x900 
0x37CA2318, 38092258177867712, 225305972, 225305982, 10, 1440x900 
0x37CA2318, 38092258178575472, 225306049, 225306064, 15, 1440x900 
0x37CA2318, 38092258179177848, 225306103, 225306112, 9, 1440x900 
0x37CA2318, 38092258179905720, 225306185, 225306198, 13, 1440x900 
0x37CA2318, 38092258180594760, 225306255, 225306264, 9, 1440x900 
0x37CA2318, 38092258181160080, 225306302, 225306310, 8, 1440x900 
0x37CA2318, 38092258181898704, 225306381, 225306398, 17, 1440x900 
0x37CA2318, 38092258182581760, 225306442, 225306448, 6, 1440x900 
0x37CA2318, 38092258183130800, 225306498, 225306508, 10, 1440x900 
0x37CA2318, 38092258183791072, 225306567, 225306578, 11, 1440x900 
0x37CA2318, 38092258184453184, 225306633, 225306644, 11, 1440x900 
0x37CA2318, 38092258185125400, 225306698, 225306709, 11, 1440x900 
0x37CA2318, 38092258185780488, 225306762, 225306772, 10, 1440x900 
0x37CA2318, 38092258186442648, 225306828, 225306837, 9, 1440x900 
0x37CA2318, 38092258187103152, 225306897, 225306909, 12, 1440x900 
0x37CA2318, 38092258187765872, 225306962, 225306970, 8, 1440x900 
0x37CA2318, 38092258188439696, 225307028, 225307035, 7, 1440x900 
0x37CA2318, 38092258189936672, 225307183, 225307190, 7, 1440x900 
0x37CA2318, 38092258190596576, 225307247, 225307254, 7, 1440x900 
0x37CA2318, 38092258191249696, 225307312, 225307320, 8, 1440x900 
0x37CA2318, 38092258191919160, 225307382, 225307389, 7, 1440x900 
0x37CA2318, 38092258192387448, 225307426, 225307432, 6, 1440x900 
0x37CA2318, 38092258193065680, 225307492, 225307498, 6, 1440x900 
0x37CA2318, 38092258193700784, 225307556, 225307562, 6, 1440x900 
0x37CA2318, 38092258194371664, 225307622, 225307629, 7, 1440x900 
0x37CA2318, 38092258195035728, 225307688, 225307696, 8, 1440x900 
0x37CA2318, 38092258195691992, 225307757, 225307765, 8, 1440x900 
0x37CA2318, 38092258196350624, 225307821, 225307830, 9, 1440x900 
0x37CA2318, 38092258197014120, 225307888, 225307895, 7, 1440x900 
0x37CA2318, 38092258197669632, 225307953, 225307959, 6, 1440x900 
0x37CA2318, 38092258198330576, 225308018, 225308026, 8, 1440x900 
0x37CA2318, 38092258198991016, 225308083, 225308091, 8, 1440x900 
0x37CA2318, 38092258199650048, 225308152, 225308159, 7, 1440x900 
0x37CA2318, 38092258200308944, 225308217, 225308224, 7, 1440x900 
0x37CA2318, 38092258200972856, 225308289, 225308297, 8, 1440x900 
0x37CA2318, 38092258201631136, 225308348, 225308356, 8, 1440x900 
0x37CA2318, 38092258202287784, 225308413, 225308421, 8, 1440x900 
0x37CA2318, 38092258203146416, 225308503, 225308510, 7, 1440x900 
0x37CA2318, 38092258203800064, 225308568, 225308576, 8, 1440x900 
0x37CA2318, 38092258204472288, 225308633, 225308641, 8, 1440x900 
0x37CA2318, 38092258205142512, 225308703, 225308711, 8, 1440x900 
0x37CA2318, 38092258205792568, 225308768, 225308775, 7, 1440x900 
0x37CA2318, 38092258206453904, 225308833, 225308842, 9, 1440x900 
0x37CA2318, 38092258206926352, 225308882, 225308889, 7, 1440x900 
0x37CA2318, 38092258207579984, 225308942, 225308951, 9, 1440x900 
0x37CA2318, 38092258208240640, 225309008, 225309016, 8, 1440x900 
0x37CA2318, 38092258208905520, 225309077, 225309086, 9, 1440x900 
0x37CA2318, 38092258209564640, 225309142, 225309149, 7, 1440x900 
0x37CA2318, 38092258210231456, 225309212, 225309220, 8, 1440x900 
0x37CA2318, 38092258210888640, 225309276, 225309283, 7, 1440x900 
0x37CA2318, 38092258211548848, 225309343, 225309352, 9, 1440x900 
0x37CA2318, 38092258212206712, 225309407, 225309415, 8, 1440x900 
0x37CA2318, 38092258212866296, 225309472, 225309480, 8, 1440x900 
0x37CA2318, 38092258213526256, 225309537, 225309545, 8, 1440x900 
0x37CA2318, 38092258214189288, 225309607, 225309615, 8, 1440x900 
0x37CA2318, 38092258214853744, 225309672, 225309679, 7, 1440x900 
0x37CA2318, 38092258215532432, 225309742, 225309750, 8, 1440x900 
0x37CA2318, 38092258216174104, 225309802, 225309810, 8, 1440x900 
0x37CA2318, 38092258217036536, 225309892, 225309899, 7, 1440x900 
0x37CA2318, 38092258217706232, 225309957, 225309965, 8, 1440x900 
0x37CA2318, 38092258218161160, 225310003, 225310011, 8, 1440x900 
0x37CA2318, 38092258218820376, 225310067, 225310075, 8, 1440x900 
0x37CA2318, 38092258219487256, 225310139, 225310147, 8, 1440x900 
0x37CA2318, 38092258220345880, 225310223, 225310232, 9, 1440x900 
0x37CA2318, 38092258220803872, 225310266, 225310274, 8, 1440x900 
0x37CA2318, 38092258221464216, 225310332, 225310340, 8, 1440x900 
0x37CA2318, 38092258222130952, 225310399, 225310406, 7, 1440x900 
0x37CA2318, 38092258222790704, 225310464, 225310472, 8, 1440x900 
0x37CA2318, 38092258223460184, 225310532, 225310541, 9, 1440x900 
0x37CA2318, 38092258224120712, 225310598, 225310605, 7, 1440x900 
0x37CA2318, 38092258224784080, 225310663, 225310671, 8, 1440x900 
0x37CA2318, 38092258225444224, 225310732, 225310742, 10, 1440x900 
0x37CA2318, 38092258226116216, 225310797, 225310805, 8, 1440x900 
0x37CA2318, 38092258226763216, 225310862, 225310870, 8, 1440x900 
0x37CA2318, 38092258227418240, 225310928, 225310936, 8, 1440x900 
0x37CA2318, 38092258228079432, 225310993, 225311002, 9, 1440x900 
0x37CA2318, 38092258228753152, 225311062, 225311070, 8, 1440x900 
0x37CA2318, 38092258229407768, 225311127, 225311135, 8, 1440x900 
0x37CA2318, 38092258230078040, 225311198, 225311207, 9, 1440x900 
0x37CA2318, 38092258230751264, 225311266, 225311274, 8, 1440x900 
0x37CA2318, 38092258231387936, 225311328, 225311337, 9, 1440x900 
0x37CA2318, 38092258232238488, 225311412, 225311420, 8, 1440x900 
0x37CA2318, 38092258232909288, 225311482, 225311490, 8, 1440x900 
0x37CA2318, 38092258233376992, 225311528, 225311537, 9, 1440x900 
0x37CA2318, 38092258234044640, 225311592, 225311600, 8, 1440x900 
0x37CA2318, 38092258234692864, 225311653, 225311662, 9, 1440x900 
0x37CA2318, 38092258235547024, 225311748, 225311757, 9, 1440x900 
0x37CA2318, 38092258236188800, 225311807, 225311815, 8, 1440x900 
0x37CA2318, 38092258236697216, 225311857, 225311867, 10, 1440x900 
0x37CA2318, 38092258237352648, 225311923, 225311935, 12, 1440x900 
0x37CA2318, 38092258238011704, 225311988, 225312001, 13, 1440x900 
0x37CA2318, 38092258238672688, 225312053, 225312061, 8, 1440x900 
0x37CA2318, 38092258239331784, 225312123, 225312135, 12, 1440x900 
0x37CA2318, 38092258239992864, 225312187, 225312198, 11, 1440x900 
0x37CA2318, 38092258240657256, 225312252, 225312262, 10, 1440x900 
0x37CA2318, 38092258241320592, 225312317, 225312326, 9, 1440x900 
0x37CA2318, 38092258241987928, 225312383, 225312393, 10, 1440x900 
0x37CA2318, 38092258242651552, 225312451, 225312460, 9, 1440x900 
0x37CA2318, 38092258243321560, 225312517, 225312527, 10, 1440x900 
0x37CA2318, 38092258243989440, 225312583, 225312593, 10, 1440x900 
0x37CA2318, 38092258244656408, 225312652, 225312660, 8, 1440x900 
0x37CA2318, 38092258245296048, 225312717, 225312727, 10, 1440x900 
0x37CA2318, 38092258245946528, 225312783, 225312793, 10, 1440x900 
0x37CA2318, 38092258247272312, 225312918, 225312927, 9, 1440x900 
0x37CA2318, 38092258247932056, 225312977, 225312986, 9, 1440x900 
0x37CA2318, 38092258248590624, 225313043, 225313051, 8, 1440x900 
0x37CA2318, 38092258249250480, 225313112, 225313118, 6, 1440x900 
0x37CA2318, 38092258249905752, 225313177, 225313184, 7, 1440x900 
0x37CA2318, 38092258250578856, 225313243, 225313252, 9, 1440x900 
0x37CA2318, 38092258251243672, 225313312, 225313320, 8, 1440x900 
0x37CA2318, 38092258251896320, 225313377, 225313385, 8, 1440x900 
0x37CA2318, 38092258252569952, 225313442, 225313450, 8, 1440x900 
0x37CA2318, 38092258253229360, 225313508, 225313516, 8, 1440x900 
0x37CA2318, 38092258253886304, 225313576, 225313583, 7, 1440x900 
0x37CA2318, 38092258254546368, 225313642, 225313650, 8, 1440x900 
0x37CA2318, 38092258255205312, 225313708, 225313715, 7, 1440x900 
0x37CA2318, 38092258255873608, 225313772, 225313781, 9, 1440x900 
0x37CA2318, 38092258256524984, 225313837, 225313845, 8, 1440x900 
0x37CA2318, 38092258257186568, 225313904, 225313912, 8, 1440x900 
0x37CA2318, 38092258257847216, 225313972, 225313978, 6, 1440x900 
0x37CA2318, 38092258258506784, 225314037, 225314044, 7, 1440x900 
0x37CA2318, 38092258259170440, 225314102, 225314110, 8, 1440x900 
0x37CA2318, 38092258259826640, 225314168, 225314175, 7, 1440x900 
0x37CA2318, 38092258260493696, 225314233, 225314241, 8, 1440x900 
0x37CA2318, 38092258261156320, 225314303, 225314310, 7, 1440x900 
0x37CA2318, 38092258261816624, 225314368, 225314376, 8, 1440x900 
0x37CA2318, 38092258262476568, 225314433, 225314441, 8, 1440x900 
0x37CA2318, 38092258263148392, 225314502, 225314510, 8, 1440x900 
0x37CA2318, 38092258263796824, 225314567, 225314575, 8, 1440x900 
0x37CA2318, 38092258264508728, 225314638, 225314645, 7, 1440x900 
0x37CA2318, 38092258265117280, 225314697, 225314705, 8, 1440x900 
0x37CA2318, 38092258265982752, 225314783, 225314791, 8, 1440x900 
0x37CA2318, 38092258266633112, 225314851, 225314859, 8, 1440x900 
0x37CA2318, 38092258267294328, 225314917, 225314925, 8, 1440x900 
0x37CA2318, 38092258267964216, 225314982, 225314990, 8, 1440x900 
0x37CA2318, 38092258268615720, 225315048, 225315055, 7, 1440x900 
0x37CA2318, 38092258269079328, 225315093, 225315101, 8, 1440x900 
0x37CA2318, 38092258269739192, 225315161, 225315169, 8, 1440x900 
0x37CA2318, 38092258270597480, 225315247, 225315255, 8, 1440x900 
0x37CA2318, 38092258271249304, 225315312, 225315320, 8, 1440x900 
0x37CA2318, 38092258271929056, 225315382, 225315390, 8, 1440x900 
0x37CA2318, 38092258272580072, 225315447, 225315456, 9, 1440x900 
0x37CA2318, 38092258273241272, 225315512, 225315521, 9, 1440x900 
0x37CA2318, 38092258273895240, 225315578, 225315586, 8, 1440x900 
0x37CA2318, 38092258274565768, 225315648, 225315656, 8, 1440x900 
0x37CA2318, 38092258275070288, 225315698, 225315706, 8, 1440x900 
0x37CA2318, 38092258275896880, 225315777, 225315785, 8, 1440x900 
0x37CA2318, 38092258276348112, 225315822, 225315829, 7, 1440x900 
0x37CA2318, 38092258277008456, 225315887, 225315894, 7, 1440x900 
0x37CA2318, 38092258277669328, 225315953, 225315960, 7, 1440x900 
0x37CA2318, 38092258278328864, 225316018, 225316026, 8, 1440x900 
0x37CA2318, 38092258278988936, 225316083, 225316091, 8, 1440x900 
0x37CA2318, 38092258279653072, 225316153, 225316162, 9, 1440x900 
0x37CA2318, 38092258280315056, 225316222, 225316230, 8, 1440x900 
0x37CA2318, 38092258280977888, 225316288, 225316297, 9, 1440x900 
0x37CA2318, 38092258281634544, 225316353, 225316361, 8, 1440x900 
0x37CA2318, 38092258282296272, 225316418, 225316427, 9, 1440x900 
0x37CA2318, 38092258282957480, 225316487, 225316496, 9, 1440x900 
0x37CA2318, 38092258283625008, 225316558, 225316566, 8, 1440x900 
0x37CA2318, 38092258284479216, 225316638, 225316646, 8, 1440x900 
0x37CA2318, 38092258285143520, 225316702, 225316711, 9, 1440x900 
0x37CA2318, 38092258285611056, 225316753, 225316761, 8, 1440x900 
0x37CA2318, 38092258286268624, 225316813, 225316821, 8, 1440x900 
0x37CA2318, 38092258286926312, 225316878, 225316885, 7, 1440x900 
0x37CA2318, 38092258287590728, 225316947, 225316956, 9, 1440x900 
0x37CA2318, 38092258288443432, 225317032, 225317040, 8, 1440x900 
0x37CA2318, 38092258288910064, 225317078, 225317086, 8, 1440x900 
0x37CA2318, 38092258289765248, 225317168, 225317177, 9, 1440x900 
0x37CA2318, 38092258290433728, 225317232, 225317240, 8, 1440x900 
0x37CA2318, 38092258291092368, 225317298, 225317306, 8, 1440x900 
0x37CA2318, 38092258291559232, 225317349, 225317358, 9, 1440x900 
0x37CA2318, 38092258292212208, 225317413, 225317422, 9, 1440x900 
0x37CA2318, 38092258292872544, 225317477, 225317486, 9, 1440x900 
0x37CA2318, 38092258293537976, 225317547, 225317556, 9, 1440x900 
0x37CA2318, 38092258294195936, 225317607, 225317615, 8, 1440x900 
0x37CA2318, 38092258294856056, 225317672, 225317680, 8, 1440x900 
0x37CA2318, 38092258295634496, 225317752, 225317761, 9, 1440x900 
0x37CA2318, 38092258296176576, 225317807, 225317815, 8, 1440x900 
0x37CA2318, 38092258296836528, 225317871, 225317879, 8, 1440x900 
0x37CA2318, 38092258297631696, 225317953, 225317962, 9, 1440x900 
0x37CA2318, 38092258298162200, 225318008, 225318017, 9, 1440x900 
0x37CA2318, 38092258298825568, 225318073, 225318082, 9, 1440x900 
0x37CA2318, 38092258299483992, 225318138, 225318147, 9, 1440x900 
0x37CA2318, 38092258300340384, 225318222, 225318231, 9, 1440x900 
0x37CA2318, 38092258300806328, 225318272, 225318281, 9, 1440x900 
0x37CA2318, 38092258301468192, 225318338, 225318346, 8, 1440x900 
0x37CA2318, 38092258302131864, 225318398, 225318407, 9, 1440x900 
0x37CA2318, 38092258302794168, 225318467, 225318476, 9, 1440x900 
0x37CA2318, 38092258303455680, 225318532, 225318542, 10, 1440x900 
0x37CA2318, 38092258304122080, 225318603, 225318612, 9, 1440x900 
0x37CA2318, 38092258304775936, 225318663, 225318671, 8, 1440x900 
0x37CA2318, 38092258305437256, 225318732, 225318740, 8, 1440x900 
0x37CA2318, 38092258306096424, 225318797, 225318805, 8, 1440x900 
0x37CA2318, 38092258306756432, 225318861, 225318869, 8, 1440x900 
0x37CA2318, 38092258307422096, 225318933, 225318941, 8, 1440x900 
0x37CA2318, 38092258308082448, 225318997, 225319006, 9, 1440x900 
0x37CA2318, 38092258308764280, 225319067, 225319075, 8, 1440x900 
0x37CA2318, 38092258309421208, 225319134, 225319143, 9, 1440x900 
0x37CA2318, 38092258310080784, 225319197, 225319207, 10, 1440x900 
0x37CA2318, 38092258310746088, 225319262, 225319272, 10, 1440x900 
0x37CA2318, 38092258311401136, 225319328, 225319338, 10, 1440x900 
0x37CA2318, 38092258312060624, 225319397, 225319405, 8, 1440x900 
0x37CA2318, 38092258312718368, 225319458, 225319466, 8, 1440x900 
0x37CA2318, 38092258313615008, 225319551, 225319571, 20, 1440x900 
0x37CA2318, 38092258314271176, 225319612, 225319619, 7, 1440x900 
0x37CA2318, 38092258314933112, 225319678, 225319686, 8, 1440x900 
0x37CA2318, 38092258315595976, 225319750, 225319760, 10, 1440x900 
0x37CA2318, 38092258316253928, 225319812, 225319820, 8, 1440x900 
0x37CA2318, 38092258316916704, 225319877, 225319885, 8, 1440x900 
0x37CA2318, 38092258317574736, 225319942, 225319950, 8, 1440x900 
0x37CA2318, 38092258318242008, 225320013, 225320022, 9, 1440x900 
0x37CA2318, 38092258318906992, 225320078, 225320086, 8, 1440x900 
0x37CA2318, 38092258319565120, 225320143, 225320152, 9, 1440x900 
0x37CA2318, 38092258320219312, 225320208, 225320216, 8, 1440x900 
0x37CA2318, 38092258320880160, 225320276, 225320284, 8, 1440x900 
0x37CA2318, 38092258321539568, 225320341, 225320349, 8, 1440x900 
0x37CA2318, 38092258322205936, 225320408, 225320416, 8, 1440x900 
0x37CA2318, 38092258322859760, 225320473, 225320481, 8, 1440x900 
0x37CA2318, 38092258323718016, 225320558, 225320566, 8, 1440x900 
0x37CA2318, 38092258324378792, 225320623, 225320633, 10, 1440x900 
0x37CA2318, 38092258324838992, 225320675, 225320686, 11, 1440x900 
0x37CA2318, 38092258325508752, 225320739, 225320750, 11, 1440x900 
0x37CA2318, 38092258326168192, 225320806, 225320815, 9, 1440x900 
0x37CA2318, 38092258326833200, 225320868, 225320882, 14, 1440x900 
0x37CA2318, 38092258327491168, 225320933, 225320941, 8, 1440x900 
0x37CA2318, 38092258328144768, 225320998, 225321007, 9, 1440x900 
0x37CA2318, 38092258328806032, 225321067, 225321075, 8, 1440x900 
0x37CA2318, 38092258329464320, 225321132, 225321140, 8, 1440x900 
0x37CA2318, 38092258330145328, 225321204, 225321211, 7, 1440x900 
0x37CA2318, 38092258330790432, 225321263, 225321272, 9, 1440x900 
0x37CA2318, 38092258331487880, 225321333, 225321342, 9, 1440x900 
0x37CA2318, 38092258332104592, 225321397, 225321404, 7, 1440x900 
0x37CA2318, 38092258332764016, 225321462, 225321470, 8, 1440x900 
0x37CA2318, 38092258333426992, 225321531, 225321539, 8, 1440x900 
0x37CA2318, 38092258334086176, 225321596, 225321605, 9, 1440x900 
0x37CA2318, 38092258334746384, 225321663, 225321670, 7, 1440x900 
0x37CA2318, 38092258335604008, 225321747, 225321757, 10, 1440x900 
0x37CA2318, 38092258336265528, 225321813, 225321821, 8, 1440x900 
0x37CA2318, 38092258336935752, 225321882, 225321890, 8, 1440x900 
0x37CA2318, 38092258337586496, 225321947, 225321955, 8, 1440x900 
0x37CA2318, 38092258338110080, 225322002, 225322010, 8, 1440x900 
0x37CA2318, 38092258338710064, 225322058, 225322066, 8, 1440x900 
0x37CA2318, 38092258339370928, 225322127, 225322135, 8, 1440x900 
0x37CA2318, 38092258340039936, 225322193, 225322201, 8, 1440x900 
0x37CA2318, 38092258340695648, 225322258, 225322267, 9, 1440x900 
0x37CA2318, 38092258341352688, 225322324, 225322333, 9, 1440x900 
0x37CA2318, 38092258342022848, 225322394, 225322402, 8, 1440x900 
0x37CA2318, 38092258342691912, 225322457, 225322465, 8, 1440x900 
0x37CA2318, 38092258343354200, 225322524, 225322533, 9, 1440x900 
0x37CA2318, 38092258344011616, 225322587, 225322595, 8, 1440x900 
0x37CA2318, 38092258344672056, 225322653, 225322662, 9, 1440x900 
0x37CA2318, 38092258345331760, 225322721, 225322729, 8, 1440x900 
0x37CA2318, 38092258345992888, 225322787, 225322795, 8, 1440x900 
0x37CA2318, 38092258346652816, 225322852, 225322860, 8, 1440x900 
0x37CA2318, 38092258347321048, 225322918, 225322926, 8, 1440x900 
0x37CA2318, 38092258348641192, 225323052, 225323060, 8, 1440x900 
0x37CA2318, 38092258349492080, 225323133, 225323141, 8, 1440x900 
0x37CA2318, 38092258350157480, 225323202, 225323210, 8, 1440x900 
0x37CA2318, 38092258350819680, 225323268, 225323275, 7, 1440x900 
0x37CA2318, 38092258351473264, 225323337, 225323345, 8, 1440x900 
0x37CA2318, 38092258352144656, 225323404, 225323413, 9, 1440x900 
0x37CA2318, 38092258352814192, 225323469, 225323479, 10, 1440x900 
0x37CA2318, 38092258353467752, 225323538, 225323546, 8, 1440x900 
0x37CA2318, 38092258354131088, 225323602, 225323610, 8, 1440x900 
0x37CA2318, 38092258354792488, 225323667, 225323676, 9, 1440x900 
0x37CA2318, 38092258355455552, 225323738, 225323746, 8, 1440x900 
0x37CA2318, 38092258356118464, 225323802, 225323811, 9, 1440x900 
0x37CA2318, 38092258356768864, 225323867, 225323875, 8, 1440x900 
0x37CA2318, 38092258357444536, 225323932, 225323941, 9, 1440x900 
0x37CA2318, 38092258358104072, 225323998, 225324007, 9, 1440x900 
0x37CA2318, 38092258358766176, 225324068, 225324076, 8, 1440x900 
0x37CA2318, 38092258359427064, 225324128, 225324136, 8, 1440x900 
0x37CA2318, 38092258360079296, 225324193, 225324202, 9, 1440x900 
0x37CA2318, 38092258360749416, 225324262, 225324270, 8, 1440x900 
0x37CA2318, 38092258361412816, 225324332, 225324340, 8, 1440x900 
0x37CA2318, 38092258362071120, 225324398, 225324406, 8, 1440x900 
0x37CA2318, 38092258362729272, 225324467, 225324475, 8, 1440x900 
0x37CA2318, 38092258363397736, 225324533, 225324540, 7, 1440x900 
0x37CA2318, 38092258364063024, 225324597, 225324605, 8, 1440x900 
0x37CA2318, 38092258364724896, 225324663, 225324671, 8, 1440x900 
0x37CA2318, 38092258365375992, 225324727, 225324735, 8, 1440x900 
0x37CA2318, 38092258366044656, 225324793, 225324803, 10, 1440x900 
0x37CA2318, 38092258366707328, 225324859, 225324867, 8, 1440x900 
0x37CA2318, 38092258367356976, 225324927, 225324935, 8, 1440x900 
0x37CA2318, 38092258368017912, 225324992, 225325000, 8, 1440x900 
0x37CA2318, 38092258368679160, 225325057, 225325065, 8, 1440x900 
0x37CA2318, 38092258369340664, 225325123, 225325132, 9, 1440x900 
0x37CA2318, 38092258369990936, 225325188, 225325196, 8, 1440x900 
0x37CA2318, 38092258370653224, 225325257, 225325265, 8, 1440x900 
0x37CA2318, 38092258371326136, 225325323, 225325331, 8, 1440x900 
0x37CA2318, 38092258371987600, 225325388, 225325397, 9, 1440x900 
0x37CA2318, 38092258372647680, 225325453, 225325462, 9, 1440x900 
0x37CA2318, 38092258373304608, 225325523, 225325531, 8, 1440x900 
0x37CA2318, 38092258373959672, 225325588, 225325596, 8, 1440x900 
0x37CA2318, 38092258374628392, 225325653, 225325661, 8, 1440x900 
0x37CA2318, 38092258375297104, 225325716, 225325724, 8, 1440x900 
0x37CA2318, 38092258375949552, 225325787, 225325795, 8, 1440x900 
0x37CA2318, 38092258376610744, 225325853, 225325861, 8, 1440x900 
0x37CA2318, 38092258377261928, 225325913, 225325920, 7, 1440x900 
0x37CA2318, 38092258377927368, 225325983, 225325991, 8, 1440x900 
0x37CA2318, 38092258378599184, 225326048, 225326056, 8, 1440x900 
0x37CA2318, 38092258379250968, 225326117, 225326125, 8, 1440x900 
0x37CA2318, 38092258379920736, 225326183, 225326191, 8, 1440x900 
0x37CA2318, 38092258380579896, 225326248, 225326256, 8, 1440x900 
0x37CA2318, 38092258381231984, 225326311, 225326319, 8, 1440x900 
0x37CA2318, 38092258381885232, 225326376, 225326384, 8, 1440x900 
0x37CA2318, 38092258382555320, 225326442, 225326450, 8, 1440x900 
0x37CA2318, 38092258383210048, 225326507, 225326515, 8, 1440x900 
0x37CA2318, 38092258383881360, 225326573, 225326582, 9, 1440x900 
0x37CA2318, 38092258384543384, 225326642, 225326650, 8, 1440x900 
0x37CA2318, 38092258385197520, 225326708, 225326715, 7, 1440x900 
0x37CA2318, 38092258385862744, 225326777, 225326785, 8, 1440x900 
0x37CA2318, 38092258386514080, 225326843, 225326851, 8, 1440x900 
0x37CA2318, 38092258387182704, 225326907, 225326915, 8, 1440x900 
0x37CA2318, 38092258387833248, 225326972, 225326980, 8, 1440x900 
0x37CA2318, 38092258388493752, 225327038, 225327046, 8, 1440x900 
0x37CA2318, 38092258389155208, 225327103, 225327112, 9, 1440x900 
0x37CA2318, 38092258389816432, 225327173, 225327181, 8, 1440x900 
0x37CA2318, 38092258390470384, 225327237, 225327246, 9, 1440x900 
0x37CA2318, 38092258391143928, 225327303, 225327311, 8, 1440x900 
0x37CA2318, 38092258391795552, 225327372, 225327380, 8, 1440x900 
0x37CA2318, 38092258392457560, 225327434, 225327442, 8, 1440x900 
0x37CA2318, 38092258393118704, 225327503, 225327511, 8, 1440x900 
0x37CA2318, 38092258393769104, 225327562, 225327570, 8, 1440x900 
0x37CA2318, 38092258394448736, 225327632, 225327640, 8, 1440x900 
0x37CA2318, 38092258395100680, 225327698, 225327707, 9, 1440x900 
0x37CA2318, 38092258395761208, 225327768, 225327777, 9, 1440x900 
0x37CA2318, 38092258396418400, 225327833, 225327841, 8, 1440x900 
0x37CA2318, 38092258397097192, 225327898, 225327907, 9, 1440x900 
0x37CA2318, 38092258397758360, 225327967, 225327975, 8, 1440x900 
0x37CA2318, 38092258398410544, 225328033, 225328041, 8, 1440x900 
0x37CA2318, 38092258399080416, 225328097, 225328105, 8, 1440x900 
0x37CA2318, 38092258399740832, 225328162, 225328170, 8, 1440x900 
0x37CA2318, 38092258400400640, 225328233, 225328241, 8, 1440x900 
0x37CA2318, 38092258401053248, 225328292, 225328300, 8, 1440x900 
0x37CA2318, 38092258401717000, 225328363, 225328371, 8, 1440x900 
0x37CA2318, 38092258402370888, 225328428, 225328437, 9, 1440x900 
0x37CA2318, 38092258403037528, 225328493, 225328501, 8, 1440x900 
0x37CA2318, 38092258403696472, 225328564, 225328573, 9, 1440x900 
0x37CA2318, 38092258404161096, 225328603, 225328611, 8, 1440x900 
0x37CA2318, 38092258404828016, 225328672, 225328680, 8, 1440x900 
0x37CA2318, 38092258406147256, 225328803, 225328812, 9, 1440x900 
0x37CA2318, 38092258406804992, 225328867, 225328875, 8, 1440x900 
0x37CA2318, 38092258407469400, 225328936, 225328944, 8, 1440x900 
0x37CA2318, 38092258408135088, 225329001, 225329009, 8, 1440x900 
0x37CA2318, 38092258408794128, 225329067, 225329075, 8, 1440x900 
0x37CA2318, 38092258409480432, 225329133, 225329142, 9, 1440x900 
0x37CA2318, 38092258410117544, 225329197, 225329205, 8, 1440x900 
0x37CA2318, 38092258410966440, 225329283, 225329290, 7, 1440x900 
0x37CA2318, 38092258411641840, 225329351, 225329359, 8, 1440x900 
0x37CA2318, 38092258412299104, 225329418, 225329427, 9, 1440x900 
0x37CA2318, 38092258412949392, 225329483, 225329492, 9, 1440x900 
0x37CA2318, 38092258413423296, 225329532, 225329540, 8, 1440x900 
0x37CA2318, 38092258414083616, 225329596, 225329604, 8, 1440x900 
0x37CA2318, 38092258414741872, 225329662, 225329670, 8, 1440x900 
0x37CA2318, 38092258415401536, 225329727, 225329735, 8, 1440x900 
0x37CA2318, 38092258416064824, 225329792, 225329800, 8, 1440x900 
0x37CA2318, 38092258416923432, 225329882, 225329890, 8, 1440x900 
0x37CA2318, 38092258417584544, 225329947, 225329955, 8, 1440x900 
0x37CA2318, 38092258418253712, 225330012, 225330020, 8, 1440x900 
0x37CA2318, 38092258418906248, 225330078, 225330087, 9, 1440x900 
0x37CA2318, 38092258419567752, 225330148, 225330156, 8, 1440x900 
0x37CA2318, 38092258420227520, 225330213, 225330223, 10, 1440x900 
0x37CA2318, 38092258420892376, 225330273, 225330281, 8, 1440x900 
0x37CA2318, 38092258421549312, 225330343, 225330351, 8, 1440x900 
0x37CA2318, 38092258422201424, 225330408, 225330416, 8, 1440x900 
0x37CA2318, 38092258422862984, 225330477, 225330485, 8, 1440x900 
0x37CA2318, 38092258423533360, 225330543, 225330551, 8, 1440x900 
0x37CA2318, 38092258424203640, 225330608, 225330617, 9, 1440x900 
0x37CA2318, 38092258424855696, 225330678, 225330686, 8, 1440x900 
0x37CA2318, 38092258425521088, 225330742, 225330751, 9, 1440x900 
0x37CA2318, 38092258426174544, 225330808, 225330817, 9, 1440x900 
0x37CA2318, 38092258426835456, 225330873, 225330881, 8, 1440x900 
0x37CA2318, 38092258427497448, 225330938, 225330947, 9, 1440x900 
0x37CA2318, 38092258428157376, 225331007, 225331015, 8, 1440x900 
0x37CA2318, 38092258428819800, 225331068, 225331077, 9, 1440x900 
0x37CA2318, 38092258429472440, 225331138, 225331146, 8, 1440x900 
0x37CA2318, 38092258430141984, 225331203, 225331211, 8, 1440x900 
0x37CA2318, 38092258430804992, 225331273, 225331281, 8, 1440x900 
0x37CA2318, 38092258431466808, 225331338, 225331346, 8, 1440x900 
0x37CA2318, 38092258432125296, 225331398, 225331406, 8, 1440x900 
0x37CA2318, 38092258432795216, 225331468, 225331476, 8, 1440x900 
0x37CA2318, 38092258433455616, 225331537, 225331545, 8, 1440x900 
0x37CA2318, 38092258434115808, 225331603, 225331611, 8, 1440x900 
0x37CA2318, 38092258434767072, 225331667, 225331675, 8, 1440x900 
0x37CA2318, 38092258435436888, 225331732, 225331740, 8, 1440x900 
0x37CA2318, 38092258436087176, 225331798, 225331806, 8, 1440x900 
0x37CA2318, 38092258436748168, 225331863, 225331871, 8, 1440x900 
0x37CA2318, 38092258437403016, 225331932, 225331940, 8, 1440x900 
0x37CA2318, 38092258438074184, 225331997, 225332005, 8, 1440x900 
0x37CA2318, 38092258438732808, 225332063, 225332071, 8, 1440x900 
0x37CA2318, 38092258439395720, 225332128, 225332136, 8, 1440x900 
0x37CA2318, 38092258440034320, 225332197, 225332206, 9, 1440x900 
0x37CA2318, 38092258440526536, 225332243, 225332252, 9, 1440x900 
0x37CA2318, 38092258441208600, 225332308, 225332316, 8, 1440x900 
0x37CA2318, 38092258441850096, 225332372, 225332380, 8, 1440x900 
0x37CA2318, 38092258442517144, 225332437, 225332445, 8, 1440x900 
0x37CA2318, 38092258443182056, 225332507, 225332515, 8, 1440x900 
0x37CA2318, 38092258443854968, 225332572, 225332580, 8, 1440x900 
0x37CA2318, 38092258444495728, 225332636, 225332643, 7, 1440x900 
0x37CA2318, 38092258445150520, 225332701, 225332708, 7, 1440x900 
0x37CA2318, 38092258445810032, 225332766, 225332775, 9, 1440x900 
0x37CA2318, 38092258446470024, 225332832, 225332840, 8, 1440x900 
0x37CA2318, 38092258447132936, 225332898, 225332906, 8, 1440x900 
0x37CA2318, 38092258447796616, 225332967, 225332975, 8, 1440x900 
0x37CA2318, 38092258448514424, 225333038, 225333046, 8, 1440x900 
0x37CA2318, 38092258449117360, 225333098, 225333106, 8, 1440x900 
0x37CA2318, 38092258449777600, 225333162, 225333171, 9, 1440x900 
0x37CA2318, 38092258450633688, 225333258, 225333286, 28, 1440x900 
0x37CA2318, 38092258451329016, 225333322, 225333353, 31, 1440x900 
0x37CA2318, 38092258451805696, 225333364, 225333383, 19, 1440x900 
0x37CA2318, 38092258452460272, 225333432, 225333440, 8, 1440x900 
0x37CA2318, 38092258453271952, 225333512, 225333520, 8, 1440x900 
0x37CA2318, 38092258453942368, 225333582, 225333590, 8, 1440x900 
0x37CA2318, 38092258454602800, 225333647, 225333656, 9, 1440x900 
0x37CA2318, 38092258455213744, 225333707, 225333715, 8, 1440x900 
0x37CA2318, 38092258455735288, 225333758, 225333767, 9, 1440x900 
0x37CA2318, 38092258456512736, 225333837, 225333845, 8, 1440x900 
0x37CA2318, 38092258457059744, 225333892, 225333899, 7, 1440x900 
0x37CA2318, 38092258457718344, 225333958, 225333965, 7, 1440x900 
0x37CA2318, 38092258458583544, 225334048, 225334056, 8, 1440x900 
0x37CA2318, 38092258459048840, 225334093, 225334102, 9, 1440x900 
0x37CA2318, 38092258459904160, 225334178, 225334187, 9, 1440x900 
0x37CA2318, 38092258460558184, 225334243, 225334252, 9, 1440x900 
0x37CA2318, 38092258461214592, 225334308, 225334316, 8, 1440x900 
0x37CA2318, 38092258461887000, 225334377, 225334385, 8, 1440x900 
0x37CA2318, 38092258462538512, 225334442, 225334450, 8, 1440x900 
0x37CA2318, 38092258463198896, 225334507, 225334516, 9, 1440x900 
0x37CA2318, 38092258463858104, 225334572, 225334579, 7, 1440x900 
0x37CA2318, 38092258464324368, 225334618, 225334625, 7, 1440x900 
0x37CA2318, 38092258465185600, 225334706, 225334714, 8, 1440x900 
0x37CA2318, 38092258465847536, 225334772, 225334780, 8, 1440x900 
0x37CA2318, 38092258466508320, 225334838, 225334846, 8, 1440x900 
0x37CA2318, 38092258467829504, 225334972, 225334981, 9, 1440x900 
0x37CA2318, 38092258468492272, 225335038, 225335046, 8, 1440x900 
0x37CA2318, 38092258469053856, 225335093, 225335101, 8, 1440x900 
0x37CA2318, 38092258469805392, 225335173, 225335181, 8, 1440x900 
0x37CA2318, 38092258470475704, 225335237, 225335245, 8, 1440x900 
0x37CA2318, 38092258471136520, 225335303, 225335311, 8, 1440x900 
0x37CA2318, 38092258471799160, 225335372, 225335380, 8, 1440x900 
0x37CA2318, 38092258472460192, 225335437, 225335445, 8, 1440x900 
0x37CA2318, 38092258473112664, 225335502, 225335510, 8, 1440x900 
0x37CA2318, 38092258473781568, 225335568, 225335577, 9, 1440x900 
0x37CA2318, 38092258474441048, 225335632, 225335639, 7, 1440x900 
0x37CA2318, 38092258475094672, 225335698, 225335709, 11, 1440x900 
0x37CA2318, 38092258475776632, 225335777, 225335784, 7, 1440x900 
0x37CA2318, 38092258476433384, 225335828, 225335837, 9, 1440x900 
0x37CA2318, 38092258476931416, 225335878, 225335888, 10, 1440x900 
0x37CA2318, 38092258477559392, 225335943, 225335951, 8, 1440x900 
0x37CA2318, 38092258478405744, 225336026, 225336034, 8, 1440x900 
0x37CA2318, 38092258479076688, 225336093, 225336101, 8, 1440x900 
0x37CA2318, 38092258479744560, 225336159, 225336167, 8, 1440x900 
0x37CA2318, 38092258480395888, 225336227, 225336234, 7, 1440x900 
0x37CA2318, 38092258481055744, 225336292, 225336300, 8, 1440x900 
0x37CA2318, 38092258481546136, 225336343, 225336350, 7, 1440x900 
0x37CA2318, 38092258482384624, 225336423, 225336430, 7, 1440x900 
0x37CA2318, 38092258483045432, 225336491, 225336498, 7, 1440x900 
0x37CA2318, 38092258483705960, 225336557, 225336564, 7, 1440x900 
0x37CA2318, 38092258484367080, 225336622, 225336630, 8, 1440x900 
0x37CA2318, 38092258485221976, 225336713, 225336720, 7, 1440x900 
0x37CA2318, 38092258485501112, 225336737, 225336745, 8, 1440x900 
0x37CA2318, 38092258486356752, 225336822, 225336829, 7, 1440x900 
0x37CA2318, 38092258487017312, 225336887, 225336895, 8, 1440x900 
0x37CA2318, 38092258487670824, 225336953, 225336960, 7, 1440x900 
0x37CA2318, 38092258488146768, 225336998, 225337006, 8, 1440x900 
0x37CA2318, 38092258488807024, 225337067, 225337073, 6, 1440x900 
0x37CA2318, 38092258489672136, 225337153, 225337160, 7, 1440x900 
0x37CA2318, 38092258490323432, 225337222, 225337229, 7, 1440x900 
0x37CA2318, 38092258490993024, 225337292, 225337300, 8, 1440x900 
0x37CA2318, 38092258491644328, 225337353, 225337360, 7, 1440x900 
0x37CA2318, 38092258492297440, 225337418, 225337426, 8, 1440x900 
0x37CA2318, 38092258492970848, 225337487, 225337494, 7, 1440x900 
0x37CA2318, 38092258493637600, 225337553, 225337561, 8, 1440x900 
0x37CA2318, 38092258494291624, 225337618, 225337626, 8, 1440x900 
0x37CA2318, 38092258494951776, 225337688, 225337696, 8, 1440x900 
0x37CA2318, 38092258495611912, 225337748, 225337755, 7, 1440x900 
0x37CA2318, 38092258496271896, 225337813, 225337822, 9, 1440x900 
0x37CA2318, 38092258496941784, 225337882, 225337890, 8, 1440x900 
0x37CA2318, 38092258497595040, 225337949, 225337956, 7, 1440x900 
0x37CA2318, 38092258498256968, 225338017, 225338024, 7, 1440x900 
0x37CA2318, 38092258498913288, 225338082, 225338090, 8, 1440x900 
0x37CA2318, 38092258499576240, 225338147, 225338154, 7, 1440x900 
0x37CA2318, 38092258500235592, 225338212, 225338220, 8, 1440x900 
0x37CA2318, 38092258500703048, 225338262, 225338270, 8, 1440x900 
0x37CA2318, 38092258501372816, 225338327, 225338336, 9, 1440x900 
0x37CA2318, 38092258502024416, 225338392, 225338401, 9, 1440x900 
0x37CA2318, 38092258502684024, 225338458, 225338466, 8, 1440x900 
0x37CA2318, 38092258503343248, 225338523, 225338531, 8, 1440x900 
0x37CA2318, 38092258504004432, 225338591, 225338599, 8, 1440x900 
0x37CA2318, 38092258504674128, 225338652, 225338661, 9, 1440x900 
0x37CA2318, 38092258505332480, 225338724, 225338731, 7, 1440x900 
0x37CA2318, 38092258505989512, 225338784, 225338792, 8, 1440x900 
0x37CA2318, 38092258506647632, 225338851, 225338859, 8, 1440x900 
0x37CA2318, 38092258507307720, 225338918, 225338925, 7, 1440x900 
0x37CA2318, 38092258507967392, 225338982, 225338990, 8, 1440x900 
0x37CA2318, 38092258508627616, 225339048, 225339057, 9, 1440x900 
0x37CA2318, 38092258509287704, 225339118, 225339126, 8, 1440x900 
0x37CA2318, 38092258509950128, 225339188, 225339196, 8, 1440x900 
0x37CA2318, 38092258510807880, 225339272, 225339280, 8, 1440x900 
0x37CA2318, 38092258511271168, 225339318, 225339326, 8, 1440x900 
0x37CA2318, 38092258511932128, 225339383, 225339391, 8, 1440x900 
0x37CA2318, 38092258512789792, 225339467, 225339475, 8, 1440x900 
0x37CA2318, 38092258513452272, 225339538, 225339546, 8, 1440x900 
0x37CA2318, 38092258514121664, 225339602, 225339610, 8, 1440x900 
0x37CA2318, 38092258514773776, 225339663, 225339672, 9, 1440x900 
0x37CA2318, 38092258515426672, 225339732, 225339740, 8, 1440x900 
0x37CA2318, 38092258516096144, 225339797, 225339804, 7, 1440x900 
0x37CA2318, 38092258516562152, 225339843, 225339856, 13, 1440x900 
0x37CA2318, 38092258517233536, 225339912, 225339919, 7, 1440x900 
0x37CA2318, 38092258517891360, 225339978, 225339986, 8, 1440x900 
0x37CA2318, 38092258519211280, 225340109, 225340117, 8, 1440x900 
0x37CA2318, 38092258519872024, 225340172, 225340180, 8, 1440x900 
0x37CA2318, 38092258520531616, 225340238, 225340249, 11, 1440x900 
0x37CA2318, 38092258521191176, 225340303, 225340311, 8, 1440x900 
0x37CA2318, 38092258521863680, 225340373, 225340381, 8, 1440x900 
0x37CA2318, 38092258522507232, 225340438, 225340448, 10, 1440x900 
0x37CA2318, 38092258523182512, 225340507, 225340515, 8, 1440x900 
0x37CA2318, 38092258523845336, 225340572, 225340580, 8, 1440x900 
0x37CA2318, 38092258524487096, 225340637, 225340645, 8, 1440x900 
0x37CA2318, 38092258525162904, 225340703, 225340711, 8, 1440x900 
0x37CA2318, 38092258525814576, 225340768, 225340775, 7, 1440x900 
0x37CA2318, 38092258526666576, 225340853, 225340859, 6, 1440x900 
0x37CA2318, 38092258527327568, 225340919, 225340927, 8, 1440x900 
0x37CA2318, 38092258527989240, 225340983, 225340991, 8, 1440x900 
0x37CA2318, 38092258528649584, 225341052, 225341060, 8, 1440x900 
0x37CA2318, 38092258529312672, 225341118, 225341125, 7, 1440x900 
0x37CA2318, 38092258529947344, 225341182, 225341189, 7, 1440x900 
0x37CA2318, 38092258530434368, 225341228, 225341237, 9, 1440x900 
0x37CA2318, 38092258531094608, 225341298, 225341306, 8, 1440x900 
0x37CA2318, 38092258531952400, 225341382, 225341391, 9, 1440x900 
0x37CA2318, 38092258532631048, 225341447, 225341455, 8, 1440x900 
0x37CA2318, 38092258533279032, 225341513, 225341521, 8, 1440x900 
0x37CA2318, 38092258533931712, 225341578, 225341586, 8, 1440x900 
0x37CA2318, 38092258534592672, 225341643, 225341651, 8, 1440x900 
0x37CA2318, 38092258535261472, 225341712, 225341721, 9, 1440x900 
0x37CA2318, 38092258535912632, 225341783, 225341791, 8, 1440x900 
0x37CA2318, 38092258536580944, 225341848, 225341855, 7, 1440x900 
0x37CA2318, 38092258537240896, 225341908, 225341916, 8, 1440x900 
0x37CA2318, 38092258537705880, 225341958, 225341966, 8, 1440x900 
0x37CA2318, 38092258538377896, 225342022, 225342033, 11, 1440x900 
0x37CA2318, 38092258539035224, 225342088, 225342096, 8, 1440x900 
0x37CA2318, 38092258539695232, 225342159, 225342167, 8, 1440x900 
0x37CA2318, 38092258540357304, 225342223, 225342233, 10, 1440x900 
0x37CA2318, 38092258541016016, 225342288, 225342298, 10, 1440x900 
0x37CA2318, 38092258541685600, 225342353, 225342364, 11, 1440x900 
0x37CA2318, 38092258542347104, 225342422, 225342430, 8, 1440x900 
0x37CA2318, 38092258543005760, 225342487, 225342497, 10, 1440x900 
0x37CA2318, 38092258543665704, 225342552, 225342560, 8, 1440x900 
0x37CA2318, 38092258544331152, 225342618, 225342627, 9, 1440x900 
0x37CA2318, 38092258545016248, 225342688, 225342695, 7, 1440x900 
0x37CA2318, 38092258545784744, 225342767, 225342773, 6, 1440x900 
0x37CA2318, 38092258546294776, 225342817, 225342824, 7, 1440x900 
0x37CA2318, 38092258546955832, 225342882, 225342889, 7, 1440x900 
0x37CA2318, 38092258547624336, 225342952, 225342960, 8, 1440x900 
0x37CA2318, 38092258548281304, 225343017, 225343024, 7, 1440x900 
0x37CA2318, 38092258548938344, 225343081, 225343089, 8, 1440x900 
0x37CA2318, 38092258549607680, 225343151, 225343159, 8, 1440x900 
0x37CA2318, 38092258550267424, 225343218, 225343225, 7, 1440x900 
0x37CA2318, 38092258550927608, 225343280, 225343287, 7, 1440x900 
0x37CA2318, 38092258551775264, 225343363, 225343372, 9, 1440x900 
0x37CA2318, 38092258552440152, 225343433, 225343441, 8, 1440x900 
0x37CA2318, 38092258553111168, 225343502, 225343510, 8, 1440x900 
0x37CA2318, 38092258553631656, 225343557, 225343565, 8, 1440x900 
0x37CA2318, 38092258554235952, 225343613, 225343622, 9, 1440x900 
0x37CA2318, 38092258554895904, 225343678, 225343686, 8, 1440x900 
0x37CA2318, 38092258555556736, 225343743, 225343752, 9, 1440x900 
0x37CA2318, 38092258556227184, 225343812, 225343820, 8, 1440x900 
0x37CA2318, 38092258557090344, 225343896, 225343903, 7, 1440x900 
0x37CA2318, 38092258557744544, 225343969, 225343978, 9, 1440x900 
0x37CA2318, 38092258558401072, 225344027, 225344034, 7, 1440x900 
0x37CA2318, 38092258559062256, 225344097, 225344105, 8, 1440x900 
0x37CA2318, 38092258559743224, 225344168, 225344178, 10, 1440x900 
0x37CA2318, 38092258560197872, 225344207, 225344215, 8, 1440x900 
0x37CA2318, 38092258560865456, 225344273, 225344282, 9, 1440x900 
0x37CA2318, 38092258561521792, 225344337, 225344347, 10, 1440x900 
0x37CA2318, 38092258562183056, 225344406, 225344416, 10, 1440x900 
0x37CA2318, 38092258562842616, 225344471, 225344480, 9, 1440x900 
0x37CA2318, 38092258563501992, 225344537, 225344546, 9, 1440x900 
0x37CA2318, 38092258564175272, 225344603, 225344612, 9, 1440x900 
0x37CA2318, 38092258564824752, 225344668, 225344677, 9, 1440x900 
0x37CA2318, 38092258565502520, 225344737, 225344744, 7, 1440x900 
0x37CA2318, 38092258566148848, 225344802, 225344810, 8, 1440x900 
0x37CA2318, 38092258566830584, 225344867, 225344875, 8, 1440x900 
0x37CA2318, 38092258567478352, 225344933, 225344941, 8, 1440x900 
0x37CA2318, 38092258568117008, 225344997, 225345005, 8, 1440x900 
0x37CA2318, 38092258568775728, 225345063, 225345071, 8, 1440x900 
0x37CA2318, 38092258569633544, 225345152, 225345159, 7, 1440x900 
0x37CA2318, 38092258570302608, 225345218, 225345230, 12, 1440x900 
0x37CA2318, 38092258570759288, 225345262, 225345271, 9, 1440x900 
0x37CA2318, 38092258571419832, 225345327, 225345335, 8, 1440x900 
0x37CA2318, 38092258572267896, 225345413, 225345420, 7, 1440x900 
0x37CA2318, 38092258572947088, 225345481, 225345488, 7, 1440x900 
0x37CA2318, 38092258573598352, 225345547, 225345554, 7, 1440x900 
0x37CA2318, 38092258574259616, 225345613, 225345622, 9, 1440x900 
0x37CA2318, 38092258574918832, 225345683, 225345691, 8, 1440x900 
0x37CA2318, 38092258575585952, 225345747, 225345755, 8, 1440x900 
0x37CA2318, 38092258576247864, 225345813, 225345821, 8, 1440x900 
0x37CA2318, 38092258576907888, 225345878, 225345887, 9, 1440x900 
0x37CA2318, 38092258577570672, 225345948, 225345956, 8, 1440x900 
0x37CA2318, 38092258578238936, 225346013, 225346021, 8, 1440x900 
0x37CA2318, 38092258578889832, 225346077, 225346086, 9, 1440x900 
0x37CA2318, 38092258579551792, 225346148, 225346156, 8, 1440x900 
0x37CA2318, 38092258580203560, 225346207, 225346216, 9, 1440x900 
0x37CA2318, 38092258580876672, 225346278, 225346286, 8, 1440x900 
0x37CA2318, 38092258581541184, 225346342, 225346350, 8, 1440x900 
0x37CA2318, 38092258582193432, 225346408, 225346416, 8, 1440x900 
0x37CA2318, 38092258582859192, 225346477, 225346485, 8, 1440x900 
0x37CA2318, 38092258583515344, 225346542, 225346550, 8, 1440x900 
0x37CA2318, 38092258584190864, 225346607, 225346615, 8, 1440x900 
0x37CA2318, 38092258584841976, 225346672, 225346680, 8, 1440x900 
0x37CA2318, 38092258585502368, 225346739, 225346747, 8, 1440x900 
0x37CA2318, 38092258586160160, 225346803, 225346811, 8, 1440x900 
0x37CA2318, 38092258586839104, 225346871, 225346878, 7, 1440x900 
0x37CA2318, 38092258587490544, 225346937, 225346945, 8, 1440x900 
0x37CA2318, 38092258588152080, 225347002, 225347010, 8, 1440x900 
0x37CA2318, 38092258588802688, 225347073, 225347081, 8, 1440x900 
0x37CA2318, 38092258589465904, 225347133, 225347140, 7, 1440x900 
0x37CA2318, 38092258590128976, 225347198, 225347206, 8, 1440x900 
0x37CA2318, 38092258590796896, 225347266, 225347274, 8, 1440x900 
0x37CA2318, 38092258591453280, 225347331, 225347339, 8, 1440x900 
0x37CA2318, 38092258592121592, 225347398, 225347405, 7, 1440x900 
0x37CA2318, 38092258592773880, 225347469, 225347477, 8, 1440x900 
0x37CA2318, 38092258593434744, 225347534, 225347542, 8, 1440x900 
0x37CA2318, 38092258594105176, 225347602, 225347610, 8, 1440x900 
0x37CA2318, 38092258595222080, 225347713, 225347721, 8, 1440x900 
0x37CA2318, 38092258595884216, 225347777, 225347785, 8, 1440x900 
0x37CA2318, 38092258596544528, 225347848, 225347857, 9, 1440x900 
0x37CA2318, 38092258597407264, 225347927, 225347935, 8, 1440x900 
0x37CA2318, 38092258598059384, 225347992, 225347999, 7, 1440x900 
0x37CA2318, 38092258598711160, 225348057, 225348063, 6, 1440x900 
0x37CA2318, 38092258599381392, 225348129, 225348137, 8, 1440x900 
0x37CA2318, 38092258599844328, 225348172, 225348179, 7, 1440x900 
0x37CA2318, 38092258600505392, 225348237, 225348244, 7, 1440x900 
0x37CA2318, 38092258601164592, 225348302, 225348310, 8, 1440x900 
0x37CA2318, 38092258601825368, 225348368, 225348376, 8, 1440x900 
0x37CA2318, 38092258602484776, 225348436, 225348444, 8, 1440x900 
0x37CA2318, 38092258603346880, 225348522, 225348531, 9, 1440x900 
0x37CA2318, 38092258604002536, 225348592, 225348600, 8, 1440x900 
0x37CA2318, 38092258604671544, 225348657, 225348665, 8, 1440x900 
0x37CA2318, 38092258605337248, 225348722, 225348730, 8, 1440x900 
0x37CA2318, 38092258605997928, 225348787, 225348795, 8, 1440x900 
0x37CA2318, 38092258606658232, 225348853, 225348860, 7, 1440x900 
0x37CA2318, 38092258607327728, 225348923, 225348931, 8, 1440x900 
0x37CA2318, 38092258607988600, 225348988, 225348996, 8, 1440x900 
0x37CA2318, 38092258608639744, 225349052, 225349060, 8, 1440x900 
0x37CA2318, 38092258609301120, 225349117, 225349126, 9, 1440x900 
0x37CA2318, 38092258609970840, 225349187, 225349195, 8, 1440x900 
0x37CA2318, 38092258610619960, 225349248, 225349255, 7, 1440x900 
0x37CA2318, 38092258611291536, 225349318, 225349326, 8, 1440x900 
0x37CA2318, 38092258611952144, 225349383, 225349392, 9, 1440x900 
0x37CA2318, 38092258612610992, 225349452, 225349460, 8, 1440x900 
0x37CA2318, 38092258613273680, 225349517, 225349525, 8, 1440x900 
0x37CA2318, 38092258613933736, 225349583, 225349591, 8, 1440x900 
0x37CA2318, 38092258614603288, 225349652, 225349660, 8, 1440x900 
0x37CA2318, 38092258615255776, 225349718, 225349726, 8, 1440x900 
0x37CA2318, 38092258615909696, 225349783, 225349791, 8, 1440x900 
0x37CA2318, 38092258616584080, 225349848, 225349856, 8, 1440x900 
0x37CA2318, 38092258617254912, 225349913, 225349921, 8, 1440x900 
0x37CA2318, 38092258617916496, 225349983, 225349991, 8, 1440x900 
0x37CA2318, 38092258618576688, 225350047, 225350055, 8, 1440x900 
0x37CA2318, 38092258619236592, 225350113, 225350121, 8, 1440x900 
0x37CA2318, 38092258619899096, 225350177, 225350186, 9, 1440x900 
0x37CA2318, 38092258620568216, 225350247, 225350255, 8, 1440x900 
0x37CA2318, 38092258621228728, 225350308, 225350316, 8, 1440x900 
0x37CA2318, 38092258621889280, 225350373, 225350381, 8, 1440x900 
0x37CA2318, 38092258622545744, 225350442, 225350449, 7, 1440x900 
0x37CA2318, 38092258623208320, 225350512, 225350520, 8, 1440x900 
0x37CA2318, 38092258623873120, 225350578, 225350586, 8, 1440x900 
0x37CA2318, 38092258624539616, 225350643, 225350651, 8, 1440x900 
0x37CA2318, 38092258625203248, 225350708, 225350716, 8, 1440x900 
0x37CA2318, 38092258625862368, 225350779, 225350787, 8, 1440x900 
0x37CA2318, 38092258626523224, 225350843, 225350852, 9, 1440x900 
0x37CA2318, 38092258627187072, 225350908, 225350915, 7, 1440x900 
0x37CA2318, 38092258627854016, 225350972, 225350980, 8, 1440x900 
0x37CA2318, 38092258628501096, 225351038, 225351046, 8, 1440x900 
0x37CA2318, 38092258629171776, 225351108, 225351116, 8, 1440x900 
0x37CA2318, 38092258629841352, 225351173, 225351181, 8, 1440x900 
0x37CA2318, 38092258630492984, 225351238, 225351246, 8, 1440x900 
0x37CA2318, 38092258631161920, 225351307, 225351316, 9, 1440x900 
0x37CA2318, 38092258631815056, 225351368, 225351375, 7, 1440x900 
0x37CA2318, 38092258632474696, 225351434, 225351443, 9, 1440x900 
0x37CA2318, 38092258633136528, 225351503, 225351511, 8, 1440x900 
0x37CA2318, 38092258633806432, 225351568, 225351577, 9, 1440x900 
0x37CA2318, 38092258634459264, 225351633, 225351642, 9, 1440x900 
0x37CA2318, 38092258635112808, 225351698, 225351707, 9, 1440x900 
0x37CA2318, 38092258635782992, 225351768, 225351777, 9, 1440x900 
0x37CA2318, 38092258636449040, 225351838, 225351846, 8, 1440x900 
0x37CA2318, 38092258637108480, 225351898, 225351906, 8, 1440x900 
0x37CA2318, 38092258637763360, 225351963, 225351970, 7, 1440x900 
0x37CA2318, 38092258638416184, 225352028, 225352035, 7, 1440x900 
0x37CA2318, 38092258639094800, 225352097, 225352105, 8, 1440x900 
0x37CA2318, 38092258639754280, 225352163, 225352170, 7, 1440x900 
0x37CA2318, 38092258640416624, 225352227, 225352235, 8, 1440x900 
0x37CA2318, 38092258641063344, 225352293, 225352299, 6, 1440x900 
0x37CA2318, 38092258641725256, 225352358, 225352366, 8, 1440x900 
0x37CA2318, 38092258642393736, 225352424, 225352432, 8, 1440x900 
0x37CA2318, 38092258643054056, 225352493, 225352500, 7, 1440x900 
0x37CA2318, 38092258643717088, 225352557, 225352564, 7, 1440x900 
0x37CA2318, 38092258644386704, 225352627, 225352634, 7, 1440x900 
0x37CA2318, 38092258645037000, 225352688, 225352695, 7, 1440x900 
0x37CA2318, 38092258645688312, 225352753, 225352762, 9, 1440x900 
0x37CA2318, 38092258646159048, 225352802, 225352808, 6, 1440x900 
0x37CA2318, 38092258646818992, 225352868, 225352875, 7, 1440x900 
0x37CA2318, 38092258647481848, 225352932, 225352940, 8, 1440x900 
0x37CA2318, 38092258648143752, 225353001, 225353008, 7, 1440x900 
0x37CA2318, 38092258648802160, 225353067, 225353074, 7, 1440x900 
0x37CA2318, 38092258649462064, 225353131, 225353139, 8, 1440x900 
0x37CA2318, 38092258650121896, 225353198, 225353205, 7, 1440x900 
0x37CA2318, 38092258650781864, 225353264, 225353272, 8, 1440x900 
0x37CA2318, 38092258651444344, 225353333, 225353340, 7, 1440x900 
0x37CA2318, 38092258652120680, 225353399, 225353407, 8, 1440x900 
0x37CA2318, 38092258652955360, 225353483, 225353490, 7, 1440x900 
0x37CA2318, 38092258653628624, 225353551, 225353559, 8, 1440x900 
0x37CA2318, 38092258654289536, 225353617, 225353625, 8, 1440x900 
0x37CA2318, 38092258654942760, 225353682, 225353690, 8, 1440x900 
0x37CA2318, 38092258655612496, 225353748, 225353757, 9, 1440x900 
0x37CA2318, 38092258656262800, 225353813, 225353820, 7, 1440x900 
0x37CA2318, 38092258656934184, 225353878, 225353886, 8, 1440x900 
0x37CA2318, 38092258657593480, 225353947, 225353955, 8, 1440x900 
0x37CA2318, 38092258658263424, 225354013, 225354020, 7, 1440x900 
0x37CA2318, 38092258658883080, 225354097, 225354123, 26, 1440x900 
0x37CA2318, 38092258659497472, 225354147, 225354155, 8, 1440x900 
0x37CA2318, 38092258660194792, 225354207, 225354218, 11, 1440x900 
0x37CA2318, 38092258660816136, 225354267, 225354275, 8, 1440x900 
0x37CA2318, 38092258661475656, 225354332, 225354340, 8, 1440x900 
0x37CA2318, 38092258662146976, 225354402, 225354409, 7, 1440x900 
0x37CA2318, 38092258662803712, 225354467, 225354474, 7, 1440x900 
0x37CA2318, 38092258663474640, 225354538, 225354546, 8, 1440x900 
0x37CA2318, 38092258664126432, 225354597, 225354605, 8, 1440x900 
0x37CA2318, 38092258664789272, 225354669, 225354676, 7, 1440x900 
0x37CA2318, 38092258665468768, 225354733, 225354740, 7, 1440x900 
0x37CA2318, 38092258666105704, 225354797, 225354804, 7, 1440x900 
0x37CA2318, 38092258666762544, 225354862, 225354869, 7, 1440x900 
0x37CA2318, 38092258667425832, 225354929, 225354936, 7, 1440x900 
0x37CA2318, 38092258668082632, 225354992, 225355000, 8, 1440x900 
0x37CA2318, 38092258668748528, 225355062, 225355068, 6, 1440x900 
0x37CA2318, 38092258670066464, 225355193, 225355200, 7, 1440x900 
0x37CA2318, 38092258670720256, 225355258, 225355265, 7, 1440x900 
0x37CA2318, 38092258671382352, 225355323, 225355331, 8, 1440x900 
0x37CA2318, 38092258672042208, 225355393, 225355402, 9, 1440x900 
0x37CA2318, 38092258672700344, 225355458, 225355467, 9, 1440x900 
0x37CA2318, 38092258673357312, 225355522, 225355529, 7, 1440x900 
0x37CA2318, 38092258674021264, 225355592, 225355600, 8, 1440x900 
0x37CA2318, 38092258674873480, 225355677, 225355685, 8, 1440x900 
0x37CA2318, 38092258675532960, 225355742, 225355750, 8, 1440x900 
0x37CA2318, 38092258676108896, 225355798, 225355806, 8, 1440x900 
0x37CA2318, 38092258676697592, 225355860, 225355870, 10, 1440x900 
0x37CA2318, 38092258677352192, 225355922, 225355935, 13, 1440x900 
0x37CA2318, 38092258678151336, 225356005, 225356041, 36, 1440x900 
0x37CA2318, 38092258678857200, 225356079, 225356090, 11, 1440x900 
0x37CA2318, 38092258679432136, 225356128, 225356157, 29, 1440x900 
0x37CA2318, 38092258680158896, 225356218, 225356241, 23, 1440x900 
0x37CA2318, 38092258680778656, 225356263, 225356301, 38, 1440x900 
0x37CA2318, 38092258681488560, 225356348, 225356357, 9, 1440x900 
0x37CA2318, 38092258682138976, 225356405, 225356420, 15, 1440x900 
0x37CA2318, 38092258682690880, 225356458, 225356466, 8, 1440x900 
0x37CA2318, 38092258683331784, 225356518, 225356525, 7, 1440x900 
0x37CA2318, 38092258683966976, 225356584, 225356590, 6, 1440x900 
0x37CA2318, 38092258684635848, 225356648, 225356655, 7, 1440x900 
0x37CA2318, 38092258685297744, 225356716, 225356722, 6, 1440x900 
0x37CA2318, 38092258685961840, 225356782, 225356789, 7, 1440x900 
0x37CA2318, 38092258686623424, 225356848, 225356854, 6, 1440x900 
0x37CA2318, 38092258687289536, 225356918, 225356926, 8, 1440x900 
0x37CA2318, 38092258687947032, 225356988, 225356997, 9, 1440x900 
0x37CA2318, 38092258688608560, 225357047, 225357054, 7, 1440x900 
0x37CA2318, 38092258689268672, 225357113, 225357120, 7, 1440x900 
0x37CA2318, 38092258689923016, 225357178, 225357185, 7, 1440x900 
0x37CA2318, 38092258690580496, 225357244, 225357251, 7, 1440x900 
0x37CA2318, 38092258691247424, 225357312, 225357320, 8, 1440x900 
0x37CA2318, 38092258691905544, 225357378, 225357386, 8, 1440x900 
0x37CA2318, 38092258692564208, 225357443, 225357450, 7, 1440x900 
0x37CA2318, 38092258693230448, 225357508, 225357516, 8, 1440x900 
0x37CA2318, 38092258693883984, 225357573, 225357581, 8, 1440x900 
0x37CA2318, 38092258694544288, 225357642, 225357650, 8, 1440x900 
0x37CA2318, 38092258695206600, 225357708, 225357715, 7, 1440x900 
0x37CA2318, 38092258695870568, 225357773, 225357780, 7, 1440x900 
0x37CA2318, 38092258696525272, 225357838, 225357845, 7, 1440x900 
0x37CA2318, 38092258697186856, 225357903, 225357911, 8, 1440x900 
0x37CA2318, 38092258697845792, 225357971, 225357978, 7, 1440x900 
0x37CA2318, 38092258698505568, 225358037, 225358043, 6, 1440x900 
0x37CA2318, 38092258699173928, 225358103, 225358110, 7, 1440x900 
0x37CA2318, 38092258699832144, 225358168, 225358175, 7, 1440x900 
0x37CA2318, 38092258700492192, 225358234, 225358242, 8, 1440x900 
0x37CA2318, 38092258701152216, 225358302, 225358309, 7, 1440x900 
0x37CA2318, 38092258702016952, 225358393, 225358401, 8, 1440x900 
0x37CA2318, 38092258702483936, 225358437, 225358446, 9, 1440x900 
0x37CA2318, 38092258703198184, 225358508, 225358516, 8, 1440x900 
0x37CA2318, 38092258703809984, 225358568, 225358575, 7, 1440x900 
0x37CA2318, 38092258704477712, 225358633, 225358641, 8, 1440x900 
0x37CA2318, 38092258705136888, 225358698, 225358706, 8, 1440x900 
0x37CA2318, 38092258705801304, 225358767, 225358775, 8, 1440x900 
0x37CA2318, 38092258706458384, 225358832, 225358839, 7, 1440x900 
0x37CA2318, 38092258707118224, 225358897, 225358904, 7, 1440x900 
0x37CA2318, 38092258707779872, 225358962, 225358970, 8, 1440x900 
0x37CA2318, 38092258708441704, 225359032, 225359039, 7, 1440x900 
0x37CA2318, 38092258709099960, 225359097, 225359104, 7, 1440x900 
0x37CA2318, 38092258709756192, 225359162, 225359170, 8, 1440x900 
0x37CA2318, 38092258710621872, 225359247, 225359254, 7, 1440x900 
0x37CA2318, 38092258711084520, 225359292, 225359300, 8, 1440x900 
0x37CA2318, 38092258711903200, 225359377, 225359388, 11, 1440x900 
0x37CA2318, 38092258712452704, 225359434, 225359455, 21, 1440x900 
0x37CA2318, 38092258713249656, 225359519, 225359530, 11, 1440x900 
0x37CA2318, 38092258713801344, 225359567, 225359607, 40, 1440x900 
0x37CA2318, 38092258714484456, 225359642, 225359652, 10, 1440x900 
0x37CA2318, 38092258715219152, 225359709, 225359733, 24, 1440x900 
0x37CA2318, 38092258715860688, 225359773, 225359780, 7, 1440x900 
0x37CA2318, 38092258716399888, 225359827, 225359833, 6, 1440x900 
0x37CA2318, 38092258717235920, 225359912, 225359919, 7, 1440x900 
0x37CA2318, 38092258717701448, 225359957, 225359963, 6, 1440x900 
0x37CA2318, 38092258718549592, 225360042, 225360049, 7, 1440x900 
0x37CA2318, 38092258719220568, 225360111, 225360118, 7, 1440x900 
0x37CA2318, 38092258719880680, 225360178, 225360185, 7, 1440x900 
0x37CA2318, 38092258720534584, 225360244, 225360252, 8, 1440x900 
0x37CA2318, 38092258721203448, 225360312, 225360319, 7, 1440x900 
0x37CA2318, 38092258721872472, 225360378, 225360386, 8, 1440x900 
0x37CA2318, 38092258722524168, 225360442, 225360450, 8, 1440x900 
0x37CA2318, 38092258723184592, 225360509, 225360517, 8, 1440x900 
0x37CA2318, 38092258723846120, 225360573, 225360581, 8, 1440x900 
0x37CA2318, 38092258724508120, 225360642, 225360650, 8, 1440x900 
0x37CA2318, 38092258725162232, 225360703, 225360712, 9, 1440x900 
0x37CA2318, 38092258725834376, 225360773, 225360782, 9, 1440x900 
0x37CA2318, 38092258726494336, 225360834, 225360842, 8, 1440x900 
0x37CA2318, 38092258727146816, 225360903, 225360911, 8, 1440x900 
0x37CA2318, 38092258727810816, 225360972, 225360980, 8, 1440x900 
0x37CA2318, 38092258728469440, 225361037, 225361045, 8, 1440x900 
0x37CA2318, 38092258729123568, 225361102, 225361110, 8, 1440x900 
0x37CA2318, 38092258729795696, 225361167, 225361176, 9, 1440x900 
0x37CA2318, 38092258730448288, 225361237, 225361245, 8, 1440x900 
0x37CA2318, 38092258731126344, 225361302, 225361310, 8, 1440x900 
0x37CA2318, 38092258731780376, 225361368, 225361376, 8, 1440x900 
0x37CA2318, 38092258732451600, 225361433, 225361442, 9, 1440x900 
0x37CA2318, 38092258733109984, 225361498, 225361507, 9, 1440x900 
0x37CA2318, 38092258733762432, 225361563, 225361572, 9, 1440x900 
0x37CA2318, 38092258734423584, 225361633, 225361641, 8, 1440x900 
0x37CA2318, 38092258735092912, 225361697, 225361705, 8, 1440x900 
0x37CA2318, 38092258735747792, 225361758, 225361766, 8, 1440x900 
0x37CA2318, 38092258736418056, 225361828, 225361836, 8, 1440x900 
0x37CA2318, 38092258737077352, 225361896, 225361904, 8, 1440x900 
0x37CA2318, 38092258737737680, 225361962, 225361969, 7, 1440x900 
0x37CA2318, 38092258738388840, 225362026, 225362034, 8, 1440x900 
0x37CA2318, 38092258739049896, 225362092, 225362100, 8, 1440x900 
0x37CA2318, 38092258739711616, 225362158, 225362167, 9, 1440x900 
0x37CA2318, 38092258740375312, 225362228, 225362236, 8, 1440x900 
0x37CA2318, 38092258741026440, 225362292, 225362300, 8, 1440x900 
0x37CA2318, 38092258741703464, 225362358, 225362367, 9, 1440x900 
0x37CA2318, 38092258742225120, 225362408, 225362418, 10, 1440x900 
0x37CA2318, 38092258743021680, 225362493, 225362501, 8, 1440x900 
0x37CA2318, 38092258743691712, 225362557, 225362565, 8, 1440x900 
0x37CA2318, 38092258744352360, 225362628, 225362636, 8, 1440x900 
0x37CA2318, 38092258745010152, 225362692, 225362700, 8, 1440x900 
0x37CA2318, 38092258745678912, 225362753, 225362761, 8, 1440x900 
0x37CA2318, 38092258746342888, 225362823, 225362831, 8, 1440x900 
0x37CA2318, 38092258746992912, 225362887, 225362895, 8, 1440x900 
0x37CA2318, 38092258747672808, 225362958, 225362966, 8, 1440x900 
0x37CA2318, 38092258748343488, 225363022, 225363031, 9, 1440x900 
0x37CA2318, 38092258748994992, 225363088, 225363096, 8, 1440x900 
0x37CA2318, 38092258749654032, 225363152, 225363159, 7, 1440x900 
0x37CA2318, 38092258750316360, 225363222, 225363230, 8, 1440x900 
0x37CA2318, 38092258750976360, 225363288, 225363296, 8, 1440x900 
0x37CA2318, 38092258751629760, 225363352, 225363360, 8, 1440x900 
0x37CA2318, 38092258752293200, 225363418, 225363426, 8, 1440x900 
0x37CA2318, 38092258752956968, 225363487, 225363495, 8, 1440x900 
0x37CA2318, 38092258753616896, 225363552, 225363560, 8, 1440x900 
0x37CA2318, 38092258754277880, 225363618, 225363626, 8, 1440x900 
0x37CA2318, 38092258754951080, 225363693, 225363703, 10, 1440x900 
0x37CA2318, 38092258755550408, 225363742, 225363750, 8, 1440x900 
0x37CA2318, 38092258756924400, 225363879, 225363886, 7, 1440x900 
0x37CA2318, 38092258757584960, 225363947, 225363956, 9, 1440x900 
0x37CA2318, 38092258758244416, 225364013, 225364021, 8, 1440x900 
0x37CA2318, 38092258758913280, 225364078, 225364084, 6, 1440x900 
0x37CA2318, 38092258759560864, 225364148, 225364157, 9, 1440x900 
0x37CA2318, 38092258760222104, 225364208, 225364215, 7, 1440x900 
0x37CA2318, 38092258760902072, 225364277, 225364285, 8, 1440x900 
0x37CA2318, 38092258761546048, 225364342, 225364350, 8, 1440x900 
0x37CA2318, 38092258762208352, 225364407, 225364415, 8, 1440x900 
0x37CA2318, 38092258762880880, 225364473, 225364481, 8, 1440x900 
0x37CA2318, 38092258763539216, 225364541, 225364548, 7, 1440x900 
0x37CA2318, 38092258764196872, 225364607, 225364615, 8, 1440x900 
0x37CA2318, 38092258764859504, 225364672, 225364680, 8, 1440x900 
0x37CA2318, 38092258765526952, 225364743, 225364751, 8, 1440x900 
0x37CA2318, 38092258766178256, 225364808, 225364816, 8, 1440x900 
0x37CA2318, 38092258766838568, 225364873, 225364880, 7, 1440x900 
0x37CA2318, 38092258767499216, 225364938, 225364947, 9, 1440x900 
0x37CA2318, 38092258768160032, 225365007, 225365016, 9, 1440x900 
0x37CA2318, 38092258768818432, 225365072, 225365080, 8, 1440x900 
0x37CA2318, 38092258769488448, 225365137, 225365145, 8, 1440x900 
0x37CA2318, 38092258770149056, 225365203, 225365211, 8, 1440x900 
0x37CA2318, 38092258770816080, 225365273, 225365281, 8, 1440x900 
0x37CA2318, 38092258771475752, 225365338, 225365346, 8, 1440x900 
0x37CA2318, 38092258772137176, 225365402, 225365410, 8, 1440x900 
0x37CA2318, 38092258772788248, 225365468, 225365476, 8, 1440x900 
0x37CA2318, 38092258773459656, 225365534, 225365542, 8, 1440x900 
0x37CA2318, 38092258774128448, 225365602, 225365610, 8, 1440x900 
0x37CA2318, 38092258774787888, 225365667, 225365675, 8, 1440x900 
0x37CA2318, 38092258775441424, 225365731, 225365739, 8, 1440x900 
0x37CA2318, 38092258776101104, 225365796, 225365804, 8, 1440x900 
0x37CA2318, 38092258776767696, 225365863, 225365871, 8, 1440x900 
0x37CA2318, 38092258777427656, 225365931, 225365939, 8, 1440x900 
0x37CA2318, 38092258778080984, 225365992, 225366000, 8, 1440x900 
0x37CA2318, 38092258778742264, 225366058, 225366066, 8, 1440x900 
0x37CA2318, 38092258779395048, 225366127, 225366135, 8, 1440x900 
0x37CA2318, 38092258780065560, 225366198, 225366205, 7, 1440x900 
0x37CA2318, 38092258780716672, 225366259, 225366268, 9, 1440x900 
0x37CA2318, 38092258781388712, 225366328, 225366336, 8, 1440x900 
0x37CA2318, 38092258782049376, 225366393, 225366402, 9, 1440x900 
0x37CA2318, 38092258782712256, 225366462, 225366470, 8, 1440x900 
0x37CA2318, 38092258783368488, 225366528, 225366536, 8, 1440x900 
0x37CA2318, 38092258784034336, 225366593, 225366601, 8, 1440x900 
0x37CA2318, 38092258784687152, 225366662, 225366670, 8, 1440x900 
0x37CA2318, 38092258785338984, 225366722, 225366730, 8, 1440x900 
0x37CA2318, 38092258786004032, 225366793, 225366802, 9, 1440x900 
0x37CA2318, 38092258786672048, 225366857, 225366865, 8, 1440x900 
0x37CA2318, 38092258787341248, 225366923, 225366931, 8, 1440x900 
0x37CA2318, 38092258787991944, 225366988, 225366996, 8, 1440x900 
0x37CA2318, 38092258788653624, 225367058, 225367066, 8, 1440x900 
0x37CA2318, 38092258789310872, 225367117, 225367125, 8, 1440x900 
0x37CA2318, 38092258789974896, 225367188, 225367196, 8, 1440x900 
0x37CA2318, 38092258790637344, 225367253, 225367261, 8, 1440x900 
0x37CA2318, 38092258791289768, 225367317, 225367326, 9, 1440x900 
0x37CA2318, 38092258791960304, 225367387, 225367395, 8, 1440x900 
0x37CA2318, 38092258792612648, 225367453, 225367462, 9, 1440x900 
0x37CA2318, 38092258793289672, 225367519, 225367527, 8, 1440x900 
0x37CA2318, 38092258793745384, 225367568, 225367576, 8, 1440x900 
0x37CA2318, 38092258794432664, 225367634, 225367653, 19, 1440x900 
0x37CA2318, 38092258795140640, 225367698, 225367709, 11, 1440x900 
0x37CA2318, 38092258795792416, 225367767, 225367780, 13, 1440x900 
0x37CA2318, 38092258796455792, 225367832, 225367842, 10, 1440x900 
0x37CA2318, 38092258797095328, 225367898, 225367906, 8, 1440x900 
0x37CA2318, 38092258797731312, 225367964, 225367975, 11, 1440x900 
0x37CA2318, 38092258798389120, 225368027, 225368037, 10, 1440x900 
0x37CA2318, 38092258799056304, 225368094, 225368105, 11, 1440x900 
0x37CA2318, 38092258799715408, 225368159, 225368169, 10, 1440x900 
0x37CA2318, 38092258800376264, 225368223, 225368231, 8, 1440x900 
0x37CA2318, 38092258801036216, 225368288, 225368301, 13, 1440x900 
0x37CA2318, 38092258801695944, 225368360, 225368371, 11, 1440x900 
0x37CA2318, 38092258802355760, 225368422, 225368434, 12, 1440x900 
0x37CA2318, 38092258803015352, 225368488, 225368495, 7, 1440x900 
0x37CA2318, 38092258803877944, 225368573, 225368580, 7, 1440x900 
0x37CA2318, 38092258804540296, 225368642, 225368650, 8, 1440x900 
0x37CA2318, 38092258804996552, 225368687, 225368694, 7, 1440x900 
0x37CA2318, 38092258805782952, 225368763, 225368770, 7, 1440x900 
0x37CA2318, 38092258806312000, 225368817, 225368824, 7, 1440x900 
0x37CA2318, 38092258806995928, 225368888, 225368896, 8, 1440x900 
0x37CA2318, 38092258807637816, 225368948, 225368956, 8, 1440x900 
0x37CA2318, 38092258808302648, 225369017, 225369024, 7, 1440x900 
0x37CA2318, 38092258808961672, 225369082, 225369089, 7, 1440x900 
0x37CA2318, 38092258809632488, 225369152, 225369160, 8, 1440x900 
0x37CA2318, 38092258810286136, 225369212, 225369219, 7, 1440x900 
0x37CA2318, 38092258810946536, 225369278, 225369286, 8, 1440x900 
0x37CA2318, 38092258811605576, 225369347, 225369354, 7, 1440x900 
0x37CA2318, 38092258812267088, 225369412, 225369420, 8, 1440x900 
0x37CA2318, 38092258812928704, 225369478, 225369486, 8, 1440x900 
0x37CA2318, 38092258813596592, 225369547, 225369554, 7, 1440x900 
0x37CA2318, 38092258814916392, 225369677, 225369685, 8, 1440x900 
0x37CA2318, 38092258815581776, 225369742, 225369750, 8, 1440x900 
0x37CA2318, 38092258816241008, 225369811, 225369818, 7, 1440x900 
0x37CA2318, 38092258816903472, 225369877, 225369884, 7, 1440x900 
0x37CA2318, 38092258817564128, 225369942, 225369950, 8, 1440x900 
0x37CA2318, 38092258818224448, 225370008, 225370016, 8, 1440x900 
0x37CA2318, 38092258818884416, 225370072, 225370081, 9, 1440x900 
0x37CA2318, 38092258819544848, 225370139, 225370147, 8, 1440x900 
0x37CA2318, 38092258820206952, 225370207, 225370215, 8, 1440x900 
0x37CA2318, 38092258820867224, 225370272, 225370280, 8, 1440x900 
0x37CA2318, 38092258821531808, 225370338, 225370347, 9, 1440x900 
0x37CA2318, 38092258822191944, 225370407, 225370415, 8, 1440x900 
0x37CA2318, 38092258823051304, 225370497, 225370505, 8, 1440x900 
0x37CA2318, 38092258823521344, 225370538, 225370547, 9, 1440x900 
0x37CA2318, 38092258824187296, 225370603, 225370612, 9, 1440x900 
0x37CA2318, 38092258824847456, 225370672, 225370680, 8, 1440x900 
0x37CA2318, 38092258825515616, 225370737, 225370746, 9, 1440x900 
0x37CA2318, 38092258826367464, 225370823, 225370831, 8, 1440x900 
0x37CA2318, 38092258827028696, 225370888, 225370897, 9, 1440x900 
0x37CA2318, 38092258827689544, 225370956, 225370964, 8, 1440x900 
0x37CA2318, 38092258828350688, 225371022, 225371029, 7, 1440x900 
0x37CA2318, 38092258828805616, 225371067, 225371075, 8, 1440x900 
0x37CA2318, 38092258829473488, 225371132, 225371140, 8, 1440x900 
0x37CA2318, 38092258830131280, 225371197, 225371205, 8, 1440x900 
0x37CA2318, 38092258830790040, 225371266, 225371273, 7, 1440x900 
0x37CA2318, 38092258831450344, 225371332, 225371339, 7, 1440x900 
0x37CA2318, 38092258832110344, 225371397, 225371404, 7, 1440x900 
0x37CA2318, 38092258832776128, 225371462, 225371470, 8, 1440x900 
0x37CA2318, 38092258833436152, 225371528, 225371536, 8, 1440x900 
0x37CA2318, 38092258834096528, 225371593, 225371601, 8, 1440x900 
0x37CA2318, 38092258834754592, 225371662, 225371669, 7, 1440x900 
0x37CA2318, 38092258835415904, 225371728, 225371735, 7, 1440x900 
0x37CA2318, 38092258836086408, 225371798, 225371805, 7, 1440x900 
0x37CA2318, 38092258836739920, 225371863, 225371870, 7, 1440x900 
0x37CA2318, 38092258837593000, 225371948, 225371957, 9, 1440x900 
0x37CA2318, 38092258838066440, 225371998, 225372006, 8, 1440x900 
0x37CA2318, 38092258838723200, 225372058, 225372066, 8, 1440x900 
0x37CA2318, 38092258839571320, 225372148, 225372156, 8, 1440x900 
0x37CA2318, 38092258840236184, 225372212, 225372220, 8, 1440x900 
0x37CA2318, 38092258840893968, 225372276, 225372284, 8, 1440x900 
0x37CA2318, 38092258841552208, 225372343, 225372351, 8, 1440x900 
0x37CA2318, 38092258842222456, 225372413, 225372422, 9, 1440x900 
0x37CA2318, 38092258842884752, 225372473, 225372482, 9, 1440x900 
0x37CA2318, 38092258843545384, 225372548, 225372556, 8, 1440x900 
0x37CA2318, 38092258844207296, 225372613, 225372621, 8, 1440x900 
0x37CA2318, 38092258844877648, 225372677, 225372685, 8, 1440x900 
0x37CA2318, 38092258845529832, 225372743, 225372751, 8, 1440x900 
0x37CA2318, 38092258846190024, 225372807, 225372815, 8, 1440x900 
0x37CA2318, 38092258846850120, 225372872, 225372880, 8, 1440x900 
0x37CA2318, 38092258847511856, 225372937, 225372945, 8, 1440x900 
0x37CA2318, 38092258848181568, 225373007, 225373015, 8, 1440x900 
0x37CA2318, 38092258848840960, 225373073, 225373081, 8, 1440x900 
0x37CA2318, 38092258849493408, 225373138, 225373147, 9, 1440x900 
0x37CA2318, 38092258850163424, 225373204, 225373214, 10, 1440x900 
0x37CA2318, 38092258850815328, 225373273, 225373281, 8, 1440x900 
0x37CA2318, 38092258851286800, 225373318, 225373326, 8, 1440x900 
0x37CA2318, 38092258852139528, 225373401, 225373409, 8, 1440x900 
0x37CA2318, 38092258852603480, 225373448, 225373455, 7, 1440x900 
0x37CA2318, 38092258853266408, 225373512, 225373520, 8, 1440x900 
0x37CA2318, 38092258853927064, 225373578, 225373586, 8, 1440x900 
0x37CA2318, 38092258854587048, 225373643, 225373651, 8, 1440x900 
0x37CA2318, 38092258855246176, 225373708, 225373717, 9, 1440x900 
0x37CA2318, 38092258855906808, 225373777, 225373785, 8, 1440x900 
0x37CA2318, 38092258856566040, 225373843, 225373851, 8, 1440x900 
0x37CA2318, 38092258857226256, 225373907, 225373915, 8, 1440x900 
0x37CA2318, 38092258857896128, 225373977, 225373984, 7, 1440x900 
0x37CA2318, 38092258858556264, 225374042, 225374049, 7, 1440x900 
0x37CA2318, 38092258859216240, 225374108, 225374116, 8, 1440x900 
0x37CA2318, 38092258859876416, 225374172, 225374180, 8, 1440x900 
0x37CA2318, 38092258860535896, 225374238, 225374246, 8, 1440x900 
0x37CA2318, 38092258861196160, 225374307, 225374314, 7, 1440x900 
0x37CA2318, 38092258861855648, 225374372, 225374380, 8, 1440x900 
0x37CA2318, 38092258862516320, 225374437, 225374445, 8, 1440x900 
0x37CA2318, 38092258863176280, 225374503, 225374511, 8, 1440x900 
0x37CA2318, 38092258863836392, 225374568, 225374576, 8, 1440x900 
0x37CA2318, 38092258864496160, 225374633, 225374642, 9, 1440x900 
0x37CA2318, 38092258865161608, 225374707, 225374715, 8, 1440x900 
0x37CA2318, 38092258866012960, 225374788, 225374796, 8, 1440x900 
0x37CA2318, 38092258866477336, 225374833, 225374840, 7, 1440x900 
0x37CA2318, 38092258867145696, 225374903, 225374911, 8, 1440x900 
0x37CA2318, 38092258867801864, 225374967, 225374975, 8, 1440x900 
0x37CA2318, 38092258868460000, 225375031, 225375039, 8, 1440x900 
0x37CA2318, 38092258869314664, 225375118, 225375125, 7, 1440x900 
0x37CA2318, 38092258869781608, 225375163, 225375171, 8, 1440x900 
0x37CA2318, 38092258870444320, 225375231, 225375239, 8, 1440x900 
0x37CA2318, 38092258871288616, 225375317, 225375325, 8, 1440x900 
0x37CA2318, 38092258871760304, 225375362, 225375370, 8, 1440x900 
0x37CA2318, 38092258872421544, 225375428, 225375436, 8, 1440x900 
0x37CA2318, 38092258873078896, 225375492, 225375500, 8, 1440x900 
0x37CA2318, 38092258873743320, 225375562, 225375571, 9, 1440x900 
0x37CA2318, 38092258874409072, 225375627, 225375634, 7, 1440x900 
0x37CA2318, 38092258875067560, 225375692, 225375699, 7, 1440x900 
0x37CA2318, 38092258875727320, 225375758, 225375765, 7, 1440x900 
0x37CA2318, 38092258876390136, 225375826, 225375834, 8, 1440x900 
0x37CA2318, 38092258877712400, 225375957, 225375966, 9, 1440x900 
0x37CA2318, 38092258878370808, 225376022, 225376030, 8, 1440x900 
0x37CA2318, 38092258879028776, 225376088, 225376096, 8, 1440x900 
0x37CA2318, 38092258879692816, 225376153, 225376161, 8, 1440x900 
0x37CA2318, 38092258880356840, 225376221, 225376229, 8, 1440x900 
0x37CA2318, 38092258881020104, 225376288, 225376296, 8, 1440x900 
0x37CA2318, 38092258881677296, 225376353, 225376360, 7, 1440x900 
0x37CA2318, 38092258882335832, 225376418, 225376427, 9, 1440x900 
0x37CA2318, 38092258882994640, 225376483, 225376491, 8, 1440x900 
0x37CA2318, 38092258883660456, 225376552, 225376560, 8, 1440x900 
0x37CA2318, 38092258884327120, 225376621, 225376629, 8, 1440x900 
0x37CA2318, 38092258884984992, 225376686, 225376693, 7, 1440x900 
0x37CA2318, 38092258885642032, 225376752, 225376759, 7, 1440x900 
0x37CA2318, 38092258886304936, 225376816, 225376824, 8, 1440x900 
0x37CA2318, 38092258886971280, 225376887, 225376895, 8, 1440x900 
0x37CA2318, 38092258887631456, 225376953, 225376961, 8, 1440x900 
0x37CA2318, 38092258888295016, 225377022, 225377030, 8, 1440x900 
0x37CA2318, 38092258888952784, 225377082, 225377090, 8, 1440x900 
0x37CA2318, 38092258889610160, 225377148, 225377156, 8, 1440x900 
0x37CA2318, 38092258890267560, 225377213, 225377220, 7, 1440x900 
0x37CA2318, 38092258890937584, 225377278, 225377286, 8, 1440x900 
0x37CA2318, 38092258891598192, 225377346, 225377354, 8, 1440x900 
0x37CA2318, 38092258892257864, 225377412, 225377421, 9, 1440x900 
0x37CA2318, 38092258892923632, 225377483, 225377491, 8, 1440x900 
0x37CA2318, 38092258893583952, 225377548, 225377557, 9, 1440x900 
0x37CA2318, 38092258894236584, 225377608, 225377616, 8, 1440x900 
0x37CA2318, 38092258894898768, 225377677, 225377684, 7, 1440x900 
0x37CA2318, 38092258895563320, 225377743, 225377751, 8, 1440x900 
0x37CA2318, 38092258896220328, 225377807, 225377815, 8, 1440x900 
0x37CA2318, 38092258896882976, 225377873, 225377881, 8, 1440x900 
0x37CA2318, 38092258897544872, 225377941, 225377948, 7, 1440x900 
0x37CA2318, 38092258898202608, 225378007, 225378014, 7, 1440x900 
0x37CA2318, 38092258898872128, 225378072, 225378080, 8, 1440x900 
0x37CA2318, 38092258899525408, 225378138, 225378146, 8, 1440x900 
0x37CA2318, 38092258900206024, 225378207, 225378215, 8, 1440x900 
0x37CA2318, 38092258900858152, 225378272, 225378280, 8, 1440x900 
0x37CA2318, 38092258901524856, 225378338, 225378346, 8, 1440x900 
0x37CA2318, 38092258902186232, 225378402, 225378410, 8, 1440x900 
0x37CA2318, 38092258902837800, 225378471, 225378478, 7, 1440x900 
0x37CA2318, 38092258903494512, 225378536, 225378544, 8, 1440x900 
0x37CA2318, 38092258904159432, 225378607, 225378615, 8, 1440x900 
0x37CA2318, 38092258904822064, 225378673, 225378680, 7, 1440x900 
0x37CA2318, 38092258905480440, 225378733, 225378742, 9, 1440x900 
0x37CA2318, 38092258906137408, 225378798, 225378806, 8, 1440x900 
0x37CA2318, 38092258906797384, 225378867, 225378875, 8, 1440x900 
0x37CA2318, 38092258907463432, 225378932, 225378939, 7, 1440x900 
0x37CA2318, 38092258908120824, 225378997, 225379005, 8, 1440x900 
0x37CA2318, 38092258908780560, 225379063, 225379072, 9, 1440x900 
0x37CA2318, 38092258909446840, 225379132, 225379139, 7, 1440x900 
0x37CA2318, 38092258910102112, 225379197, 225379205, 8, 1440x900 
0x37CA2318, 38092258910766312, 225379262, 225379269, 7, 1440x900 
0x37CA2318, 38092258911421856, 225379328, 225379336, 8, 1440x900 
0x37CA2318, 38092258912089488, 225379396, 225379403, 7, 1440x900 
0x37CA2318, 38092258912774728, 225379468, 225379477, 9, 1440x900 
0x37CA2318, 38092258913420760, 225379528, 225379536, 8, 1440x900 
0x37CA2318, 38092258914079688, 225379593, 225379601, 8, 1440x900 
0x37CA2318, 38092258914933344, 225379683, 225379691, 8, 1440x900 
0x37CA2318, 38092258915405608, 225379727, 225379737, 10, 1440x900 
0x37CA2318, 38092258916070152, 225379804, 225379813, 9, 1440x900 
0x37CA2318, 38092258916724416, 225379858, 225379866, 8, 1440x900 
0x37CA2318, 38092258917388352, 225379927, 225379935, 8, 1440x900 
0x37CA2318, 38092258918044552, 225379992, 225380000, 8, 1440x900 
0x37CA2318, 38092258918700568, 225380057, 225380065, 8, 1440x900 
0x37CA2318, 38092258919360600, 225380122, 225380129, 7, 1440x900 
0x37CA2318, 38092258920024048, 225380189, 225380196, 7, 1440x900 
0x37CA2318, 38092258920681320, 225380256, 225380264, 8, 1440x900 
0x37CA2318, 38092258921744400, 225380359, 225380375, 16, 1440x900 
0x37CA2318, 38092258922360248, 225380424, 225380434, 10, 1440x900 
0x37CA2318, 38092258923047240, 225380488, 225380495, 7, 1440x900 
0x37CA2318, 38092258923864808, 225380573, 225380581, 8, 1440x900 
0x37CA2318, 38092258924329120, 225380623, 225380630, 7, 1440x900 
0x37CA2318, 38092258924989360, 225380684, 225380692, 8, 1440x900 
0x37CA2318, 38092258925653104, 225380752, 225380760, 8, 1440x900 
0x37CA2318, 38092258926313704, 225380818, 225380825, 7, 1440x900 
0x37CA2318, 38092258926978016, 225380887, 225380895, 8, 1440x900 
0x37CA2318, 38092258927635552, 225380948, 225380957, 9, 1440x900 
0x37CA2318, 38092258928296112, 225381018, 225381025, 7, 1440x900 
0x37CA2318, 38092258928955824, 225381083, 225381090, 7, 1440x900 
0x37CA2318, 38092258929627368, 225381153, 225381161, 8, 1440x900 
0x37CA2318, 38092258930279736, 225381220, 225381228, 8, 1440x900 
0x37CA2318, 38092258930938304, 225381283, 225381291, 8, 1440x900 
0x37CA2318, 38092258931598824, 225381353, 225381361, 8, 1440x900 
0x37CA2318, 38092258932256032, 225381412, 225381420, 8, 1440x900 
0x37CA2318, 38092258932924024, 225381481, 225381489, 8, 1440x900 
0x37CA2318, 38092258933772064, 225381568, 225381576, 8, 1440x900 
0x37CA2318, 38092258934431592, 225381633, 225381641, 8, 1440x900 
0x37CA2318, 38092258935096472, 225381698, 225381706, 8, 1440x900 
0x37CA2318, 38092258935765232, 225381767, 225381773, 6, 1440x900 
0x37CA2318, 38092258936424832, 225381834, 225381842, 8, 1440x900 
0x37CA2318, 38092258937075560, 225381896, 225381904, 8, 1440x900 
0x37CA2318, 38092258937745960, 225381962, 225381970, 8, 1440x900 
0x37CA2318, 38092258938407808, 225382042, 225382052, 10, 1440x900 
0x37CA2318, 38092258939063976, 225382098, 225382109, 11, 1440x900 
0x37CA2318, 38092258939722224, 225382159, 225382169, 10, 1440x900 
0x37CA2318, 38092258940339464, 225382222, 225382229, 7, 1440x900 
0x37CA2318, 38092258940999048, 225382287, 225382295, 8, 1440x900 
0x37CA2318, 38092258941658040, 225382352, 225382359, 7, 1440x900 
0x37CA2318, 38092258942314640, 225382417, 225382424, 7, 1440x900 
0x37CA2318, 38092258942976248, 225382483, 225382490, 7, 1440x900 
0x37CA2318, 38092258943634744, 225382548, 225382555, 7, 1440x900 
0x37CA2318, 38092258944307704, 225382622, 225382630, 8, 1440x900 
0x37CA2318, 38092258944969992, 225382683, 225382691, 8, 1440x900 
0x37CA2318, 38092258945639368, 225382752, 225382760, 8, 1440x900 
0x37CA2318, 38092258946296288, 225382817, 225382824, 7, 1440x900 
0x37CA2318, 38092258946957072, 225382883, 225382890, 7, 1440x900 
0x37CA2318, 38092258947623352, 225382947, 225382955, 8, 1440x900 
0x37CA2318, 38092258948440048, 225383032, 225383040, 8, 1440x900 
0x37CA2318, 38092258949134696, 225383102, 225383110, 8, 1440x900 
0x37CA2318, 38092258949811520, 225383173, 225383181, 8, 1440x900 
0x37CA2318, 38092258950274456, 225383218, 225383227, 9, 1440x900 
0x37CA2318, 38092258950942784, 225383288, 225383296, 8, 1440x900 
0x37CA2318, 38092258951594240, 225383347, 225383356, 9, 1440x900 
0x37CA2318, 38092258952280992, 225383417, 225383424, 7, 1440x900 
0x37CA2318, 38092258952931720, 225383478, 225383486, 8, 1440x900 
0x37CA2318, 38092258953589064, 225383546, 225383554, 8, 1440x900 
0x37CA2318, 38092258954263448, 225383617, 225383625, 8, 1440x900 
0x37CA2318, 38092258954915392, 225383677, 225383685, 8, 1440x900 
0x37CA2318, 38092258955754576, 225383763, 225383770, 7, 1440x900 
0x37CA2318, 38092258956232576, 225383811, 225383819, 8, 1440x900 
0x37CA2318, 38092258956895480, 225383877, 225383884, 7, 1440x900 
0x37CA2318, 38092258957556880, 225383942, 225383949, 7, 1440x900 
0x37CA2318, 38092258958218024, 225384007, 225384015, 8, 1440x900 
0x37CA2318, 38092258958881144, 225384077, 225384084, 7, 1440x900 
0x37CA2318, 38092258959543520, 225384142, 225384149, 7, 1440x900 
0x37CA2318, 38092258960198264, 225384207, 225384214, 7, 1440x900 
0x37CA2318, 38092258960871536, 225384278, 225384285, 7, 1440x900 
0x37CA2318, 38092258961520280, 225384337, 225384345, 8, 1440x900 
0x37CA2318, 38092258962177344, 225384402, 225384410, 8, 1440x900 
0x37CA2318, 38092258962834408, 225384468, 225384476, 8, 1440x900 
0x37CA2318, 38092258963497472, 225384536, 225384544, 8, 1440x900 
0x37CA2318, 38092258964159208, 225384602, 225384609, 7, 1440x900 
0x37CA2318, 38092258964818848, 225384668, 225384675, 7, 1440x900 
0x37CA2318, 38092258965494992, 225384739, 225384748, 9, 1440x900 
0x37CA2318, 38092258966156960, 225384808, 225384818, 10, 1440x900 
0x37CA2318, 38092258966803992, 225384867, 225384874, 7, 1440x900 
0x37CA2318, 38092258967464248, 225384932, 225384939, 7, 1440x900 
0x37CA2318, 38092258968125320, 225384998, 225385006, 8, 1440x900 
0x37CA2318, 38092258968786576, 225385067, 225385075, 8, 1440x900 
0x37CA2318, 38092258969445752, 225385131, 225385139, 8, 1440x900 
0x37CA2318, 38092258970106752, 225385197, 225385205, 8, 1440x900 
0x37CA2318, 38092258970768880, 225385268, 225385276, 8, 1440x900 
0x37CA2318, 38092258971612752, 225385347, 225385356, 9, 1440x900 
0x37CA2318, 38092258972281024, 225385413, 225385421, 8, 1440x900 
0x37CA2318, 38092258972941288, 225385483, 225385490, 7, 1440x900 
0x37CA2318, 38092258973405224, 225385527, 225385535, 8, 1440x900 
0x37CA2318, 38092258974067264, 225385592, 225385600, 8, 1440x900 
0x37CA2318, 38092258974728456, 225385658, 225385666, 8, 1440x900 
0x37CA2318, 38092258975387472, 225385723, 225385731, 8, 1440x900 
0x37CA2318, 38092258976046160, 225385792, 225385800, 8, 1440x900 
0x37CA2318, 38092258976711000, 225385858, 225385866, 8, 1440x900 
0x37CA2318, 38092258977371160, 225385923, 225385931, 8, 1440x900 
0x37CA2318, 38092258978041168, 225385993, 225386000, 7, 1440x900 
0x37CA2318, 38092258978696208, 225386053, 225386062, 9, 1440x900 
0x37CA2318, 38092258979360656, 225386123, 225386131, 8, 1440x900 
0x37CA2318, 38092258980016888, 225386187, 225386195, 8, 1440x900 
0x37CA2318, 38092258980675648, 225386253, 225386260, 7, 1440x900 
0x37CA2318, 38092258981336432, 225386317, 225386325, 8, 1440x900 
0x37CA2318, 38092258981996136, 225386388, 225386396, 8, 1440x900 
0x37CA2318, 38092258982666368, 225386452, 225386460, 8, 1440x900 
0x37CA2318, 38092258983335456, 225386523, 225386531, 8, 1440x900 
0x37CA2318, 38092258983985952, 225386583, 225386591, 8, 1440x900 
0x37CA2318, 38092258984651040, 225386652, 225386660, 8, 1440x900 
0x37CA2318, 38092258985310984, 225386717, 225386724, 7, 1440x900 
0x37CA2318, 38092258985971376, 225386782, 225386790, 8, 1440x900 
0x37CA2318, 38092258986637984, 225386851, 225386858, 7, 1440x900 
0x37CA2318, 38092258987297232, 225386917, 225386925, 8, 1440x900 
0x37CA2318, 38092258987957120, 225386982, 225386990, 8, 1440x900 
0x37CA2318, 38092258988619320, 225387047, 225387055, 8, 1440x900 
0x37CA2318, 38092258989277736, 225387113, 225387121, 8, 1440x900 
0x37CA2318, 38092258989935480, 225387178, 225387186, 8, 1440x900 
0x37CA2318, 38092258990602800, 225387248, 225387256, 8, 1440x900 
0x37CA2318, 38092258991257672, 225387312, 225387320, 8, 1440x900 
0x37CA2318, 38092258991918288, 225387377, 225387386, 9, 1440x900 
0x37CA2318, 38092258992590104, 225387448, 225387457, 9, 1440x900 
0x37CA2318, 38092258993244648, 225387512, 225387520, 8, 1440x900 
0x37CA2318, 38092258993904624, 225387577, 225387585, 8, 1440x900 
0x37CA2318, 38092258994562432, 225387643, 225387651, 8, 1440x900 
0x37CA2318, 38092258995232448, 225387708, 225387718, 10, 1440x900 
0x37CA2318, 38092258995897568, 225387777, 225387784, 7, 1440x900 
0x37CA2318, 38092258996559536, 225387842, 225387850, 8, 1440x900 
0x37CA2318, 38092258997217920, 225387908, 225387916, 8, 1440x900 
0x37CA2318, 38092258997877064, 225387972, 225387980, 8, 1440x900 
0x37CA2318, 38092258998536992, 225388042, 225388049, 7, 1440x900 
0x37CA2318, 38092258999206432, 225388107, 225388114, 7, 1440x900 
0x37CA2318, 38092258999869600, 225388172, 225388181, 9, 1440x900 
0x37CA2318, 38092259001199472, 225388306, 225388314, 8, 1440x900 
0x37CA2318, 38092259001858136, 225388372, 225388380, 8, 1440x900 
0x37CA2318, 38092259002517592, 225388438, 225388445, 7, 1440x900 
0x37CA2318, 38092259003177608, 225388502, 225388510, 8, 1440x900 
0x37CA2318, 38092259003837344, 225388568, 225388577, 9, 1440x900 
0x37CA2318, 38092259004497760, 225388637, 225388645, 8, 1440x900 
0x37CA2318, 38092259005162520, 225388707, 225388715, 8, 1440x900 
0x37CA2318, 38092259005962816, 225388782, 225388789, 7, 1440x900 
0x37CA2318, 38092259006475456, 225388832, 225388841, 9, 1440x900 
0x37CA2318, 38092259007150448, 225388902, 225388910, 8, 1440x900 
0x37CA2318, 38092259007804832, 225388967, 225388975, 8, 1440x900 
0x37CA2318, 38092259008468256, 225389033, 225389042, 9, 1440x900 
0x37CA2318, 38092259009120520, 225389097, 225389106, 9, 1440x900 
0x37CA2318, 38092259009781648, 225389163, 225389171, 8, 1440x900 
0x37CA2318, 38092259010440216, 225389229, 225389237, 8, 1440x900 
0x37CA2318, 38092259011102736, 225389298, 225389305, 7, 1440x900 
0x37CA2318, 38092259011760752, 225389363, 225389370, 7, 1440x900 
0x37CA2318, 38092259012421104, 225389429, 225389436, 7, 1440x900 
0x37CA2318, 38092259013080472, 225389493, 225389501, 8, 1440x900 
0x37CA2318, 38092259013742312, 225389562, 225389569, 7, 1440x900 
0x37CA2318, 38092259014402256, 225389627, 225389635, 8, 1440x900 
0x37CA2318, 38092259015067112, 225389692, 225389700, 8, 1440x900 
0x37CA2318, 38092259015726008, 225389757, 225389765, 8, 1440x900 
0x37CA2318, 38092259016386744, 225389823, 225389831, 8, 1440x900 
0x37CA2318, 38092259017047520, 225389888, 225389896, 8, 1440x900 
0x37CA2318, 38092259017708088, 225389957, 225389965, 8, 1440x900 
0x37CA2318, 38092259018368552, 225390022, 225390029, 7, 1440x900 
0x37CA2318, 38092259019033416, 225390093, 225390101, 8, 1440x900 
0x37CA2318, 38092259019695656, 225390158, 225390166, 8, 1440x900 
0x37CA2318, 38092259020358680, 225390222, 225390230, 8, 1440x900 
0x37CA2318, 38092259021020544, 225390287, 225390295, 8, 1440x900 
0x37CA2318, 38092259021681440, 225390354, 225390362, 8, 1440x900 
0x37CA2318, 38092259022343088, 225390418, 225390426, 8, 1440x900 
0x37CA2318, 38092259023009696, 225390487, 225390495, 8, 1440x900 
0x37CA2318, 38092259023661824, 225390552, 225390560, 8, 1440x900 
0x37CA2318, 38092259024323680, 225390617, 225390625, 8, 1440x900 
0x37CA2318, 38092259024986216, 225390683, 225390692, 9, 1440x900 
0x37CA2318, 38092259025647864, 225390752, 225390760, 8, 1440x900 
0x37CA2318, 38092259026307216, 225390817, 225390824, 7, 1440x900 
0x37CA2318, 38092259026964328, 225390883, 225390890, 7, 1440x900 
0x37CA2318, 38092259027625552, 225390948, 225390956, 8, 1440x900 
0x37CA2318, 38092259028289096, 225391012, 225391020, 8, 1440x900 
0x37CA2318, 38092259028950568, 225391082, 225391089, 7, 1440x900 
0x37CA2318, 38092259029628944, 225391148, 225391158, 10, 1440x900 
0x37CA2318, 38092259030281512, 225391217, 225391225, 8, 1440x900 
0x37CA2318, 38092259030940192, 225391282, 225391290, 8, 1440x900 
0x37CA2318, 38092259031589392, 225391348, 225391355, 7, 1440x900 
0x37CA2318, 38092259032255896, 225391413, 225391421, 8, 1440x900 
0x37CA2318, 38092259032915984, 225391478, 225391487, 9, 1440x900 
0x37CA2318, 38092259033582672, 225391542, 225391550, 8, 1440x900 
0x37CA2318, 38092259034252152, 225391618, 225391626, 8, 1440x900 
0x37CA2318, 38092259034907608, 225391678, 225391685, 7, 1440x900 
0x37CA2318, 38092259035567016, 225391742, 225391750, 8, 1440x900 
0x37CA2318, 38092259036343568, 225391822, 225391830, 8, 1440x900 
0x37CA2318, 38092259036887536, 225391877, 225391885, 8, 1440x900 
0x37CA2318, 38092259037550920, 225391942, 225391949, 7, 1440x900 
0x37CA2318, 38092259038224536, 225392016, 225392026, 10, 1440x900 
0x37CA2318, 38092259038872392, 225392073, 225392081, 8, 1440x900 
0x37CA2318, 38092259039533672, 225392138, 225392147, 9, 1440x900 
0x37CA2318, 38092259040192752, 225392209, 225392216, 7, 1440x900 
0x37CA2318, 38092259040851816, 225392273, 225392281, 8, 1440x900 
0x37CA2318, 38092259041510296, 225392337, 225392345, 8, 1440x900 
0x37CA2318, 38092259042172264, 225392403, 225392410, 7, 1440x900 
0x37CA2318, 38092259042833304, 225392468, 225392476, 8, 1440x900 
0x37CA2318, 38092259043493696, 225392533, 225392541, 8, 1440x900 
0x37CA2318, 38092259044153240, 225392602, 225392609, 7, 1440x900 
0x37CA2318, 38092259044813264, 225392667, 225392675, 8, 1440x900 
0x37CA2318, 38092259045486360, 225392738, 225392746, 8, 1440x900 
0x37CA2318, 38092259046140032, 225392798, 225392808, 10, 1440x900 
0x37CA2318, 38092259046997488, 225392887, 225392895, 8, 1440x900 
0x37CA2318, 38092259047631664, 225392952, 225392960, 8, 1440x900 
0x37CA2318, 38092259048126000, 225393002, 225393010, 8, 1440x900 
0x37CA2318, 38092259048969744, 225393083, 225393091, 8, 1440x900 
0x37CA2318, 38092259049640672, 225393152, 225393160, 8, 1440x900 
0x37CA2318, 38092259050096416, 225393197, 225393206, 9, 1440x900 
0x37CA2318, 38092259050762112, 225393262, 225393269, 7, 1440x900 
0x37CA2318, 38092259051559640, 225393343, 225393350, 7, 1440x900 
0x37CA2318, 38092259052083344, 225393393, 225393401, 8, 1440x900 
0x37CA2318, 38092259052742168, 225393458, 225393466, 8, 1440x900 
0x37CA2318, 38092259053404304, 225393527, 225393534, 7, 1440x900 
0x37CA2318, 38092259054063976, 225393592, 225393599, 7, 1440x900 
0x37CA2318, 38092259054721336, 225393657, 225393665, 8, 1440x900 
0x37CA2318, 38092259055390360, 225393727, 225393734, 7, 1440x900 
0x37CA2318, 38092259056041112, 225393788, 225393796, 8, 1440x900 
0x37CA2318, 38092259056704128, 225393856, 225393863, 7, 1440x900 
0x37CA2318, 38092259057361160, 225393922, 225393929, 7, 1440x900 
0x37CA2318, 38092259058026032, 225393987, 225393996, 9, 1440x900 
0x37CA2318, 38092259058697384, 225394062, 225394070, 8, 1440x900 
0x37CA2318, 38092259059352312, 225394121, 225394129, 8, 1440x900 
0x37CA2318, 38092259060010272, 225394187, 225394195, 8, 1440x900 
0x37CA2318, 38092259060868200, 225394278, 225394286, 8, 1440x900 
0x37CA2318, 38092259061529808, 225394343, 225394351, 8, 1440x900 
0x37CA2318, 38092259061994512, 225394387, 225394396, 9, 1440x900 
0x37CA2318, 38092259062657872, 225394452, 225394461, 9, 1440x900 
0x37CA2318, 38092259063311472, 225394517, 225394525, 8, 1440x900 
0x37CA2318, 38092259063972576, 225394583, 225394591, 8, 1440x900 
0x37CA2318, 38092259064632496, 225394648, 225394657, 9, 1440x900 
0x37CA2318, 38092259065298144, 225394717, 225394725, 8, 1440x900 
0x37CA2318, 38092259066819528, 225394872, 225394881, 9, 1440x900 
0x37CA2318, 38092259067490296, 225394942, 225394950, 8, 1440x900 
0x37CA2318, 38092259068140488, 225395003, 225395011, 8, 1440x900 
0x37CA2318, 38092259068748160, 225395062, 225395071, 9, 1440x900 
0x37CA2318, 38092259069273392, 225395118, 225395132, 14, 1440x900 
0x37CA2318, 38092259069948752, 225395182, 225395195, 13, 1440x900 
0x37CA2318, 38092259070611912, 225395247, 225395257, 10, 1440x900 
0x37CA2318, 38092259071273392, 225395313, 225395321, 8, 1440x900 
0x37CA2318, 38092259071927848, 225395377, 225395386, 9, 1440x900 
0x37CA2318, 38092259072770944, 225395463, 225395470, 7, 1440x900 
0x37CA2318, 38092259073433792, 225395532, 225395542, 10, 1440x900 
0x37CA2318, 38092259074102784, 225395597, 225395604, 7, 1440x900 
0x37CA2318, 38092259074755456, 225395663, 225395672, 9, 1440x900 
0x37CA2318, 38092259075415392, 225395733, 225395741, 8, 1440x900 
0x37CA2318, 38092259076085080, 225395797, 225395806, 9, 1440x900 
0x37CA2318, 38092259076736400, 225395863, 225395871, 8, 1440x900 
0x37CA2318, 38092259077404936, 225395929, 225395937, 8, 1440x900 
0x37CA2318, 38092259078064680, 225395998, 225396006, 8, 1440x900 
0x37CA2318, 38092259078542032, 225396050, 225396059, 9, 1440x900 
0x37CA2318, 38092259079206320, 225396107, 225396115, 8, 1440x900 
0x37CA2318, 38092259079867984, 225396172, 225396187, 15, 1440x900 
0x37CA2318, 38092259080522688, 225396238, 225396251, 13, 1440x900 
0x37CA2318, 38092259081184864, 225396304, 225396317, 13, 1440x900 
0x37CA2318, 38092259081843792, 225396372, 225396383, 11, 1440x900 
0x37CA2318, 38092259082511672, 225396439, 225396450, 11, 1440x900 
0x37CA2318, 38092259083171872, 225396502, 225396515, 13, 1440x900 
0x37CA2318, 38092259083832912, 225396567, 225396577, 10, 1440x900 
0x37CA2318, 38092259084492744, 225396633, 225396643, 10, 1440x900 
0x37CA2318, 38092259085152560, 225396702, 225396715, 13, 1440x900 
0x37CA2318, 38092259085817280, 225396767, 225396780, 13, 1440x900 
0x37CA2318, 38092259086486800, 225396833, 225396845, 12, 1440x900 
0x37CA2318, 38092259087146992, 225396902, 225396914, 12, 1440x900 
0x37CA2318, 38092259087806872, 225396967, 225396980, 13, 1440x900 
0x37CA2318, 38092259088470616, 225397033, 225397046, 13, 1440x900 
0x37CA2318, 38092259089138576, 225397101, 225397114, 13, 1440x900 
0x37CA2318, 38092259089798968, 225397167, 225397180, 13, 1440x900 
0x37CA2318, 38092259090463928, 225397232, 225397241, 9, 1440x900 
0x37CA2318, 38092259091129808, 225397298, 225397305, 7, 1440x900 
0x37CA2318, 38092259091811408, 225397368, 225397381, 13, 1440x900 
0x37CA2318, 38092259092453088, 225397432, 225397441, 9, 1440x900 
0x37CA2318, 38092259093143224, 225397502, 225397517, 15, 1440x900 
0x37CA2318, 38092259093771920, 225397563, 225397571, 8, 1440x900 
0x37CA2318, 38092259094486896, 225397637, 225397644, 7, 1440x900 
0x37CA2318, 38092259095079384, 225397693, 225397700, 7, 1440x900 
0x37CA2318, 38092259095734536, 225397758, 225397766, 8, 1440x900 
0x37CA2318, 38092259096394608, 225397826, 225397833, 7, 1440x900 
0x37CA2318, 38092259097058536, 225397891, 225397898, 7, 1440x900 
0x37CA2318, 38092259097722688, 225397958, 225397966, 8, 1440x900 
0x37CA2318, 38092259098385160, 225398028, 225398035, 7, 1440x900 
0x37CA2318, 38092259099039728, 225398088, 225398096, 8, 1440x900 
0x37CA2318, 38092259099708592, 225398162, 225398170, 8, 1440x900 
0x37CA2318, 38092259100364320, 225398222, 225398230, 8, 1440x900 
0x37CA2318, 38092259101021712, 225398287, 225398296, 9, 1440x900 
0x37CA2318, 38092259101680960, 225398353, 225398361, 8, 1440x900 
0x37CA2318, 38092259102340768, 225398418, 225398426, 8, 1440x900 
0x37CA2318, 38092259103012448, 225398488, 225398496, 8, 1440x900 
0x37CA2318, 38092259103664128, 225398552, 225398560, 8, 1440x900 
0x37CA2318, 38092259104324816, 225398617, 225398625, 8, 1440x900 
0x37CA2318, 38092259104991872, 225398687, 225398695, 8, 1440x900 
0x37CA2318, 38092259105647752, 225398751, 225398759, 8, 1440x900 
0x37CA2318, 38092259106338624, 225398823, 225398830, 7, 1440x900 
0x37CA2318, 38092259106973384, 225398882, 225398890, 8, 1440x900 
0x37CA2318, 38092259107814224, 225398973, 225398981, 8, 1440x900 
0x37CA2318, 38092259108483432, 225399038, 225399046, 8, 1440x900 
0x37CA2318, 38092259108946128, 225399084, 225399093, 9, 1440x900 
0x37CA2318, 38092259109609792, 225399147, 225399155, 8, 1440x900 
0x37CA2318, 38092259110280304, 225399216, 225399224, 8, 1440x900 
0x37CA2318, 38092259110940048, 225399282, 225399290, 8, 1440x900 
0x37CA2318, 38092259111602408, 225399347, 225399354, 7, 1440x900 
0x37CA2318, 38092259112260472, 225399412, 225399420, 8, 1440x900 
0x37CA2318, 38092259112923056, 225399477, 225399486, 9, 1440x900 
0x37CA2318, 38092259113588480, 225399547, 225399555, 8, 1440x900 
0x37CA2318, 38092259114266688, 225399616, 225399623, 7, 1440x900 
0x37CA2318, 38092259114901848, 225399678, 225399686, 8, 1440x900 
0x37CA2318, 38092259115558064, 225399742, 225399751, 9, 1440x900 
0x37CA2318, 38092259116227688, 225399813, 225399822, 9, 1440x900 
0x37CA2318, 38092259116877992, 225399877, 225399884, 7, 1440x900 
0x37CA2318, 38092259117540472, 225399943, 225399952, 9, 1440x900 
0x37CA2318, 38092259118200320, 225400007, 225400016, 9, 1440x900 
0x37CA2318, 38092259118860560, 225400077, 225400085, 8, 1440x900 
0x37CA2318, 38092259119717008, 225400163, 225400171, 8, 1440x900 
0x37CA2318, 38092259120186336, 225400208, 225400216, 8, 1440x900 
0x37CA2318, 38092259120863280, 225400273, 225400288, 15, 1440x900 
0x37CA2318, 38092259121515936, 225400338, 225400347, 9, 1440x900 
0x37CA2318, 38092259122176168, 225400402, 225400412, 10, 1440x900 
0x37CA2318, 38092259122841040, 225400468, 225400478, 10, 1440x900 
0x37CA2318, 38092259123496360, 225400536, 225400545, 9, 1440x900 
0x37CA2318, 38092259124160872, 225400602, 225400611, 9, 1440x900 
0x37CA2318, 38092259124826848, 225400668, 225400678, 10, 1440x900 
0x37CA2318, 38092259126168160, 225400803, 225400812, 9, 1440x900 
0x37CA2318, 38092259126828400, 225400868, 225400878, 10, 1440x900 
0x37CA2318, 38092259127463208, 225400932, 225400939, 7, 1440x900 
0x37CA2318, 38092259128311456, 225401017, 225401025, 8, 1440x900 
0x37CA2318, 38092259128962592, 225401082, 225401089, 7, 1440x900 
0x37CA2318, 38092259129642176, 225401148, 225401156, 8, 1440x900 
0x37CA2318, 38092259130294704, 225401217, 225401224, 7, 1440x900 
0x37CA2318, 38092259130956192, 225401288, 225401298, 10, 1440x900 
0x37CA2318, 38092259131429688, 225401334, 225401342, 8, 1440x900 
0x37CA2318, 38092259132088064, 225401394, 225401409, 15, 1440x900 
0x37CA2318, 38092259132784544, 225401464, 225401473, 9, 1440x900 
0x37CA2318, 38092259133421704, 225401528, 225401544, 16, 1440x900 
0x37CA2318, 38092259134080048, 225401593, 225401606, 13, 1440x900 
0x37CA2318, 38092259134884912, 225401677, 225401715, 38, 1440x900 
0x37CA2318, 38092259135416152, 225401727, 225401736, 9, 1440x900 
0x37CA2318, 38092259136148464, 225401805, 225401826, 21, 1440x900 
0x37CA2318, 38092259136866496, 225401878, 225401908, 30, 1440x900 
0x37CA2318, 38092259137531024, 225401945, 225401955, 10, 1440x900 
0x37CA2318, 38092259138161992, 225402004, 225402022, 18, 1440x900 
0x37CA2318, 38092259138809232, 225402075, 225402087, 12, 1440x900 
0x37CA2318, 38092259139477952, 225402140, 225402156, 16, 1440x900 
0x37CA2318, 38092259140135000, 225402204, 225402222, 18, 1440x900 
0x37CA2318, 38092259140809888, 225402270, 225402285, 15, 1440x900 
0x37CA2318, 38092259141473952, 225402332, 225402339, 7, 1440x900 
0x37CA2318, 38092259142303376, 225402417, 225402423, 6, 1440x900 
0x37CA2318, 38092259142848360, 225402472, 225402478, 6, 1440x900 
0x37CA2318, 38092259143511328, 225402537, 225402544, 7, 1440x900 
0x37CA2318, 38092259144015440, 225402598, 225402605, 7, 1440x900 
0x37CA2318, 38092259144652488, 225402652, 225402658, 6, 1440x900 
0x37CA2318, 38092259145290152, 225402716, 225402722, 6, 1440x900 
0x37CA2318, 38092259145963552, 225402783, 225402789, 6, 1440x900 
0x37CA2318, 38092259146616672, 225402847, 225402854, 7, 1440x900 
0x37CA2318, 38092259147273328, 225402913, 225402919, 6, 1440x900 
0x37CA2318, 38092259147933592, 225402978, 225402985, 7, 1440x900 
0x37CA2318, 38092259148593352, 225403043, 225403050, 7, 1440x900 
0x37CA2318, 38092259149260608, 225403112, 225403118, 6, 1440x900 
0x37CA2318, 38092259149922328, 225403178, 225403184, 6, 1440x900 
0x37CA2318, 38092259150585560, 225403243, 225403250, 7, 1440x900 
0x37CA2318, 38092259151240872, 225403311, 225403318, 7, 1440x900 
0x37CA2318, 38092259151900640, 225403373, 225403381, 8, 1440x900 
0x37CA2318, 38092259152565960, 225403442, 225403449, 7, 1440x900 
0x37CA2318, 38092259153227560, 225403507, 225403515, 8, 1440x900 
0x37CA2318, 38092259153887120, 225403573, 225403580, 7, 1440x900 
0x37CA2318, 38092259154542992, 225403638, 225403646, 8, 1440x900 
0x37CA2318, 38092259155203456, 225403707, 225403714, 7, 1440x900 
0x37CA2318, 38092259155864960, 225403772, 225403780, 8, 1440x900 
0x37CA2318, 38092259157210992, 225403907, 225403917, 10, 1440x900 
0x37CA2318, 38092259157420008, 225403928, 225403938, 10, 1440x900 
0x37CA2318, 38092259157996608, 225403987, 225403993, 6, 1440x900 
0x37CA2318, 38092259158745712, 225404062, 225404069, 7, 1440x900 
0x37CA2318, 38092259159382976, 225404123, 225404131, 8, 1440x900 
0x37CA2318, 38092259160004768, 225404192, 225404200, 8, 1440x900 
0x37CA2318, 38092259161203520, 225404307, 225404314, 7, 1440x900 
0x37CA2318, 38092259161864048, 225404373, 225404382, 9, 1440x900 
0x37CA2318, 38092259162714248, 225404464, 225404472, 8, 1440x900 
0x37CA2318, 38092259163184720, 225404508, 225404516, 8, 1440x900 
0x37CA2318, 38092259163843184, 225404573, 225404586, 13, 1440x900 
0x37CA2318, 38092259164510152, 225404638, 225404645, 7, 1440x900 
0x37CA2318, 38092259165349296, 225404722, 225404730, 8, 1440x900 
0x37CA2318, 38092259166015264, 225404788, 225404796, 8, 1440x900 
0x37CA2318, 38092259166477864, 225404834, 225404840, 6, 1440x900 
0x37CA2318, 38092259167334416, 225404921, 225404928, 7, 1440x900 
0x37CA2318, 38092259167988608, 225404987, 225404995, 8, 1440x900 
0x37CA2318, 38092259168659944, 225405053, 225405060, 7, 1440x900 
0x37CA2318, 38092259169321064, 225405118, 225405126, 8, 1440x900 
0x37CA2318, 38092259169982056, 225405187, 225405195, 8, 1440x900 
0x37CA2318, 38092259170652144, 225405252, 225405261, 9, 1440x900 
0x37CA2318, 38092259171116272, 225405304, 225405312, 8, 1440x900 
0x37CA2318, 38092259171972496, 225405382, 225405389, 7, 1440x900 
0x37CA2318, 38092259172622856, 225405448, 225405455, 7, 1440x900 
0x37CA2318, 38092259173291992, 225405516, 225405524, 8, 1440x900 
0x37CA2318, 38092259173755608, 225405563, 225405571, 8, 1440x900 
0x37CA2318, 38092259174604672, 225405652, 225405660, 8, 1440x900 
0x37CA2318, 38092259175071720, 225405699, 225405707, 8, 1440x900 
0x37CA2318, 38092259175741912, 225405759, 225405767, 8, 1440x900 
0x37CA2318, 38092259176401952, 225405828, 225405836, 8, 1440x900 
0x37CA2318, 38092259177062824, 225405892, 225405900, 8, 1440x900 
0x37CA2318, 38092259177729848, 225405961, 225405969, 8, 1440x900 
0x37CA2318, 38092259178386512, 225406026, 225406033, 7, 1440x900 
0x37CA2318, 38092259179248264, 225406113, 225406122, 9, 1440x900 
0x37CA2318, 38092259179892616, 225406177, 225406185, 8, 1440x900 
0x37CA2318, 38092259180369304, 225406228, 225406236, 8, 1440x900 
0x37CA2318, 38092259181037272, 225406292, 225406300, 8, 1440x900 
0x37CA2318, 38092259181689496, 225406357, 225406366, 9, 1440x900 
0x37CA2318, 38092259182350008, 225406428, 225406436, 8, 1440x900 
0x37CA2318, 38092259183010440, 225406492, 225406500, 8, 1440x900 
0x37CA2318, 38092259183676368, 225406557, 225406565, 8, 1440x900 
0x37CA2318, 38092259184530960, 225406638, 225406646, 8, 1440x900 
0x37CA2318, 38092259185014440, 225406687, 225406694, 7, 1440x900 
0x37CA2318, 38092259185839192, 225406771, 225406778, 7, 1440x900 
0x37CA2318, 38092259186511944, 225406837, 225406844, 7, 1440x900 
0x37CA2318, 38092259186972496, 225406883, 225406891, 8, 1440x900 
0x37CA2318, 38092259187632160, 225406948, 225406956, 8, 1440x900 
0x37CA2318, 38092259188292352, 225407013, 225407021, 8, 1440x900 
0x37CA2318, 38092259188952328, 225407082, 225407089, 7, 1440x900 
0x37CA2318, 38092259189613984, 225407148, 225407155, 7, 1440x900 
0x37CA2318, 38092259190476248, 225407236, 225407243, 7, 1440x900 
0x37CA2318, 38092259190936568, 225407283, 225407291, 8, 1440x900 
0x37CA2318, 38092259191597128, 225407352, 225407360, 8, 1440x900 
0x37CA2318, 38092259192257584, 225407416, 225407424, 8, 1440x900 
0x37CA2318, 38092259192921984, 225407483, 225407500, 17, 1440x900 
0x37CA2318, 38092259193612624, 225407547, 225407555, 8, 1440x900 
0x37CA2318, 38092259194423040, 225407628, 225407637, 9, 1440x900 
0x37CA2318, 38092259194932280, 225407678, 225407686, 8, 1440x900 
0x37CA2318, 38092259195559824, 225407742, 225407751, 9, 1440x900 
0x37CA2318, 38092259196419048, 225407827, 225407835, 8, 1440x900 
0x37CA2318, 38092259197079520, 225407893, 225407902, 9, 1440x900 
0x37CA2318, 38092259197547640, 225407947, 225407956, 9, 1440x900 
0x37CA2318, 38092259198215912, 225408012, 225408027, 15, 1440x900 
0x37CA2318, 38092259198875416, 225408077, 225408084, 7, 1440x900 
0x37CA2318, 38092259199541024, 225408138, 225408145, 7, 1440x900 
0x37CA2318, 38092259200200296, 225408207, 225408214, 7, 1440x900 
0x37CA2318, 38092259200862904, 225408272, 225408279, 7, 1440x900 
0x37CA2318, 38092259201526080, 225408338, 225408346, 8, 1440x900 
0x37CA2318, 38092259202186328, 225408406, 225408413, 7, 1440x900 
0x37CA2318, 38092259202862360, 225408473, 225408480, 7, 1440x900 
0x37CA2318, 38092259203519904, 225408538, 225408545, 7, 1440x900 
0x37CA2318, 38092259204182744, 225408603, 225408611, 8, 1440x900 
0x37CA2318, 38092259204908976, 225408683, 225408690, 7, 1440x900 
0x37CA2318, 38092259205538352, 225408738, 225408748, 10, 1440x900 
0x37CA2318, 38092259206383432, 225408829, 225408839, 10, 1440x900 
0x37CA2318, 38092259206839008, 225408868, 225408877, 9, 1440x900 
0x37CA2318, 38092259207756904, 225408962, 225408976, 14, 1440x900 
0x37CA2318, 38092259208404784, 225409027, 225409033, 6, 1440x900 
0x37CA2318, 38092259209061704, 225409091, 225409098, 7, 1440x900 
0x37CA2318, 38092259209722152, 225409157, 225409164, 7, 1440x900 
0x37CA2318, 38092259210383096, 225409223, 225409230, 7, 1440x900 
0x37CA2318, 38092259211041480, 225409288, 225409295, 7, 1440x900 
0x37CA2318, 38092259211702800, 225409357, 225409364, 7, 1440x900 
0x37CA2318, 38092259212365456, 225409422, 225409429, 7, 1440x900 
0x37CA2318, 38092259213025776, 225409488, 225409495, 7, 1440x900 
0x37CA2318, 38092259213692040, 225409557, 225409564, 7, 1440x900 
0x37CA2318, 38092259214622984, 225409650, 225409658, 8, 1440x900 
0x37CA2318, 38092259215051304, 225409698, 225409711, 13, 1440x900 
0x37CA2318, 38092259215924808, 225409785, 225409793, 8, 1440x900 
0x37CA2318, 38092259216448936, 225409834, 225409852, 18, 1440x900 
0x37CA2318, 38092259217028368, 225409887, 225409894, 7, 1440x900 
0x37CA2318, 38092259217655952, 225409953, 225409960, 7, 1440x900 
0x37CA2318, 38092259218317312, 225410019, 225410027, 8, 1440x900 
0x37CA2318, 38092259218980656, 225410083, 225410091, 8, 1440x900 
0x37CA2318, 38092259219643056, 225410152, 225410159, 7, 1440x900 
0x37CA2318, 38092259220305520, 225410218, 225410225, 7, 1440x900 
0x37CA2318, 38092259220962056, 225410282, 225410289, 7, 1440x900 
0x37CA2318, 38092259221628392, 225410352, 225410359, 7, 1440x900 
0x37CA2318, 38092259222280728, 225410413, 225410420, 7, 1440x900 
0x37CA2318, 38092259222944408, 225410481, 225410489, 8, 1440x900 
0x37CA2318, 38092259223602504, 225410546, 225410553, 7, 1440x900 
0x37CA2318, 38092259224271432, 225410618, 225410626, 8, 1440x900 
0x37CA2318, 38092259224922704, 225410678, 225410685, 7, 1440x900 
0x37CA2318, 38092259225680048, 225410754, 225410762, 8, 1440x900 
0x37CA2318, 38092259226241424, 225410808, 225410816, 8, 1440x900 
0x37CA2318, 38092259226912600, 225410877, 225410884, 7, 1440x900 
0x37CA2318, 38092259227568832, 225410943, 225410949, 6, 1440x900 
0x37CA2318, 38092259228402432, 225411026, 225411033, 7, 1440x900 
0x37CA2318, 38092259228896640, 225411077, 225411084, 7, 1440x900 
0x37CA2318, 38092259229558448, 225411143, 225411149, 6, 1440x900 
0x37CA2318, 38092259230210640, 225411207, 225411214, 7, 1440x900 
0x37CA2318, 38092259230871696, 225411272, 225411280, 8, 1440x900 
0x37CA2318, 38092259231529760, 225411338, 225411345, 7, 1440x900 
0x37CA2318, 38092259232225664, 225411408, 225411416, 8, 1440x900 
0x37CA2318, 38092259232850752, 225411471, 225411478, 7, 1440x900 
0x37CA2318, 38092259233514336, 225411537, 225411545, 8, 1440x900 
0x37CA2318, 38092259234174512, 225411603, 225411611, 8, 1440x900 
0x37CA2318, 38092259234835064, 225411668, 225411676, 8, 1440x900 
0x37CA2318, 38092259235493784, 225411733, 225411741, 8, 1440x900 
0x37CA2318, 38092259236355360, 225411822, 225411831, 9, 1440x900 
0x37CA2318, 38092259237008208, 225411887, 225411895, 8, 1440x900 
0x37CA2318, 38092259237473376, 225411933, 225411942, 9, 1440x900 
0x37CA2318, 38092259238267032, 225412018, 225412026, 8, 1440x900 
0x37CA2318, 38092259238794384, 225412067, 225412075, 8, 1440x900 
0x37CA2318, 38092259239455696, 225412137, 225412145, 8, 1440x900 
0x37CA2318, 38092259240115760, 225412203, 225412212, 9, 1440x900 
0x37CA2318, 38092259240773800, 225412263, 225412271, 8, 1440x900 
0x37CA2318, 38092259241438288, 225412332, 225412340, 8, 1440x900 
0x37CA2318, 38092259242094672, 225412397, 225412405, 8, 1440x900 
0x37CA2318, 38092259242754464, 225412462, 225412470, 8, 1440x900 
0x37CA2318, 38092259243422040, 225412529, 225412537, 8, 1440x900 
0x37CA2318, 38092259244082144, 225412596, 225412604, 8, 1440x900 
0x37CA2318, 38092259244743488, 225412661, 225412669, 8, 1440x900 
0x37CA2318, 38092259245402000, 225412727, 225412734, 7, 1440x900 
0x37CA2318, 38092259246062968, 225412792, 225412800, 8, 1440x900 
0x37CA2318, 38092259246723488, 225412861, 225412869, 8, 1440x900 
0x37CA2318, 38092259247382176, 225412927, 225412935, 8, 1440x900 
0x37CA2318, 38092259248707776, 225413062, 225413070, 8, 1440x900 
0x37CA2318, 38092259249573840, 225413147, 225413154, 7, 1440x900 
0x37CA2318, 38092259250232264, 225413212, 225413220, 8, 1440x900 
0x37CA2318, 38092259250885016, 225413278, 225413286, 8, 1440x900 
0x37CA2318, 38092259251545536, 225413343, 225413352, 9, 1440x900 
0x37CA2318, 38092259252204288, 225413408, 225413415, 7, 1440x900 
0x37CA2318, 38092259252864976, 225413473, 225413481, 8, 1440x900 
0x37CA2318, 38092259253520416, 225413538, 225413545, 7, 1440x900 
0x37CA2318, 38092259254182576, 225413603, 225413611, 8, 1440x900 
0x37CA2318, 38092259254848480, 225413673, 225413680, 7, 1440x900 
0x37CA2318, 38092259255500880, 225413737, 225413745, 8, 1440x900 
0x37CA2318, 38092259256173928, 225413808, 225413816, 8, 1440x900 
0x37CA2318, 38092259256834024, 225413872, 225413880, 8, 1440x900 
0x37CA2318, 38092259257503736, 225413938, 225413945, 7, 1440x900 
0x37CA2318, 38092259258155008, 225414002, 225414009, 7, 1440x900 
0x37CA2318, 38092259258809048, 225414067, 225414075, 8, 1440x900 
0x37CA2318, 38092259259484344, 225414135, 225414142, 7, 1440x900 
0x37CA2318, 38092259260146392, 225414202, 225414209, 7, 1440x900 
0x37CA2318, 38092259260807904, 225414267, 225414275, 8, 1440x900 
0x37CA2318, 38092259261458208, 225414332, 225414340, 8, 1440x900 
0x37CA2318, 38092259262121848, 225414398, 225414406, 8, 1440x900 
0x37CA2318, 38092259262778856, 225414463, 225414471, 8, 1440x900 
0x37CA2318, 38092259263441768, 225414532, 225414540, 8, 1440x900 
0x37CA2318, 38092259264100928, 225414597, 225414605, 8, 1440x900 
0x37CA2318, 38092259264754456, 225414664, 225414671, 7, 1440x900 
0x37CA2318, 38092259265418584, 225414728, 225414736, 8, 1440x900 
0x37CA2318, 38092259266081120, 225414793, 225414801, 8, 1440x900 
0x37CA2318, 38092259266742328, 225414862, 225414870, 8, 1440x900 
0x37CA2318, 38092259267407632, 225414928, 225414935, 7, 1440x900 
0x37CA2318, 38092259268074048, 225414994, 225415002, 8, 1440x900 
0x37CA2318, 38092259268725464, 225415062, 225415069, 7, 1440x900 
0x37CA2318, 38092259269385896, 225415123, 225415131, 8, 1440x900 
0x37CA2318, 38092259270057696, 225415197, 225415205, 8, 1440x900 
0x37CA2318, 38092259270719024, 225415263, 225415271, 8, 1440x900 
0x37CA2318, 38092259271377480, 225415327, 225415336, 9, 1440x900 
0x37CA2318, 38092259272038384, 225415392, 225415401, 9, 1440x900 
0x37CA2318, 38092259272698408, 225415459, 225415468, 9, 1440x900 
0x37CA2318, 38092259273358368, 225415527, 225415535, 8, 1440x900 
0x37CA2318, 38092259274028400, 225415592, 225415600, 8, 1440x900 
0x37CA2318, 38092259274679504, 225415658, 225415665, 7, 1440x900 
0x37CA2318, 38092259275340464, 225415723, 225415731, 8, 1440x900 
0x37CA2318, 38092259275992064, 225415787, 225415795, 8, 1440x900 
0x37CA2318, 38092259276662448, 225415857, 225415865, 8, 1440x900 
0x37CA2318, 38092259277323064, 225415922, 225415930, 8, 1440x900 
0x37CA2318, 38092259277983112, 225415988, 225415996, 8, 1440x900 
0x37CA2318, 38092259278654096, 225416058, 225416066, 8, 1440x900 
0x37CA2318, 38092259279313856, 225416118, 225416127, 9, 1440x900 
0x37CA2318, 38092259279973392, 225416187, 225416196, 9, 1440x900 
0x37CA2318, 38092259280626488, 225416253, 225416261, 8, 1440x900 
0x37CA2318, 38092259281281872, 225416317, 225416325, 8, 1440x900 
0x37CA2318, 38092259281951744, 225416382, 225416390, 8, 1440x900 
0x37CA2318, 38092259282616744, 225416452, 225416460, 8, 1440x900 
0x37CA2318, 38092259283274384, 225416513, 225416522, 9, 1440x900 
0x37CA2318, 38092259283931168, 225416583, 225416591, 8, 1440x900 
0x37CA2318, 38092259284610136, 225416648, 225416655, 7, 1440x900 
0x37CA2318, 38092259285130896, 225416698, 225416706, 8, 1440x900 
0x37CA2318, 38092259285939024, 225416782, 225416790, 8, 1440x900 
0x37CA2318, 38092259286608576, 225416847, 225416854, 7, 1440x900 
0x37CA2318, 38092259287258456, 225416911, 225416918, 7, 1440x900 
0x37CA2318, 38092259287919288, 225416978, 225416985, 7, 1440x900 
0x37CA2318, 38092259288580576, 225417043, 225417051, 8, 1440x900 
0x37CA2318, 38092259289444552, 225417132, 225417140, 8, 1440x900 
0x37CA2318, 38092259290104400, 225417203, 225417211, 8, 1440x900 
0x37CA2318, 38092259290767328, 225417267, 225417275, 8, 1440x900 
0x37CA2318, 38092259291426136, 225417333, 225417341, 8, 1440x900 
0x37CA2318, 38092259292088112, 225417398, 225417406, 8, 1440x900 
0x37CA2318, 38092259292747560, 225417463, 225417472, 9, 1440x900 
0x37CA2318, 38092259293408160, 225417532, 225417540, 8, 1440x900 
0x37CA2318, 38092259294077880, 225417598, 225417606, 8, 1440x900 
0x37CA2318, 38092259294726736, 225417659, 225417667, 8, 1440x900 
0x37CA2318, 38092259295398112, 225417732, 225417740, 8, 1440x900 
0x37CA2318, 38092259296387448, 225417827, 225417835, 8, 1440x900 
0x37CA2318, 38092259296946576, 225417882, 225417889, 7, 1440x900 
0x37CA2318, 38092259297614512, 225417948, 225417956, 8, 1440x900 
0x37CA2318, 38092259298284632, 225418018, 225418026, 8, 1440x900 
0x37CA2318, 38092259298740640, 225418058, 225418066, 8, 1440x900 
0x37CA2318, 38092259299597432, 225418147, 225418154, 7, 1440x900 
0x37CA2318, 38092259300264320, 225418213, 225418220, 7, 1440x900 
0x37CA2318, 38092259300916776, 225418278, 225418285, 7, 1440x900 
0x37CA2318, 38092259301571616, 225418342, 225418350, 8, 1440x900 
0x37CA2318, 38092259302235000, 225418409, 225418417, 8, 1440x900 
0x37CA2318, 38092259303051632, 225418498, 225418514, 16, 1440x900 
0x37CA2318, 38092259303563504, 225418543, 225418550, 7, 1440x900 
0x37CA2318, 38092259304214720, 225418608, 225418616, 8, 1440x900 
0x37CA2318, 38092259304875728, 225418673, 225418681, 8, 1440x900 
0x37CA2318, 38092259305526208, 225418738, 225418745, 7, 1440x900 
0x37CA2318, 38092259306188096, 225418803, 225418811, 8, 1440x900 
0x37CA2318, 38092259306868592, 225418878, 225418886, 8, 1440x900 
0x37CA2318, 38092259307527696, 225418941, 225418949, 8, 1440x900 
0x37CA2318, 38092259308185536, 225419008, 225419016, 8, 1440x900 
0x37CA2318, 38092259308838312, 225419073, 225419081, 8, 1440x900 
0x37CA2318, 38092259309508256, 225419142, 225419150, 8, 1440x900 
0x37CA2318, 38092259310168968, 225419203, 225419213, 10, 1440x900 
0x37CA2318, 38092259310824288, 225419273, 225419281, 8, 1440x900 
0x37CA2318, 38092259311485952, 225419338, 225419346, 8, 1440x900 
0x37CA2318, 38092259312155160, 225419403, 225419412, 9, 1440x900 
0x37CA2318, 38092259312815184, 225419472, 225419480, 8, 1440x900 
0x37CA2318, 38092259313475680, 225419537, 225419545, 8, 1440x900 
0x37CA2318, 38092259314134928, 225419603, 225419611, 8, 1440x900 
0x37CA2318, 38092259314796120, 225419667, 225419676, 9, 1440x900 
0x37CA2318, 38092259315447456, 225419737, 225419745, 8, 1440x900 
0x37CA2318, 38092259316108416, 225419802, 225419810, 8, 1440x900 
0x37CA2318, 38092259316768304, 225419864, 225419872, 8, 1440x900 
0x37CA2318, 38092259317428656, 225419931, 225419939, 8, 1440x900 
0x37CA2318, 38092259318098408, 225419997, 225420005, 8, 1440x900 
0x37CA2318, 38092259318743080, 225420062, 225420070, 8, 1440x900 
0x37CA2318, 38092259319405912, 225420127, 225420135, 8, 1440x900 
0x37CA2318, 38092259320084632, 225420199, 225420207, 8, 1440x900 
0x37CA2318, 38092259320740080, 225420263, 225420271, 8, 1440x900 
0x37CA2318, 38092259321391736, 225420327, 225420336, 9, 1440x900 
0x37CA2318, 38092259322060480, 225420397, 225420405, 8, 1440x900 
0x37CA2318, 38092259322721264, 225420463, 225420471, 8, 1440x900 
0x37CA2318, 38092259323376728, 225420528, 225420537, 9, 1440x900 
0x37CA2318, 38092259324038192, 225420593, 225420601, 8, 1440x900 
0x37CA2318, 38092259324698616, 225420657, 225420665, 8, 1440x900 
0x37CA2318, 38092259325362920, 225420723, 225420732, 9, 1440x900 
0x37CA2318, 38092259326023992, 225420792, 225420800, 8, 1440x900 
0x37CA2318, 38092259326683216, 225420857, 225420866, 9, 1440x900 
0x37CA2318, 38092259327352736, 225420928, 225420936, 8, 1440x900 
0x37CA2318, 38092259328001624, 225420987, 225420995, 8, 1440x900 
0x37CA2318, 38092259328663752, 225421053, 225421060, 7, 1440x900 
0x37CA2318, 38092259329333032, 225421118, 225421126, 8, 1440x900 
0x37CA2318, 38092259329983808, 225421184, 225421193, 9, 1440x900 
0x37CA2318, 38092259330645208, 225421253, 225421261, 8, 1440x900 
0x37CA2318, 38092259331305976, 225421323, 225421331, 8, 1440x900 
0x37CA2318, 38092259331969848, 225421387, 225421395, 8, 1440x900 
0x37CA2318, 38092259332621632, 225421453, 225421461, 8, 1440x900 
0x37CA2318, 38092259333292032, 225421517, 225421525, 8, 1440x900 
0x37CA2318, 38092259333954128, 225421582, 225421591, 9, 1440x900 
0x37CA2318, 38092259334606944, 225421652, 225421660, 8, 1440x900 
0x37CA2318, 38092259335276984, 225421713, 225421721, 8, 1440x900 
0x37CA2318, 38092259335942576, 225421782, 225421790, 8, 1440x900 
0x37CA2318, 38092259336544160, 225421851, 225421872, 21, 1440x900 
0x37CA2318, 38092259337105192, 225421900, 225421923, 23, 1440x900 
0x37CA2318, 38092259337925280, 225421995, 225422051, 56, 1440x900 
0x37CA2318, 38092259338534472, 225422054, 225422065, 11, 1440x900 
0x37CA2318, 38092259339137160, 225422098, 225422116, 18, 1440x900 
0x37CA2318, 38092259339727384, 225422158, 225422165, 7, 1440x900 
0x37CA2318, 38092259341028312, 225422288, 225422295, 7, 1440x900 
0x37CA2318, 38092259341689728, 225422357, 225422364, 7, 1440x900 
0x37CA2318, 38092259342365992, 225422422, 225422430, 8, 1440x900 
0x37CA2318, 38092259343019520, 225422487, 225422494, 7, 1440x900 
0x37CA2318, 38092259343690976, 225422557, 225422564, 7, 1440x900 
0x37CA2318, 38092259344346096, 225422622, 225422629, 7, 1440x900 
0x37CA2318, 38092259344999824, 225422687, 225422693, 6, 1440x900 
0x37CA2318, 38092259345867904, 225422773, 225422780, 7, 1440x900 
0x37CA2318, 38092259346321856, 225422818, 225422826, 8, 1440x900 
0x37CA2318, 38092259346983160, 225422883, 225422891, 8, 1440x900 
0x37CA2318, 38092259347640368, 225422952, 225422959, 7, 1440x900 
0x37CA2318, 38092259348301792, 225423017, 225423024, 7, 1440x900 
0x37CA2318, 38092259348970480, 225423084, 225423092, 8, 1440x900 
0x37CA2318, 38092259349626232, 225423154, 225423161, 7, 1440x900 
0x37CA2318, 38092259350286392, 225423213, 225423221, 8, 1440x900 
0x37CA2318, 38092259350949712, 225423282, 225423290, 8, 1440x900 
0x37CA2318, 38092259351626240, 225423347, 225423355, 8, 1440x900 
0x37CA2318, 38092259352279264, 225423413, 225423421, 8, 1440x900 
0x37CA2318, 38092259352939296, 225423478, 225423487, 9, 1440x900 
0x37CA2318, 38092259353605696, 225423547, 225423554, 7, 1440x900 
0x37CA2318, 38092259354264000, 225423613, 225423622, 9, 1440x900 
0x37CA2318, 38092259355037728, 225423708, 225423720, 12, 1440x900 
0x37CA2318, 38092259355643272, 225423752, 225423759, 7, 1440x900 
0x37CA2318, 38092259356304400, 225423817, 225423824, 7, 1440x900 
0x37CA2318, 38092259356959520, 225423882, 225423889, 7, 1440x900 
0x37CA2318, 38092259357810032, 225423967, 225423975, 8, 1440x900 
0x37CA2318, 38092259358473824, 225424032, 225424040, 8, 1440x900 
0x37CA2318, 38092259359137992, 225424101, 225424109, 8, 1440x900 
0x37CA2318, 38092259359601104, 225424147, 225424154, 7, 1440x900 
0x37CA2318, 38092259360263240, 225424212, 225424220, 8, 1440x900 
0x37CA2318, 38092259360921184, 225424278, 225424286, 8, 1440x900 
0x37CA2318, 38092259361580576, 225424343, 225424351, 8, 1440x900 
0x37CA2318, 38092259362240664, 225424412, 225424420, 8, 1440x900 
0x37CA2318, 38092259362901968, 225424477, 225424485, 8, 1440x900 
0x37CA2318, 38092259363563120, 225424543, 225424550, 7, 1440x900 
0x37CA2318, 38092259364226472, 225424607, 225424616, 9, 1440x900 
0x37CA2318, 38092259364881888, 225424673, 225424681, 8, 1440x900 
0x37CA2318, 38092259365542032, 225424738, 225424746, 8, 1440x900 
0x37CA2318, 38092259366201672, 225424806, 225424814, 8, 1440x900 
0x37CA2318, 38092259366863840, 225424873, 225424882, 9, 1440x900 
0x37CA2318, 38092259367522128, 225424938, 225424945, 7, 1440x900 
0x37CA2318, 38092259368182400, 225425003, 225425011, 8, 1440x900 
0x37CA2318, 38092259368845080, 225425072, 225425081, 9, 1440x900 
0x37CA2318, 38092259369505296, 225425138, 225425146, 8, 1440x900 
0x37CA2318, 38092259370168248, 225425208, 225425217, 9, 1440x900 
0x37CA2318, 38092259370914160, 225425283, 225425291, 8, 1440x900 
0x37CA2318, 38092259371484896, 225425336, 225425344, 8, 1440x900 
0x37CA2318, 38092259372143968, 225425403, 225425410, 7, 1440x900 
0x37CA2318, 38092259372804072, 225425466, 225425474, 8, 1440x900 
0x37CA2318, 38092259373468968, 225425533, 225425540, 7, 1440x900 
0x37CA2318, 38092259374123928, 225425598, 225425606, 8, 1440x900 
0x37CA2318, 38092259374783120, 225425663, 225425671, 8, 1440x900 
0x37CA2318, 38092259375443136, 225425731, 225425738, 7, 1440x900 
0x37CA2318, 38092259376105008, 225425798, 225425804, 6, 1440x900 
0x37CA2318, 38092259376763360, 225425862, 225425870, 8, 1440x900 
0x37CA2318, 38092259377425752, 225425928, 225425936, 8, 1440x900 
0x37CA2318, 38092259378085808, 225425993, 225426001, 8, 1440x900 
0x37CA2318, 38092259378744688, 225426062, 225426070, 8, 1440x900 
0x37CA2318, 38092259379404848, 225426124, 225426132, 8, 1440x900 
0x37CA2318, 38092259380066056, 225426193, 225426200, 7, 1440x900 
0x37CA2318, 38092259380726688, 225426261, 225426269, 8, 1440x900 
0x37CA2318, 38092259381386528, 225426327, 225426335, 8, 1440x900 
0x37CA2318, 38092259382104160, 225426397, 225426405, 8, 1440x900 
0x37CA2318, 38092259382712600, 225426457, 225426464, 7, 1440x900 
0x37CA2318, 38092259383372360, 225426523, 225426531, 8, 1440x900 
0x37CA2318, 38092259384034248, 225426594, 225426601, 7, 1440x900 
0x37CA2318, 38092259384701792, 225426657, 225426664, 7, 1440x900 
0x37CA2318, 38092259385362472, 225426723, 225426730, 7, 1440x900 
0x37CA2318, 38092259386022592, 225426787, 225426795, 8, 1440x900 
0x37CA2318, 38092259386682840, 225426853, 225426861, 8, 1440x900 
0x37CA2318, 38092259387534000, 225426939, 225426947, 8, 1440x900 
0x37CA2318, 38092259388202752, 225427007, 225427014, 7, 1440x900 
0x37CA2318, 38092259388667800, 225427052, 225427059, 7, 1440x900 
0x37CA2318, 38092259389324552, 225427118, 225427125, 7, 1440x900 
0x37CA2318, 38092259389986072, 225427183, 225427192, 9, 1440x900 
0x37CA2318, 38092259390646296, 225427252, 225427260, 8, 1440x900 
0x37CA2318, 38092259391307568, 225427317, 225427326, 9, 1440x900 
0x37CA2318, 38092259391967600, 225427383, 225427391, 8, 1440x900 
0x37CA2318, 38092259392627976, 225427448, 225427456, 8, 1440x900 
0x37CA2318, 38092259393287936, 225427517, 225427525, 8, 1440x900 
0x37CA2318, 38092259393950376, 225427581, 225427591, 10, 1440x900 
0x37CA2318, 38092259394610320, 225427652, 225427660, 8, 1440x900 
0x37CA2318, 38092259395276424, 225427713, 225427721, 8, 1440x900 
0x37CA2318, 38092259395933872, 225427778, 225427786, 8, 1440x900 
0x37CA2318, 38092259396593360, 225427848, 225427858, 10, 1440x900 
0x37CA2318, 38092259397444272, 225427933, 225427941, 8, 1440x900 
0x37CA2318, 38092259397921232, 225427982, 225427991, 9, 1440x900 
0x37CA2318, 38092259398579816, 225428043, 225428051, 8, 1440x900 
0x37CA2318, 38092259399248120, 225428113, 225428120, 7, 1440x900 
0x37CA2318, 38092259399909456, 225428178, 225428185, 7, 1440x900 
0x37CA2318, 38092259400569520, 225428243, 225428252, 9, 1440x900 
0x37CA2318, 38092259401230416, 225428308, 225428317, 9, 1440x900 
0x37CA2318, 38092259401891760, 225428377, 225428385, 8, 1440x900 
0x37CA2318, 38092259402551568, 225428442, 225428450, 8, 1440x900 
0x37CA2318, 38092259403211992, 225428507, 225428514, 7, 1440x900 
0x37CA2318, 38092259403875936, 225428578, 225428586, 8, 1440x900 
0x37CA2318, 38092259404534688, 225428643, 225428651, 8, 1440x900 
0x37CA2318, 38092259405389016, 225428728, 225428736, 8, 1440x900 
0x37CA2318, 38092259406059176, 225428797, 225428805, 8, 1440x900 
0x37CA2318, 38092259406702440, 225428857, 225428866, 9, 1440x900 
0x37CA2318, 38092259407381416, 225428927, 225428934, 7, 1440x900 
0x37CA2318, 38092259408040152, 225428992, 225428999, 7, 1440x900 
0x37CA2318, 38092259408709904, 225429057, 225429064, 7, 1440x900 
0x37CA2318, 38092259409369320, 225429122, 225429130, 8, 1440x900 
0x37CA2318, 38092259410039080, 225429192, 225429199, 7, 1440x900 
0x37CA2318, 38092259410688696, 225429253, 225429261, 8, 1440x900 
0x37CA2318, 38092259411820688, 225429368, 225429376, 8, 1440x900 
0x37CA2318, 38092259412480424, 225429432, 225429440, 8, 1440x900 
0x37CA2318, 38092259413140496, 225429498, 225429506, 8, 1440x900 
0x37CA2318, 38092259413800392, 225429566, 225429573, 7, 1440x900 
0x37CA2318, 38092259414465144, 225429633, 225429642, 9, 1440x900 
0x37CA2318, 38092259415122704, 225429702, 225429710, 8, 1440x900 
0x37CA2318, 38092259415792904, 225429767, 225429775, 8, 1440x900 
0x37CA2318, 38092259416451936, 225429832, 225429840, 8, 1440x900 
0x37CA2318, 38092259417111688, 225429898, 225429906, 8, 1440x900 
0x37CA2318, 38092259417771936, 225429966, 225429974, 8, 1440x900 
0x37CA2318, 38092259418432080, 225430028, 225430036, 8, 1440x900 
0x37CA2318, 38092259419094440, 225430096, 225430104, 8, 1440x900 
0x37CA2318, 38092259419754784, 225430163, 225430170, 7, 1440x900 
0x37CA2318, 38092259420413504, 225430227, 225430234, 7, 1440x900 
0x37CA2318, 38092259421073176, 225430293, 225430301, 8, 1440x900 
0x37CA2318, 38092259421742848, 225430358, 225430366, 8, 1440x900 
0x37CA2318, 38092259422402800, 225430426, 225430433, 7, 1440x900 
0x37CA2318, 38092259423064016, 225430493, 225430500, 7, 1440x900 
0x37CA2318, 38092259423722848, 225430558, 225430565, 7, 1440x900 
0x37CA2318, 38092259424382920, 225430623, 225430631, 8, 1440x900 
0x37CA2318, 38092259425245048, 225430713, 225430722, 9, 1440x900 
0x37CA2318, 38092259425899072, 225430778, 225430787, 9, 1440x900 
0x37CA2318, 38092259426428800, 225430833, 225430841, 8, 1440x900 
0x37CA2318, 38092259427030768, 225430894, 225430902, 8, 1440x900 
0x37CA2318, 38092259427685984, 225430953, 225430961, 8, 1440x900 
0x37CA2318, 38092259428346552, 225431022, 225431030, 8, 1440x900 
0x37CA2318, 38092259429009712, 225431092, 225431100, 8, 1440x900 
0x37CA2318, 38092259429669168, 225431153, 225431162, 9, 1440x900 
0x37CA2318, 38092259430342328, 225431223, 225431231, 8, 1440x900 
0x37CA2318, 38092259430990120, 225431287, 225431295, 8, 1440x900 
0x37CA2318, 38092259431782216, 225431363, 225431371, 8, 1440x900 
0x37CA2318, 38092259432315592, 225431418, 225431425, 7, 1440x900 
0x37CA2318, 38092259432976696, 225431487, 225431495, 8, 1440x900 
0x37CA2318, 38092259433634128, 225431548, 225431556, 8, 1440x900 
0x37CA2318, 38092259434489952, 225431637, 225431645, 8, 1440x900 
0x37CA2318, 38092259435141264, 225431703, 225431711, 8, 1440x900 
0x37CA2318, 38092259435786152, 225431768, 225431778, 10, 1440x900 
0x37CA2318, 38092259436289944, 225431818, 225431826, 8, 1440x900 
0x37CA2318, 38092259436945904, 225431889, 225431898, 9, 1440x900 
0x37CA2318, 38092259437614432, 225431952, 225431960, 8, 1440x900 
0x37CA2318, 38092259438268480, 225432012, 225432021, 9, 1440x900 
0x37CA2318, 38092259438926304, 225432078, 225432086, 8, 1440x900 
0x37CA2318, 38092259439584272, 225432143, 225432153, 10, 1440x900 
0x37CA2318, 38092259440245648, 225432212, 225432220, 8, 1440x900 
0x37CA2318, 38092259440907728, 225432277, 225432284, 7, 1440x900 
0x37CA2318, 38092259441560360, 225432342, 225432350, 8, 1440x900 
0x37CA2318, 38092259442225776, 225432408, 225432416, 8, 1440x900 
0x37CA2318, 38092259442882296, 225432473, 225432481, 8, 1440x900 
0x37CA2318, 38092259443547608, 225432542, 225432550, 8, 1440x900 
0x37CA2318, 38092259444366312, 225432623, 225432630, 7, 1440x900 
0x37CA2318, 38092259444862536, 225432672, 225432680, 8, 1440x900 
0x37CA2318, 38092259445529424, 225432741, 225432749, 8, 1440x900 
0x37CA2318, 38092259446192792, 225432807, 225432815, 8, 1440x900 
0x37CA2318, 38092259446858928, 225432873, 225432881, 8, 1440x900 
0x37CA2318, 38092259447518296, 225432937, 225432945, 8, 1440x900 
0x37CA2318, 38092259448188312, 225433007, 225433015, 8, 1440x900 
0x37CA2318, 38092259448841192, 225433072, 225433080, 8, 1440x900 
0x37CA2318, 38092259449503936, 225433137, 225433144, 7, 1440x900 
0x37CA2318, 38092259450167864, 225433206, 225433214, 8, 1440x900 
0x37CA2318, 38092259450816232, 225433267, 225433275, 8, 1440x900 
0x37CA2318, 38092259451475480, 225433333, 225433341, 8, 1440x900 
0x37CA2318, 38092259452142272, 225433398, 225433406, 8, 1440x900 
0x37CA2318, 38092259452801640, 225433466, 225433474, 8, 1440x900 
0x37CA2318, 38092259453461760, 225433532, 225433540, 8, 1440x900 
0x37CA2318, 38092259454122384, 225433597, 225433604, 7, 1440x900 
0x37CA2318, 38092259454781904, 225433663, 225433671, 8, 1440x900 
0x37CA2318, 38092259455449656, 225433732, 225433739, 7, 1440x900 
0x37CA2318, 38092259456107472, 225433796, 225433804, 8, 1440x900 
0x37CA2318, 38092259456773136, 225433863, 225433870, 7, 1440x900 
0x37CA2318, 38092259457428272, 225433928, 225433936, 8, 1440x900 
0x37CA2318, 38092259458087656, 225433996, 225434003, 7, 1440x900 
0x37CA2318, 38092259458747672, 225434061, 225434068, 7, 1440x900 
0x37CA2318, 38092259459412432, 225434127, 225434134, 7, 1440x900 
0x37CA2318, 38092259460078264, 225434193, 225434201, 8, 1440x900 
0x37CA2318, 38092259460738176, 225434258, 225434266, 8, 1440x900 
0x37CA2318, 38092259461392840, 225434326, 225434334, 8, 1440x900 
0x37CA2318, 38092259462053336, 225434391, 225434398, 7, 1440x900 
0x37CA2318, 38092259462721824, 225434458, 225434465, 7, 1440x900 
0x37CA2318, 38092259463381672, 225434522, 225434530, 8, 1440x900 
0x37CA2318, 38092259464041800, 225434588, 225434596, 8, 1440x900 
0x37CA2318, 38092259464704336, 225434657, 225434664, 7, 1440x900 
0x37CA2318, 38092259465362600, 225434722, 225434729, 7, 1440x900 
0x37CA2318, 38092259466022640, 225434788, 225434795, 7, 1440x900 
0x37CA2318, 38092259466682712, 225434853, 225434861, 8, 1440x900 
0x37CA2318, 38092259467343352, 225434918, 225434926, 8, 1440x900 
0x37CA2318, 38092259468002864, 225434987, 225434994, 7, 1440x900 
0x37CA2318, 38092259468669904, 225435052, 225435059, 7, 1440x900 
0x37CA2318, 38092259469330128, 225435118, 225435126, 8, 1440x900 
0x37CA2318, 38092259469988512, 225435183, 225435191, 8, 1440x900 
0x37CA2318, 38092259470653408, 225435253, 225435260, 7, 1440x900 
0x37CA2318, 38092259471314912, 225435317, 225435325, 8, 1440x900 
0x37CA2318, 38092259471968480, 225435383, 225435390, 7, 1440x900 
0x37CA2318, 38092259472630576, 225435448, 225435456, 8, 1440x900 
0x37CA2318, 38092259473289184, 225435518, 225435525, 7, 1440x900 
0x37CA2318, 38092259474014632, 225435587, 225435595, 8, 1440x900 
0x37CA2318, 38092259474642208, 225435651, 225435658, 7, 1440x900 
0x37CA2318, 38092259475271440, 225435713, 225435720, 7, 1440x900 
0x37CA2318, 38092259475930288, 225435778, 225435785, 7, 1440x900 
0x37CA2318, 38092259476792360, 225435863, 225435871, 8, 1440x900 
0x37CA2318, 38092259477298680, 225435917, 225435924, 7, 1440x900 
0x37CA2318, 38092259477915872, 225435977, 225435984, 7, 1440x900 
0x37CA2318, 38092259479269568, 225436113, 225436124, 11, 1440x900 
0x37CA2318, 38092259479947688, 225436182, 225436189, 7, 1440x900 
0x37CA2318, 38092259480554448, 225436242, 225436249, 7, 1440x900 
0x37CA2318, 38092259481222632, 225436307, 225436315, 8, 1440x900 
0x37CA2318, 38092259482007288, 225436388, 225436400, 12, 1440x900 
0x37CA2318, 38092259482620288, 225436448, 225436455, 7, 1440x900 
0x37CA2318, 38092259483291952, 225436518, 225436526, 8, 1440x900 
0x37CA2318, 38092259483895776, 225436573, 225436581, 8, 1440x900 
0x37CA2318, 38092259484525320, 225436638, 225436645, 7, 1440x900 
0x37CA2318, 38092259485186616, 225436703, 225436711, 8, 1440x900 
0x37CA2318, 38092259485844904, 225436772, 225436779, 7, 1440x900 
0x37CA2318, 38092259486513888, 225436838, 225436845, 7, 1440x900 
0x37CA2318, 38092259487172128, 225436902, 225436911, 9, 1440x900 
0x37CA2318, 38092259487832112, 225436968, 225436976, 8, 1440x900 
0x37CA2318, 38092259488491920, 225437037, 225437045, 8, 1440x900 
0x37CA2318, 38092259489155568, 225437102, 225437109, 7, 1440x900 
0x37CA2318, 38092259489815272, 225437167, 225437175, 8, 1440x900 
0x37CA2318, 38092259490472008, 225437234, 225437241, 7, 1440x900 
0x37CA2318, 38092259491141128, 225437301, 225437309, 8, 1440x900 
0x37CA2318, 38092259491800840, 225437367, 225437375, 8, 1440x900 
0x37CA2318, 38092259492460720, 225437432, 225437440, 8, 1440x900 
0x37CA2318, 38092259493120832, 225437498, 225437506, 8, 1440x900 
0x37CA2318, 38092259493780920, 225437563, 225437571, 8, 1440x900 
0x37CA2318, 38092259494645216, 225437653, 225437660, 7, 1440x900 
0x37CA2318, 38092259495297216, 225437722, 225437730, 8, 1440x900 
0x37CA2318, 38092259495957992, 225437784, 225437792, 8, 1440x900 
0x37CA2318, 38092259496620592, 225437853, 225437861, 8, 1440x900 
0x37CA2318, 38092259497270568, 225437913, 225437920, 7, 1440x900 
0x37CA2318, 38092259497742536, 225437962, 225437970, 8, 1440x900 
0x37CA2318, 38092259498402392, 225438027, 225438035, 8, 1440x900 
0x37CA2318, 38092259499062680, 225438093, 225438100, 7, 1440x900 
0x37CA2318, 38092259499727824, 225438163, 225438171, 8, 1440x900 
0x37CA2318, 38092259500385304, 225438227, 225438235, 8, 1440x900 
0x37CA2318, 38092259501049392, 225438292, 225438301, 9, 1440x900 
0x37CA2318, 38092259501706544, 225438356, 225438363, 7, 1440x900 
0x37CA2318, 38092259502362744, 225438422, 225438430, 8, 1440x900 
0x37CA2318, 38092259503022992, 225438488, 225438496, 8, 1440x900 
0x37CA2318, 38092259503685112, 225438553, 225438561, 8, 1440x900 
0x37CA2318, 38092259504350648, 225438623, 225438631, 8, 1440x900 
0x37CA2318, 38092259505006464, 225438687, 225438695, 8, 1440x900 
0x37CA2318, 38092259505664960, 225438753, 225438760, 7, 1440x900 
0x37CA2318, 38092259506326128, 225438818, 225438826, 8, 1440x900 
0x37CA2318, 38092259506984256, 225438883, 225438893, 10, 1440x900 
0x37CA2318, 38092259507650256, 225438952, 225438959, 7, 1440x900 
0x37CA2318, 38092259508310848, 225439018, 225439025, 7, 1440x900 
0x37CA2318, 38092259508970280, 225439083, 225439090, 7, 1440x900 
0x37CA2318, 38092259509630352, 225439147, 225439155, 8, 1440x900 
0x37CA2318, 38092259510290456, 225439213, 225439221, 8, 1440x900 
0x37CA2318, 38092259510953560, 225439282, 225439290, 8, 1440x900 
0x37CA2318, 38092259511620800, 225439352, 225439360, 8, 1440x900 
0x37CA2318, 38092259512273312, 225439413, 225439421, 8, 1440x900 
0x37CA2318, 38092259512935352, 225439483, 225439491, 8, 1440x900 
0x37CA2318, 38092259513791024, 225439568, 225439576, 8, 1440x900 
0x37CA2318, 38092259514451640, 225439637, 225439646, 9, 1440x900 
0x37CA2318, 38092259514926264, 225439682, 225439690, 8, 1440x900 
0x37CA2318, 38092259515575912, 225439744, 225439752, 8, 1440x900 
0x37CA2318, 38092259516237648, 225439811, 225439819, 8, 1440x900 
0x37CA2318, 38092259516907048, 225439877, 225439885, 8, 1440x900 
0x37CA2318, 38092259517554688, 225439942, 225439949, 7, 1440x900 
0x37CA2318, 38092259518218848, 225440013, 225440021, 8, 1440x900 
0x37CA2318, 38092259519070352, 225440098, 225440106, 8, 1440x900 
0x37CA2318, 38092259519544232, 225440142, 225440151, 9, 1440x900 
0x37CA2318, 38092259520199648, 225440208, 225440216, 8, 1440x900 
0x37CA2318, 38092259520861296, 225440277, 225440285, 8, 1440x900 
0x37CA2318, 38092259521522904, 225440343, 225440351, 8, 1440x900 
0x37CA2318, 38092259522190440, 225440408, 225440417, 9, 1440x900 
0x37CA2318, 38092259522858176, 225440478, 225440486, 8, 1440x900 
0x37CA2318, 38092259523509480, 225440537, 225440545, 8, 1440x900 
0x37CA2318, 38092259524168296, 225440603, 225440611, 8, 1440x900 
0x37CA2318, 38092259524836752, 225440667, 225440675, 8, 1440x900 
0x37CA2318, 38092259525495152, 225440737, 225440744, 7, 1440x900 
0x37CA2318, 38092259526157744, 225440803, 225440810, 7, 1440x900 
0x37CA2318, 38092259526818624, 225440868, 225440877, 9, 1440x900 
0x37CA2318, 38092259527476408, 225440933, 225440941, 8, 1440x900 
0x37CA2318, 38092259528136104, 225440998, 225441006, 8, 1440x900 
0x37CA2318, 38092259528796096, 225441066, 225441074, 8, 1440x900 
0x37CA2318, 38092259529462800, 225441132, 225441139, 7, 1440x900 
0x37CA2318, 38092259530122024, 225441197, 225441205, 8, 1440x900 
0x37CA2318, 38092259530916592, 225441277, 225441285, 8, 1440x900 
0x37CA2318, 38092259531583888, 225441343, 225441351, 8, 1440x900 
0x37CA2318, 38092259532107792, 225441397, 225441404, 7, 1440x900 
0x37CA2318, 38092259532922928, 225441477, 225441485, 8, 1440x900 
0x37CA2318, 38092259533513744, 225441538, 225441545, 7, 1440x900 
0x37CA2318, 38092259534083456, 225441593, 225441601, 8, 1440x900 
0x37CA2318, 38092259534846424, 225441668, 225441676, 8, 1440x900 
0x37CA2318, 38092259535402744, 225441727, 225441734, 7, 1440x900 
0x37CA2318, 38092259536064008, 225441792, 225441799, 7, 1440x900 
0x37CA2318, 38092259536722624, 225441858, 225441866, 8, 1440x900 
0x37CA2318, 38092259537390928, 225441927, 225441935, 8, 1440x900 
0x37CA2318, 38092259538045160, 225441992, 225441999, 7, 1440x900 
0x37CA2318, 38092259538705144, 225442058, 225442065, 7, 1440x900 
0x37CA2318, 38092259539365336, 225442124, 225442131, 7, 1440x900 
0x37CA2318, 38092259540026856, 225442188, 225442196, 8, 1440x900 
0x37CA2318, 38092259540686368, 225442257, 225442265, 8, 1440x900 
0x37CA2318, 38092259541347416, 225442323, 225442330, 7, 1440x900 
0x37CA2318, 38092259542675968, 225442453, 225442461, 8, 1440x900 
0x37CA2318, 38092259543332736, 225442523, 225442531, 8, 1440x900 
0x37CA2318, 38092259544042960, 225442591, 225442598, 7, 1440x900 
0x37CA2318, 38092259544858400, 225442672, 225442679, 7, 1440x900 
0x37CA2318, 38092259545507888, 225442737, 225442744, 7, 1440x900 
0x37CA2318, 38092259546184456, 225442809, 225442817, 8, 1440x900 
0x37CA2318, 38092259546844864, 225442873, 225442881, 8, 1440x900 
0x37CA2318, 38092259547494640, 225442939, 225442947, 8, 1440x900 
0x37CA2318, 38092259548166640, 225443008, 225443016, 8, 1440x900 
0x37CA2318, 38092259548819048, 225443073, 225443081, 8, 1440x900 
0x37CA2318, 38092259549501032, 225443170, 225443218, 48, 1440x900 
0x37CA2318, 38092259550365320, 225443238, 225443278, 40, 1440x900 
0x37CA2318, 38092259551168616, 225443312, 225443360, 48, 1440x900 
0x37CA2318, 38092259551822632, 225443380, 225443402, 22, 1440x900 
0x37CA2318, 38092259552634232, 225443450, 225443497, 47, 1440x900 
0x37CA2318, 38092259553190720, 225443514, 225443531, 17, 1440x900 
0x37CA2318, 38092259553705664, 225443569, 225443592, 23, 1440x900 
0x37CA2318, 38092259554373112, 225443629, 225443638, 9, 1440x900 
0x37CA2318, 38092259555027888, 225443688, 225443701, 13, 1440x900 
0x37CA2318, 38092259555689288, 225443753, 225443763, 10, 1440x900 
0x37CA2318, 38092259556345672, 225443822, 225443828, 6, 1440x900 
0x37CA2318, 38092259557185840, 225443907, 225443913, 6, 1440x900 
0x37CA2318, 38092259557652128, 225443952, 225443958, 6, 1440x900 
0x37CA2318, 38092259558308392, 225444017, 225444023, 6, 1440x900 
0x37CA2318, 38092259558984208, 225444088, 225444096, 8, 1440x900 
0x37CA2318, 38092259559641392, 225444152, 225444159, 7, 1440x900 
0x37CA2318, 38092259560299784, 225444217, 225444223, 6, 1440x900 
0x37CA2318, 38092259560955672, 225444282, 225444288, 6, 1440x900 
0x37CA2318, 38092259561616712, 225444347, 225444354, 7, 1440x900 
0x37CA2318, 38092259562275208, 225444412, 225444419, 7, 1440x900 
0x37CA2318, 38092259562943952, 225444482, 225444489, 7, 1440x900 
0x37CA2318, 38092259563597616, 225444547, 225444554, 7, 1440x900 
0x37CA2318, 38092259564258352, 225444612, 225444619, 7, 1440x900 
0x37CA2318, 38092259564917544, 225444677, 225444684, 7, 1440x900 
0x37CA2318, 38092259565576432, 225444742, 225444750, 8, 1440x900 
0x37CA2318, 38092259566244136, 225444813, 225444821, 8, 1440x900 
0x37CA2318, 38092259566905080, 225444882, 225444890, 8, 1440x900 
0x37CA2318, 38092259567561096, 225444942, 225444950, 8, 1440x900 
0x37CA2318, 38092259568227072, 225445008, 225445016, 8, 1440x900 
0x37CA2318, 38092259568877176, 225445073, 225445081, 8, 1440x900 
0x37CA2318, 38092259569536920, 225445144, 225445152, 8, 1440x900 
0x37CA2318, 38092259570203816, 225445208, 225445216, 8, 1440x900 
0x37CA2318, 38092259570869456, 225445278, 225445287, 9, 1440x900 
0x37CA2318, 38092259571516104, 225445342, 225445350, 8, 1440x900 
0x37CA2318, 38092259572178096, 225445408, 225445416, 8, 1440x900 
0x37CA2318, 38092259573032472, 225445492, 225445500, 8, 1440x900 
0x37CA2318, 38092259573694080, 225445557, 225445566, 9, 1440x900 
0x37CA2318, 38092259574351616, 225445622, 225445631, 9, 1440x900 
0x37CA2318, 38092259575012368, 225445689, 225445698, 9, 1440x900 
0x37CA2318, 38092259575482264, 225445738, 225445746, 8, 1440x900 
0x37CA2318, 38092259576148984, 225445803, 225445811, 8, 1440x900 
0x37CA2318, 38092259576894232, 225445873, 225445883, 10, 1440x900 
0x37CA2318, 38092259577561960, 225445947, 225445957, 10, 1440x900 
0x37CA2318, 38092259578159224, 225446008, 225446023, 15, 1440x900 
0x37CA2318, 38092259578856080, 225446073, 225446089, 16, 1440x900 
0x37CA2318, 38092259579514280, 225446138, 225446149, 11, 1440x900 
0x37CA2318, 38092259580141328, 225446204, 225446215, 11, 1440x900 
0x37CA2318, 38092259580798640, 225446267, 225446274, 7, 1440x900 
0x37CA2318, 38092259581438416, 225446331, 225446338, 7, 1440x900 
0x37CA2318, 38092259582109544, 225446397, 225446406, 9, 1440x900 
0x37CA2318, 38092259582810616, 225446468, 225446476, 8, 1440x900 
0x37CA2318, 38092259583421520, 225446529, 225446536, 7, 1440x900 
0x37CA2318, 38092259584107680, 225446603, 225446612, 9, 1440x900 
0x37CA2318, 38092259584779368, 225446668, 225446675, 7, 1440x900 
0x37CA2318, 38092259585441968, 225446729, 225446738, 9, 1440x900 
0x37CA2318, 38092259586073784, 225446793, 225446801, 8, 1440x900 
0x37CA2318, 38092259586738480, 225446858, 225446866, 8, 1440x900 
0x37CA2318, 38092259587414896, 225446928, 225446937, 9, 1440x900 
0x37CA2318, 38092259588066112, 225446992, 225446999, 7, 1440x900 
0x37CA2318, 38092259588717216, 225447061, 225447069, 8, 1440x900 
0x37CA2318, 38092259589390824, 225447129, 225447138, 9, 1440x900 
0x37CA2318, 38092259590037568, 225447192, 225447200, 8, 1440x900 
0x37CA2318, 38092259590701344, 225447257, 225447264, 7, 1440x900 
0x37CA2318, 38092259591367272, 225447323, 225447330, 7, 1440x900 
0x37CA2318, 38092259592026448, 225447388, 225447396, 8, 1440x900 
0x37CA2318, 38092259592686312, 225447452, 225447460, 8, 1440x900 
0x37CA2318, 38092259593353408, 225447522, 225447530, 8, 1440x900 
0x37CA2318, 38092259594012608, 225447588, 225447595, 7, 1440x900 
0x37CA2318, 38092259594672008, 225447653, 225447660, 7, 1440x900 
0x37CA2318, 38092259595331712, 225447717, 225447725, 8, 1440x900 
0x37CA2318, 38092259595993808, 225447786, 225447793, 7, 1440x900 
0x37CA2318, 38092259596653344, 225447852, 225447859, 7, 1440x900 
0x37CA2318, 38092259597316728, 225447917, 225447925, 8, 1440x900 
0x37CA2318, 38092259597982368, 225447983, 225447992, 9, 1440x900 
0x37CA2318, 38092259598642184, 225448048, 225448057, 9, 1440x900 
0x37CA2318, 38092259599301168, 225448117, 225448124, 7, 1440x900 
0x37CA2318, 38092259600624688, 225448248, 225448256, 8, 1440x900 
0x37CA2318, 38092259601479944, 225448333, 225448341, 8, 1440x900 
0x37CA2318, 38092259602142000, 225448402, 225448410, 8, 1440x900 
0x37CA2318, 38092259602792416, 225448468, 225448475, 7, 1440x900 
0x37CA2318, 38092259603267752, 225448513, 225448522, 9, 1440x900 
0x37CA2318, 38092259603927960, 225448579, 225448587, 8, 1440x900 
0x37CA2318, 38092259604585496, 225448643, 225448652, 9, 1440x900 
0x37CA2318, 38092259605246184, 225448709, 225448718, 9, 1440x900 
0x37CA2318, 38092259605907888, 225448777, 225448785, 8, 1440x900 
0x37CA2318, 38092259606567960, 225448842, 225448850, 8, 1440x900 
0x37CA2318, 38092259607232072, 225448908, 225448916, 8, 1440x900 
0x37CA2318, 38092259607891672, 225448976, 225448983, 7, 1440x900 
0x37CA2318, 38092259608553920, 225449042, 225449050, 8, 1440x900 
0x37CA2318, 38092259609213408, 225449107, 225449115, 8, 1440x900 
0x37CA2318, 38092259609872152, 225449173, 225449181, 8, 1440x900 
0x37CA2318, 38092259610533016, 225449242, 225449249, 7, 1440x900 
0x37CA2318, 38092259611193072, 225449303, 225449311, 8, 1440x900 
0x37CA2318, 38092259611853904, 225449372, 225449379, 7, 1440x900 
0x37CA2318, 38092259612512448, 225449437, 225449444, 7, 1440x900 
0x37CA2318, 38092259613177456, 225449504, 225449512, 8, 1440x900 
0x37CA2318, 38092259613839952, 225449573, 225449582, 9, 1440x900 
0x37CA2318, 38092259614508392, 225449638, 225449647, 9, 1440x900 
0x37CA2318, 38092259615185816, 225449708, 225449716, 8, 1440x900 
0x37CA2318, 38092259615822304, 225449768, 225449776, 8, 1440x900 
0x37CA2318, 38092259616482376, 225449833, 225449841, 8, 1440x900 
0x37CA2318, 38092259617186912, 225449907, 225449914, 7, 1440x900 
0x37CA2318, 38092259617815000, 225449968, 225449976, 8, 1440x900 
0x37CA2318, 38092259618480912, 225450033, 225450041, 8, 1440x900 
0x37CA2318, 38092259619138896, 225450098, 225450107, 9, 1440x900 
0x37CA2318, 38092259619803512, 225450165, 225450174, 9, 1440x900 
0x37CA2318, 38092259620467736, 225450233, 225450240, 7, 1440x900 
0x37CA2318, 38092259621118352, 225450298, 225450305, 7, 1440x900 
0x37CA2318, 38092259621788144, 225450364, 225450374, 10, 1440x900 
0x37CA2318, 38092259622445792, 225450432, 225450440, 8, 1440x900 
0x37CA2318, 38092259623116016, 225450499, 225450507, 8, 1440x900 
0x37CA2318, 38092259623791712, 225450567, 225450575, 8, 1440x900 
0x37CA2318, 38092259624624248, 225450652, 225450659, 7, 1440x900 
0x37CA2318, 38092259625293856, 225450718, 225450726, 8, 1440x900 
0x37CA2318, 38092259625949400, 225450783, 225450791, 8, 1440x900 
0x37CA2318, 38092259626604832, 225450848, 225450857, 9, 1440x900 
0x37CA2318, 38092259627071576, 225450903, 225450913, 10, 1440x900 
0x37CA2318, 38092259627734664, 225450962, 225450970, 8, 1440x900 
0x37CA2318, 38092259628395320, 225451027, 225451035, 8, 1440x900 
0x37CA2318, 38092259629056496, 225451092, 225451099, 7, 1440x900 
0x37CA2318, 38092259629711432, 225451158, 225451165, 7, 1440x900 
0x37CA2318, 38092259630370504, 225451222, 225451230, 8, 1440x900 
0x37CA2318, 38092259631031464, 225451288, 225451296, 8, 1440x900 
0x37CA2318, 38092259631690480, 225451354, 225451362, 8, 1440x900 
0x37CA2318, 38092259632350640, 225451422, 225451429, 7, 1440x900 
0x37CA2318, 38092259633011768, 225451487, 225451494, 7, 1440x900 
0x37CA2318, 38092259633671408, 225451553, 225451560, 7, 1440x900 
0x37CA2318, 38092259634331664, 225451618, 225451626, 8, 1440x900 
0x37CA2318, 38092259634992288, 225451683, 225451691, 8, 1440x900 
0x37CA2318, 38092259635660800, 225451757, 225451765, 8, 1440x900 
0x37CA2318, 38092259636319992, 225451818, 225451827, 9, 1440x900 
0x37CA2318, 38092259636982704, 225451884, 225451892, 8, 1440x900 
0x37CA2318, 38092259637652152, 225451957, 225451965, 8, 1440x900 
0x37CA2318, 38092259638308264, 225452018, 225452026, 8, 1440x900 
0x37CA2318, 38092259638965792, 225452083, 225452091, 8, 1440x900 
0x37CA2318, 38092259639631880, 225452148, 225452157, 9, 1440x900 
0x37CA2318, 38092259640294696, 225452218, 225452226, 8, 1440x900 
0x37CA2318, 38092259641150304, 225452303, 225452311, 8, 1440x900 
0x37CA2318, 38092259641807656, 225452368, 225452375, 7, 1440x900 
0x37CA2318, 38092259642476472, 225452433, 225452441, 8, 1440x900 
0x37CA2318, 38092259643027848, 225452488, 225452496, 8, 1440x900 
0x37CA2318, 38092259643611312, 225452553, 225452561, 8, 1440x900 
0x37CA2318, 38092259644267432, 225452613, 225452622, 9, 1440x900 
0x37CA2318, 38092259644931624, 225452677, 225452685, 8, 1440x900 
0x37CA2318, 38092259645592880, 225452747, 225452755, 8, 1440x900 
0x37CA2318, 38092259646253312, 225452812, 225452819, 7, 1440x900 
0x37CA2318, 38092259646911976, 225452877, 225452885, 8, 1440x900 
0x37CA2318, 38092259647605792, 225452947, 225452955, 8, 1440x900 
0x37CA2318, 38092259648232784, 225453008, 225453017, 9, 1440x900 
0x37CA2318, 38092259648895360, 225453078, 225453086, 8, 1440x900 
0x37CA2318, 38092259649555072, 225453142, 225453149, 7, 1440x900 
0x37CA2318, 38092259650213744, 225453207, 225453215, 8, 1440x900 
0x37CA2318, 38092259650874728, 225453273, 225453281, 8, 1440x900 
0x37CA2318, 38092259651533784, 225453337, 225453345, 8, 1440x900 
0x37CA2318, 38092259652195280, 225453407, 225453415, 8, 1440x900 
0x37CA2318, 38092259652864192, 225453472, 225453480, 8, 1440x900 
0x37CA2318, 38092259653523032, 225453538, 225453546, 8, 1440x900 
0x37CA2318, 38092259654190464, 225453607, 225453615, 8, 1440x900 
0x37CA2318, 38092259654852656, 225453673, 225453682, 9, 1440x900 
0x37CA2318, 38092259655514184, 225453738, 225453746, 8, 1440x900 
0x37CA2318, 38092259656186664, 225453803, 225453811, 8, 1440x900 
0x37CA2318, 38092259656844360, 225453872, 225453879, 7, 1440x900 
0x37CA2318, 38092259657503456, 225453937, 225453944, 7, 1440x900 
0x37CA2318, 38092259658167320, 225454002, 225454010, 8, 1440x900 
0x37CA2318, 38092259658826096, 225454068, 225454076, 8, 1440x900 
0x37CA2318, 38092259659500032, 225454138, 225454146, 8, 1440x900 
0x37CA2318, 38092259660160240, 225454203, 225454212, 9, 1440x900 
0x37CA2318, 38092259660814040, 225454268, 225454276, 8, 1440x900 
0x37CA2318, 38092259662136152, 225454398, 225454406, 8, 1440x900 
0x37CA2318, 38092259662793136, 225454467, 225454474, 7, 1440x900 
0x37CA2318, 38092259663455904, 225454531, 225454539, 8, 1440x900 
0x37CA2318, 38092259664112560, 225454597, 225454604, 7, 1440x900 
0x37CA2318, 38092259664776008, 225454663, 225454671, 8, 1440x900 
0x37CA2318, 38092259665434872, 225454728, 225454736, 8, 1440x900 
0x37CA2318, 38092259666093024, 225454796, 225454804, 8, 1440x900 
0x37CA2318, 38092259666755640, 225454862, 225454870, 8, 1440x900 
0x37CA2318, 38092259667410416, 225454928, 225454935, 7, 1440x900 
0x37CA2318, 38092259668082408, 225454994, 225455002, 8, 1440x900 
0x37CA2318, 38092259668738544, 225455058, 225455066, 8, 1440x900 
0x37CA2318, 38092259669396760, 225455123, 225455131, 8, 1440x900 
0x37CA2318, 38092259670057184, 225455192, 225455199, 7, 1440x900 
0x37CA2318, 38092259670728832, 225455258, 225455266, 8, 1440x900 
0x37CA2318, 38092259671586752, 225455343, 225455352, 9, 1440x900 
0x37CA2318, 38092259672051104, 225455392, 225455401, 9, 1440x900 
0x37CA2318, 38092259672716192, 225455457, 225455465, 8, 1440x900 
0x37CA2318, 38092259673390096, 225455527, 225455535, 8, 1440x900 
0x37CA2318, 38092259674070640, 225455597, 225455605, 8, 1440x900 
0x37CA2318, 38092259674706848, 225455658, 225455666, 8, 1440x900 
0x37CA2318, 38092259675366832, 225455727, 225455735, 8, 1440x900 
0x37CA2318, 38092259676025136, 225455787, 225455796, 9, 1440x900 
0x37CA2318, 38092259676681744, 225455853, 225455861, 8, 1440x900 
0x37CA2318, 38092259677347344, 225455922, 225455930, 8, 1440x900 
0x37CA2318, 38092259678013544, 225455989, 225455997, 8, 1440x900 
0x37CA2318, 38092259678668888, 225456053, 225456061, 8, 1440x900 
0x37CA2318, 38092259679326432, 225456118, 225456126, 8, 1440x900 
0x37CA2318, 38092259679988576, 225456187, 225456196, 9, 1440x900 
0x37CA2318, 38092259680847160, 225456273, 225456281, 8, 1440x900 
0x37CA2318, 38092259681358616, 225456325, 225456339, 14, 1440x900 
0x37CA2318, 38092259681995840, 225456390, 225456402, 12, 1440x900 
0x37CA2318, 38092259682653048, 225456452, 225456468, 16, 1440x900 
0x37CA2318, 38092259683321432, 225456518, 225456533, 15, 1440x900 
0x37CA2318, 38092259683979112, 225456589, 225456600, 11, 1440x900 
0x37CA2318, 38092259684636720, 225456648, 225456659, 11, 1440x900 
0x37CA2318, 38092259685321848, 225456718, 225456732, 14, 1440x900 
0x37CA2318, 38092259685969704, 225456783, 225456792, 9, 1440x900 
0x37CA2318, 38092259686640912, 225456848, 225456858, 10, 1440x900 
0x37CA2318, 38092259687302840, 225456917, 225456926, 9, 1440x900 
0x37CA2318, 38092259687962808, 225456982, 225456992, 10, 1440x900 
0x37CA2318, 38092259688631064, 225457048, 225457058, 10, 1440x900 
0x37CA2318, 38092259689295304, 225457117, 225457125, 8, 1440x900 
0x37CA2318, 38092259689961416, 225457183, 225457192, 9, 1440x900 
0x37CA2318, 38092259690576888, 225457242, 225457250, 8, 1440x900 
0x37CA2318, 38092259691427304, 225457333, 225457340, 7, 1440x900 
0x37CA2318, 38092259692087208, 225457397, 225457404, 7, 1440x900 
0x37CA2318, 38092259692552096, 225457442, 225457449, 7, 1440x900 
0x37CA2318, 38092259693220536, 225457508, 225457515, 7, 1440x900 
0x37CA2318, 38092259693872408, 225457573, 225457582, 9, 1440x900 
0x37CA2318, 38092259694547184, 225457642, 225457661, 19, 1440x900 
0x37CA2318, 38092259695223968, 225457707, 225457715, 8, 1440x900 
0x37CA2318, 38092259695850512, 225457771, 225457778, 7, 1440x900 
0x37CA2318, 38092259696512496, 225457837, 225457845, 8, 1440x900 
0x37CA2318, 38092259697180232, 225457908, 225457915, 7, 1440x900 
0x37CA2318, 38092259697839536, 225457968, 225457976, 8, 1440x900 
0x37CA2318, 38092259698500584, 225458037, 225458045, 8, 1440x900 
0x37CA2318, 38092259699159088, 225458102, 225458109, 7, 1440x900 
0x37CA2318, 38092259699822304, 225458168, 225458176, 8, 1440x900 
0x37CA2318, 38092259700482360, 225458236, 225458244, 8, 1440x900 
0x37CA2318, 38092259701142376, 225458301, 225458308, 7, 1440x900 
0x37CA2318, 38092259701802256, 225458367, 225458374, 7, 1440x900 
0x37CA2318, 38092259702462504, 225458432, 225458440, 8, 1440x900 
0x37CA2318, 38092259703130824, 225458501, 225458509, 8, 1440x900 
0x37CA2318, 38092259703783576, 225458563, 225458571, 8, 1440x900 
0x37CA2318, 38092259704445752, 225458632, 225458639, 7, 1440x900 
0x37CA2318, 38092259705106520, 225458697, 225458704, 7, 1440x900 
0x37CA2318, 38092259705766104, 225458762, 225458769, 7, 1440x900 
0x37CA2318, 38092259706427992, 225458830, 225458837, 7, 1440x900 
0x37CA2318, 38092259707093200, 225458896, 225458904, 8, 1440x900 
0x37CA2318, 38092259707747776, 225458962, 225458969, 7, 1440x900 
0x37CA2318, 38092259708426904, 225459033, 225459041, 8, 1440x900 
0x37CA2318, 38092259709072304, 225459097, 225459105, 8, 1440x900 
0x37CA2318, 38092259709739632, 225459162, 225459170, 8, 1440x900 
0x37CA2318, 38092259710391328, 225459229, 225459239, 10, 1440x900 
0x37CA2318, 38092259711047360, 225459294, 225459302, 8, 1440x900 
0x37CA2318, 38092259711705920, 225459358, 225459365, 7, 1440x900 
0x37CA2318, 38092259712366440, 225459423, 225459429, 6, 1440x900 
0x37CA2318, 38092259713026272, 225459488, 225459496, 8, 1440x900 
0x37CA2318, 38092259713686320, 225459553, 225459561, 8, 1440x900 
0x37CA2318, 38092259714346944, 225459619, 225459627, 8, 1440x900 
0x37CA2318, 38092259715006744, 225459687, 225459694, 7, 1440x900 
0x37CA2318, 38092259715666488, 225459752, 225459759, 7, 1440x900 
0x37CA2318, 38092259716341680, 225459823, 225459830, 7, 1440x900 
0x37CA2318, 38092259716990704, 225459887, 225459895, 8, 1440x900 
0x37CA2318, 38092259717650440, 225459953, 225459960, 7, 1440x900 
0x37CA2318, 38092259718313376, 225460018, 225460025, 7, 1440x900 
0x37CA2318, 38092259718972368, 225460083, 225460092, 9, 1440x900 
0x37CA2318, 38092259719633088, 225460147, 225460155, 8, 1440x900 
0x37CA2318, 38092259720292016, 225460217, 225460225, 8, 1440x900 
0x37CA2318, 38092259720951752, 225460282, 225460290, 8, 1440x900 
0x37CA2318, 38092259721613096, 225460352, 225460360, 8, 1440x900 
0x37CA2318, 38092259722274088, 225460416, 225460424, 8, 1440x900 
0x37CA2318, 38092259722943440, 225460482, 225460490, 8, 1440x900 
0x37CA2318, 38092259723607408, 225460547, 225460554, 7, 1440x900 
0x37CA2318, 38092259724263032, 225460612, 225460620, 8, 1440x900 
0x37CA2318, 38092259724923896, 225460681, 225460689, 8, 1440x900 
0x37CA2318, 38092259726247312, 225460812, 225460820, 8, 1440x900 
0x37CA2318, 38092259726904528, 225460877, 225460885, 8, 1440x900 
0x37CA2318, 38092259727565024, 225460943, 225460951, 8, 1440x900 
0x37CA2318, 38092259728225104, 225461009, 225461016, 7, 1440x900 
0x37CA2318, 38092259728882416, 225461073, 225461081, 8, 1440x900 
0x37CA2318, 38092259729545848, 225461143, 225461151, 8, 1440x900 
0x37CA2318, 38092259730209048, 225461209, 225461218, 9, 1440x900 
0x37CA2318, 38092259730868408, 225461274, 225461281, 7, 1440x900 
0x37CA2318, 38092259731527488, 225461338, 225461346, 8, 1440x900 
0x37CA2318, 38092259732200336, 225461408, 225461415, 7, 1440x900 
0x37CA2318, 38092259732856144, 225461472, 225461479, 7, 1440x900 
0x37CA2318, 38092259733722208, 225461558, 225461566, 8, 1440x900 
0x37CA2318, 38092259734266384, 225461618, 225461627, 9, 1440x900 
0x37CA2318, 38092259734841608, 225461672, 225461681, 9, 1440x900 
0x37CA2318, 38092259735498496, 225461737, 225461745, 8, 1440x900 
0x37CA2318, 38092259736157024, 225461802, 225461810, 8, 1440x900 
0x37CA2318, 38092259736821432, 225461868, 225461875, 7, 1440x900 
0x37CA2318, 38092259737484360, 225461933, 225461941, 8, 1440x900 
0x37CA2318, 38092259738140816, 225461998, 225462006, 8, 1440x900 
0x37CA2318, 38092259738800872, 225462066, 225462073, 7, 1440x900 
0x37CA2318, 38092259739462736, 225462132, 225462140, 8, 1440x900 
0x37CA2318, 38092259740129744, 225462202, 225462209, 7, 1440x900 
0x37CA2318, 38092259740786672, 225462268, 225462276, 8, 1440x900 
0x37CA2318, 38092259741519992, 225462342, 225462349, 7, 1440x900 
0x37CA2318, 38092259742108352, 225462399, 225462408, 9, 1440x900 
0x37CA2318, 38092259742768880, 225462464, 225462472, 8, 1440x900 
0x37CA2318, 38092259743428800, 225462532, 225462540, 8, 1440x900 
0x37CA2318, 38092259744186040, 225462608, 225462617, 9, 1440x900 
0x37CA2318, 38092259744751184, 225462662, 225462671, 9, 1440x900 
0x37CA2318, 38092259745418496, 225462728, 225462737, 9, 1440x900 
0x37CA2318, 38092259746072712, 225462797, 225462806, 9, 1440x900 
0x37CA2318, 38092259746731600, 225462862, 225462869, 7, 1440x900 
0x37CA2318, 38092259747463000, 225462937, 225462945, 8, 1440x900 
0x37CA2318, 38092259748051680, 225462993, 225463001, 8, 1440x900 
0x37CA2318, 38092259748722696, 225463062, 225463070, 8, 1440x900 
0x37CA2318, 38092259749373824, 225463128, 225463136, 8, 1440x900 
0x37CA2318, 38092259750032504, 225463193, 225463201, 8, 1440x900 
0x37CA2318, 38092259750692816, 225463257, 225463265, 8, 1440x900 
0x37CA2318, 38092259751353008, 225463324, 225463332, 8, 1440x900 
0x37CA2318, 38092259752012736, 225463392, 225463400, 8, 1440x900 
0x37CA2318, 38092259752674984, 225463453, 225463462, 9, 1440x900 
0x37CA2318, 38092259753337960, 225463523, 225463530, 7, 1440x900 
0x37CA2318, 38092259753992744, 225463588, 225463596, 8, 1440x900 
0x37CA2318, 38092259754854840, 225463678, 225463686, 8, 1440x900 
0x37CA2318, 38092259755461280, 225463732, 225463741, 9, 1440x900 
0x37CA2318, 38092259756067560, 225463847, 225463855, 8, 1440x900 
0x37CA2318, 38092259756814048, 225463874, 225463888, 14, 1440x900 
0x37CA2318, 38092259757562000, 225463942, 225463951, 9, 1440x900 
0x37CA2318, 38092259758077976, 225463992, 225464001, 9, 1440x900 
0x37CA2318, 38092259758739032, 225464058, 225464066, 8, 1440x900 
0x37CA2318, 38092259759394392, 225464126, 225464134, 8, 1440x900 
0x37CA2318, 38092259760054480, 225464193, 225464200, 7, 1440x900 
0x37CA2318, 38092259760716448, 225464257, 225464265, 8, 1440x900 
0x37CA2318, 38092259761376496, 225464323, 225464330, 7, 1440x900 
0x37CA2318, 38092259762034680, 225464391, 225464398, 7, 1440x900 
0x37CA2318, 38092259762695056, 225464453, 225464461, 8, 1440x900 
0x37CA2318, 38092259763547976, 225464541, 225464549, 8, 1440x900 
0x37CA2318, 38092259764020568, 225464588, 225464596, 8, 1440x900 
0x37CA2318, 38092259764677608, 225464653, 225464661, 8, 1440x900 
0x37CA2318, 38092259765340592, 225464721, 225464729, 8, 1440x900 
0x37CA2318, 38092259766002280, 225464787, 225464795, 8, 1440x900 
0x37CA2318, 38092259766857440, 225464872, 225464879, 7, 1440x900 
0x37CA2318, 38092259767322448, 225464918, 225464925, 7, 1440x900 
0x37CA2318, 38092259767980560, 225464983, 225464991, 8, 1440x900 
0x37CA2318, 38092259768832240, 225465068, 225465076, 8, 1440x900 
0x37CA2318, 38092259769303832, 225465117, 225465125, 8, 1440x900 
0x37CA2318, 38092259769966040, 225465182, 225465190, 8, 1440x900 
0x37CA2318, 38092259770673592, 225465252, 225465260, 8, 1440x900 
0x37CA2318, 38092259771283496, 225465313, 225465321, 8, 1440x900 
0x37CA2318, 38092259771944984, 225465381, 225465389, 8, 1440x900 
0x37CA2318, 38092259772807096, 225465475, 225465484, 9, 1440x900 
0x37CA2318, 38092259773523216, 225465545, 225465557, 12, 1440x900 
0x37CA2318, 38092259774081728, 225465604, 225465632, 28, 1440x900 
0x37CA2318, 38092259774627576, 225465650, 225465685, 35, 1440x900 
0x37CA2318, 38092259775371136, 225465722, 225465731, 9, 1440x900 
0x37CA2318, 38092259775989064, 225465792, 225465803, 11, 1440x900 
0x37CA2318, 38092259776601552, 225465847, 225465853, 6, 1440x900 
0x37CA2318, 38092259777377872, 225465922, 225465928, 6, 1440x900 
0x37CA2318, 38092259777900920, 225465977, 225465983, 6, 1440x900 
0x37CA2318, 38092259778560808, 225466042, 225466048, 6, 1440x900 
0x37CA2318, 38092259779421520, 225466128, 225466136, 8, 1440x900 
0x37CA2318, 38092259780025664, 225466194, 225466201, 7, 1440x900 
0x37CA2318, 38092259780543712, 225466241, 225466248, 7, 1440x900 
0x37CA2318, 38092259781393792, 225466327, 225466334, 7, 1440x900 
0x37CA2318, 38092259781941960, 225466382, 225466388, 6, 1440x900 
0x37CA2318, 38092259782725792, 225466461, 225466468, 7, 1440x900 
0x37CA2318, 38092259783377920, 225466527, 225466536, 9, 1440x900 
0x37CA2318, 38092259784057488, 225466591, 225466598, 7, 1440x900 
0x37CA2318, 38092259784728904, 225466658, 225466666, 8, 1440x900 
0x37CA2318, 38092259785193136, 225466706, 225466713, 7, 1440x900 
0x37CA2318, 38092259785858736, 225466772, 225466779, 7, 1440x900 
0x37CA2318, 38092259786516672, 225466837, 225466845, 8, 1440x900 
0x37CA2318, 38092259787175552, 225466907, 225466915, 8, 1440x900 
0x37CA2318, 38092259787941768, 225466983, 225466990, 7, 1440x900 
0x37CA2318, 38092259788506184, 225467037, 225467045, 8, 1440x900 
0x37CA2318, 38092259789171000, 225467102, 225467111, 9, 1440x900 
0x37CA2318, 38092259789835776, 225467169, 225467177, 8, 1440x900 
0x37CA2318, 38092259790691016, 225467256, 225467263, 7, 1440x900 
0x37CA2318, 38092259791341680, 225467321, 225467328, 7, 1440x900 
0x37CA2318, 38092259791993240, 225467388, 225467396, 8, 1440x900 
0x37CA2318, 38092259792673008, 225467453, 225467462, 9, 1440x900 
0x37CA2318, 38092259793125328, 225467498, 225467505, 7, 1440x900 
0x37CA2318, 38092259793978880, 225467583, 225467591, 8, 1440x900 
0x37CA2318, 38092259794642744, 225467651, 225467658, 7, 1440x900 
0x37CA2318, 38092259795298792, 225467717, 225467725, 8, 1440x900 
0x37CA2318, 38092259795963840, 225467783, 225467792, 9, 1440x900 
0x37CA2318, 38092259796626320, 225467854, 225467862, 8, 1440x900 
0x37CA2318, 38092259797286632, 225467917, 225467925, 8, 1440x900 
0x37CA2318, 38092259797940960, 225467978, 225467986, 8, 1440x900 
0x37CA2318, 38092259798465808, 225468039, 225468049, 10, 1440x900 
0x37CA2318, 38092259799164800, 225468101, 225468113, 12, 1440x900 
0x37CA2318, 38092259799797000, 225468163, 225468173, 10, 1440x900 
0x37CA2318, 38092259800494744, 225468240, 225468252, 12, 1440x900 
0x37CA2318, 38092259801114552, 225468298, 225468311, 13, 1440x900 
0x37CA2318, 38092259801780120, 225468363, 225468379, 16, 1440x900 
0x37CA2318, 38092259802463616, 225468433, 225468447, 14, 1440x900 
0x37CA2318, 38092259803114976, 225468498, 225468511, 13, 1440x900 
0x37CA2318, 38092259803787400, 225468563, 225468574, 11, 1440x900 
0x37CA2318, 38092259804450856, 225468632, 225468641, 9, 1440x900 
0x37CA2318, 38092259805057576, 225468692, 225468699, 7, 1440x900 
0x37CA2318, 38092259806380784, 225468823, 225468831, 8, 1440x900 
0x37CA2318, 38092259807046360, 225468892, 225468901, 9, 1440x900 
0x37CA2318, 38092259807704184, 225468957, 225468965, 8, 1440x900 
0x37CA2318, 38092259808414840, 225469028, 225469036, 8, 1440x900 
0x37CA2318, 38092259809038512, 225469092, 225469099, 7, 1440x900 
0x37CA2318, 38092259809700792, 225469158, 225469166, 8, 1440x900 
0x37CA2318, 38092259810378064, 225469228, 225469238, 10, 1440x900 
0x37CA2318, 38092259811003360, 225469287, 225469294, 7, 1440x900 
0x37CA2318, 38092259811875160, 225469373, 225469380, 7, 1440x900 
0x37CA2318, 38092259812529776, 225469438, 225469446, 8, 1440x900 
0x37CA2318, 38092259813189912, 225469503, 225469511, 8, 1440x900 
0x37CA2318, 38092259813847856, 225469572, 225469579, 7, 1440x900 
0x37CA2318, 38092259814509344, 225469637, 225469644, 7, 1440x900 
0x37CA2318, 38092259815178864, 225469703, 225469711, 8, 1440x900 
0x37CA2318, 38092259815830816, 225469773, 225469781, 8, 1440x900 
0x37CA2318, 38092259816490976, 225469838, 225469846, 8, 1440x900 
0x37CA2318, 38092259816966488, 225469883, 225469893, 10, 1440x900 
0x37CA2318, 38092259817626184, 225469948, 225469955, 7, 1440x900 
0x37CA2318, 38092259818277528, 225470012, 225470020, 8, 1440x900 
0x37CA2318, 38092259818940928, 225470078, 225470086, 8, 1440x900 
0x37CA2318, 38092259819598824, 225470143, 225470151, 8, 1440x900 
0x37CA2318, 38092259820260936, 225470212, 225470220, 8, 1440x900 
0x37CA2318, 38092259820981032, 225470289, 225470296, 7, 1440x900 
0x37CA2318, 38092259821585152, 225470347, 225470355, 8, 1440x900 
0x37CA2318, 38092259822243488, 225470412, 225470419, 7, 1440x900 
0x37CA2318, 38092259822902528, 225470477, 225470484, 7, 1440x900 
0x37CA2318, 38092259823566960, 225470542, 225470550, 8, 1440x900 
0x37CA2318, 38092259824223968, 225470608, 225470616, 8, 1440x900 
0x37CA2318, 38092259824883568, 225470673, 225470681, 8, 1440x900 
0x37CA2318, 38092259825545048, 225470739, 225470746, 7, 1440x900 
0x37CA2318, 38092259826205368, 225470808, 225470816, 8, 1440x900 
0x37CA2318, 38092259826859904, 225470873, 225470880, 7, 1440x900 
0x37CA2318, 38092259827520328, 225470938, 225470946, 8, 1440x900 
0x37CA2318, 38092259828181056, 225471004, 225471012, 8, 1440x900 
0x37CA2318, 38092259828841344, 225471068, 225471076, 8, 1440x900 
0x37CA2318, 38092259829690696, 225471153, 225471161, 8, 1440x900 
0x37CA2318, 38092259830257504, 225471212, 225471219, 7, 1440x900 
0x37CA2318, 38092259830852504, 225471272, 225471287, 15, 1440x900 
0x37CA2318, 38092259831509888, 225471338, 225471352, 14, 1440x900 
0x37CA2318, 38092259832181312, 225471403, 225471412, 9, 1440x900 
0x37CA2318, 38092259833035640, 225471495, 225471510, 15, 1440x900 
0x37CA2318, 38092259833530856, 225471549, 225471580, 31, 1440x900 
0x37CA2318, 38092259834397760, 225471626, 225471651, 25, 1440x900 
0x37CA2318, 38092259834823328, 225471667, 225471673, 6, 1440x900 
0x37CA2318, 38092259835488168, 225471733, 225471739, 6, 1440x900 
0x37CA2318, 38092259836314920, 225471817, 225471823, 6, 1440x900 
0x37CA2318, 38092259836981976, 225471883, 225471890, 7, 1440x900 
0x37CA2318, 38092259837601984, 225471952, 225471960, 8, 1440x900 
0x37CA2318, 38092259838136536, 225471997, 225472005, 8, 1440x900 
0x37CA2318, 38092259838770328, 225472063, 225472070, 7, 1440x900 
0x37CA2318, 38092259839432240, 225472128, 225472136, 8, 1440x900 
0x37CA2318, 38092259840092160, 225472197, 225472203, 6, 1440x900 
0x37CA2318, 38092259840754432, 225472263, 225472269, 6, 1440x900 
0x37CA2318, 38092259841411736, 225472328, 225472334, 6, 1440x900 
0x37CA2318, 38092259842084800, 225472397, 225472404, 7, 1440x900 
0x37CA2318, 38092259842750696, 225472462, 225472469, 7, 1440x900 
0x37CA2318, 38092259843409696, 225472528, 225472535, 7, 1440x900 
0x37CA2318, 38092259844068936, 225472592, 225472599, 7, 1440x900 
0x37CA2318, 38092259844826784, 225472674, 225472682, 8, 1440x900 
0x37CA2318, 38092259845391792, 225472727, 225472734, 7, 1440x900 
0x37CA2318, 38092259846050312, 225472792, 225472799, 7, 1440x900 
0x37CA2318, 38092259846710312, 225472861, 225472869, 8, 1440x900 
0x37CA2318, 38092259847371768, 225472928, 225472936, 8, 1440x900 
0x37CA2318, 38092259848031360, 225472992, 225472999, 7, 1440x900 
0x37CA2318, 38092259849026768, 225473088, 225473099, 11, 1440x900 
0x37CA2318, 38092259849564800, 225473152, 225473166, 14, 1440x900 
0x37CA2318, 38092259850154304, 225473208, 225473233, 25, 1440x900 
0x37CA2318, 38092259850786296, 225473263, 225473272, 9, 1440x900 
0x37CA2318, 38092259851378864, 225473323, 225473339, 16, 1440x900 
0x37CA2318, 38092259852043376, 225473388, 225473395, 7, 1440x900 
0x37CA2318, 38092259852871696, 225473473, 225473479, 6, 1440x900 
0x37CA2318, 38092259853541816, 225473538, 225473544, 6, 1440x900 
0x37CA2318, 38092259854202672, 225473606, 225473611, 5, 1440x900 
0x37CA2318, 38092259854863200, 225473672, 225473678, 6, 1440x900 
0x37CA2318, 38092259855532592, 225473738, 225473747, 9, 1440x900 
0x37CA2318, 38092259856185664, 225473807, 225473813, 6, 1440x900 
0x37CA2318, 38092259856817456, 225473867, 225473874, 7, 1440x900 
0x37CA2318, 38092259857308248, 225473918, 225473924, 6, 1440x900 
0x37CA2318, 38092259857968456, 225473982, 225473989, 7, 1440x900 
0x37CA2318, 38092259858628432, 225474048, 225474054, 6, 1440x900 
0x37CA2318, 38092259859289112, 225474117, 225474123, 6, 1440x900 
0x37CA2318, 38092259859950256, 225474178, 225474185, 7, 1440x900 
0x37CA2318, 38092259860608488, 225474247, 225474253, 6, 1440x900 
0x37CA2318, 38092259861268800, 225474313, 225474320, 7, 1440x900 
0x37CA2318, 38092259861946976, 225474378, 225474386, 8, 1440x900 
0x37CA2318, 38092259862642736, 225474452, 225474459, 7, 1440x900 
0x37CA2318, 38092259863392912, 225474528, 225474535, 7, 1440x900 
0x37CA2318, 38092259863933904, 225474578, 225474585, 7, 1440x900 
0x37CA2318, 38092259864591944, 225474643, 225474650, 7, 1440x900 
0x37CA2318, 38092259865295064, 225474716, 225474722, 6, 1440x900 
0x37CA2318, 38092259865916992, 225474778, 225474786, 8, 1440x900 
0x37CA2318, 38092259866587232, 225474847, 225474854, 7, 1440x900 
0x37CA2318, 38092259867317520, 225474923, 225474932, 9, 1440x900 
0x37CA2318, 38092259867955120, 225474987, 225474994, 7, 1440x900 
0x37CA2318, 38092259868571048, 225475043, 225475051, 8, 1440x900 
0x37CA2318, 38092259869231664, 225475107, 225475117, 10, 1440x900 
0x37CA2318, 38092259869919656, 225475184, 225475198, 14, 1440x900 
0x37CA2318, 38092259870581720, 225475243, 225475251, 8, 1440x900 
0x37CA2318, 38092259871208576, 225475307, 225475315, 8, 1440x900 
0x37CA2318, 38092259872561256, 225475442, 225475449, 7, 1440x900 
0x37CA2318, 38092259873191104, 225475503, 225475511, 8, 1440x900 
0x37CA2318, 38092259873860800, 225475572, 225475579, 7, 1440x900 
0x37CA2318, 38092259874521032, 225475638, 225475646, 8, 1440x900 
0x37CA2318, 38092259875177624, 225475703, 225475710, 7, 1440x900 
0x37CA2318, 38092259876036784, 225475788, 225475796, 8, 1440x900 
0x37CA2318, 38092259876501168, 225475839, 225475846, 7, 1440x900 
0x37CA2318, 38092259877159496, 225475902, 225475911, 9, 1440x900 
0x37CA2318, 38092259878047528, 225475992, 225475999, 7, 1440x900 
0x37CA2318, 38092259878486208, 225476033, 225476041, 8, 1440x900 
0x37CA2318, 38092259879151992, 225476102, 225476109, 7, 1440x900 
0x37CA2318, 38092259879828736, 225476168, 225476177, 9, 1440x900 
0x37CA2318, 38092259880475680, 225476232, 225476240, 8, 1440x900 
0x37CA2318, 38092259881129144, 225476301, 225476309, 8, 1440x900 
0x37CA2318, 38092259881793168, 225476368, 225476376, 8, 1440x900 
0x37CA2318, 38092259882491832, 225476436, 225476445, 9, 1440x900 
0x37CA2318, 38092259883110008, 225476497, 225476505, 8, 1440x900 
0x37CA2318, 38092259883814712, 225476573, 225476584, 11, 1440x900 
0x37CA2318, 38092259884469536, 225476633, 225476641, 8, 1440x900 
0x37CA2318, 38092259885093984, 225476693, 225476703, 10, 1440x900 
0x37CA2318, 38092259885753232, 225476763, 225476770, 7, 1440x900 
0x37CA2318, 38092259886413424, 225476832, 225476839, 7, 1440x900 
0x37CA2318, 38092259887102800, 225476897, 225476905, 8, 1440x900 
0x37CA2318, 38092259887727688, 225476958, 225476968, 10, 1440x900 
0x37CA2318, 38092259888392904, 225477024, 225477032, 8, 1440x900 
0x37CA2318, 38092259889160944, 225477101, 225477110, 9, 1440x900 
0x37CA2318, 38092259889712240, 225477157, 225477164, 7, 1440x900 
0x37CA2318, 38092259890367512, 225477222, 225477229, 7, 1440x900 
0x37CA2318, 38092259891027688, 225477288, 225477296, 8, 1440x900 
0x37CA2318, 38092259891694272, 225477356, 225477364, 8, 1440x900 
0x37CA2318, 38092259892384184, 225477427, 225477436, 9, 1440x900 
0x37CA2318, 38092259893031472, 225477492, 225477500, 8, 1440x900 
0x37CA2318, 38092259893812896, 225477573, 225477580, 7, 1440x900 
0x37CA2318, 38092259894337640, 225477618, 225477626, 8, 1440x900 
0x37CA2318, 38092259895213760, 225477710, 225477718, 8, 1440x900 
0x37CA2318, 38092259895657936, 225477753, 225477761, 8, 1440x900 
0x37CA2318, 38092259896316104, 225477818, 225477825, 7, 1440x900 
0x37CA2318, 38092259897325888, 225477935, 225477961, 26, 1440x900 
0x37CA2318, 38092259898035680, 225478051, 225478068, 17, 1440x900 
0x37CA2318, 38092259898824016, 225478069, 225478078, 9, 1440x900 
0x37CA2318, 38092259899425544, 225478127, 225478134, 7, 1440x900 
0x37CA2318, 38092259900083072, 225478193, 225478200, 7, 1440x900 
0x37CA2318, 38092259900747744, 225478258, 225478265, 7, 1440x900 
0x37CA2318, 38092259901407856, 225478327, 225478334, 7, 1440x900 
0x37CA2318, 38092259902197088, 225478403, 225478411, 8, 1440x900 
0x37CA2318, 38092259902724488, 225478457, 225478465, 8, 1440x900 
0x37CA2318, 38092259903385792, 225478524, 225478532, 8, 1440x900 
0x37CA2318, 38092259904052624, 225478592, 225478599, 7, 1440x900 
0x37CA2318, 38092259904706320, 225478657, 225478665, 8, 1440x900 
0x37CA2318, 38092259905368592, 225478724, 225478730, 6, 1440x900 
0x37CA2318, 38092259906038528, 225478788, 225478796, 8, 1440x900 
0x37CA2318, 38092259906698792, 225478859, 225478868, 9, 1440x900 
0x37CA2318, 38092259907355656, 225478923, 225478931, 8, 1440x900 
0x37CA2318, 38092259908013616, 225478988, 225478994, 6, 1440x900 
0x37CA2318, 38092259908743048, 225479070, 225479087, 17, 1440x900 
0x37CA2318, 38092259909346816, 225479122, 225479132, 10, 1440x900 
0x37CA2318, 38092259910001952, 225479188, 225479195, 7, 1440x900 
0x37CA2318, 38092259910658544, 225479250, 225479261, 11, 1440x900 
0x37CA2318, 38092259911320336, 225479324, 225479332, 8, 1440x900 
0x37CA2318, 38092259912020304, 225479387, 225479395, 8, 1440x900 
0x37CA2318, 38092259912675656, 225479453, 225479461, 8, 1440x900 
0x37CA2318, 38092259913298696, 225479517, 225479524, 7, 1440x900 
0x37CA2318, 38092259914161928, 225479602, 225479610, 8, 1440x900 
0x37CA2318, 38092259914621408, 225479651, 225479659, 8, 1440x900 
0x37CA2318, 38092259915282976, 225479717, 225479725, 8, 1440x900 
0x37CA2318, 38092259915947752, 225479783, 225479790, 7, 1440x900 
0x37CA2318, 38092259916608200, 225479848, 225479856, 8, 1440x900 
0x37CA2318, 38092259917268376, 225479913, 225479920, 7, 1440x900 
0x37CA2318, 38092259917929248, 225479981, 225479989, 8, 1440x900 
0x37CA2318, 38092259918593760, 225480049, 225480058, 9, 1440x900 
0x37CA2318, 38092259919249120, 225480112, 225480119, 7, 1440x900 
0x37CA2318, 38092259919919024, 225480178, 225480185, 7, 1440x900 
0x37CA2318, 38092259920580232, 225480242, 225480250, 8, 1440x900 
0x37CA2318, 38092259921243232, 225480311, 225480319, 8, 1440x900 
0x37CA2318, 38092259921903128, 225480376, 225480383, 7, 1440x900 
0x37CA2318, 38092259922559488, 225480441, 225480450, 9, 1440x900 
0x37CA2318, 38092259923269728, 225480519, 225480555, 36, 1440x900 
0x37CA2318, 38092259923967688, 225480583, 225480590, 7, 1440x900 
0x37CA2318, 38092259924609648, 225480646, 225480654, 8, 1440x900 
0x37CA2318, 38092259925226952, 225480708, 225480716, 8, 1440x900 
0x37CA2318, 38092259925896736, 225480777, 225480784, 7, 1440x900 
0x37CA2318, 38092259926570016, 225480848, 225480857, 9, 1440x900 
0x37CA2318, 38092259927222496, 225480912, 225480921, 9, 1440x900 
0x37CA2318, 38092259928024768, 225480993, 225481001, 8, 1440x900 
0x37CA2318, 38092259928539368, 225481042, 225481049, 7, 1440x900 
0x37CA2318, 38092259929205096, 225481113, 225481121, 8, 1440x900 
0x37CA2318, 38092259929865432, 225481172, 225481180, 8, 1440x900 
0x37CA2318, 38092259930524448, 225481242, 225481249, 7, 1440x900 
0x37CA2318, 38092259931184824, 225481307, 225481315, 8, 1440x900 
0x37CA2318, 38092259932035088, 225481390, 225481398, 8, 1440x900 
0x37CA2318, 38092259932704192, 225481458, 225481465, 7, 1440x900 
0x37CA2318, 38092259933300448, 225481519, 225481527, 8, 1440x900 
0x37CA2318, 38092259933837168, 225481572, 225481580, 8, 1440x900 
0x37CA2318, 38092259934533008, 225481638, 225481646, 8, 1440x900 
0x37CA2318, 38092259935159056, 225481702, 225481710, 8, 1440x900 
0x37CA2318, 38092259935844704, 225481769, 225481778, 9, 1440x900 
0x37CA2318, 38092259936477352, 225481832, 225481840, 8, 1440x900 
0x37CA2318, 38092259937140632, 225481900, 225481913, 13, 1440x900 
0x37CA2318, 38092259937828064, 225481970, 225481978, 8, 1440x900 
0x37CA2318, 38092259938464080, 225482033, 225482040, 7, 1440x900 
0x37CA2318, 38092259939117368, 225482097, 225482104, 7, 1440x900 
0x37CA2318, 38092259939780880, 225482166, 225482174, 8, 1440x900 
0x37CA2318, 38092259940446296, 225482233, 225482242, 9, 1440x900 
0x37CA2318, 38092259941106960, 225482304, 225482314, 10, 1440x900 
0x37CA2318, 38092259941763640, 225482362, 225482370, 8, 1440x900 
0x37CA2318, 38092259942431728, 225482428, 225482437, 9, 1440x900 
0x37CA2318, 38092259943085080, 225482493, 225482501, 8, 1440x900 
0x37CA2318, 38092259943744896, 225482561, 225482569, 8, 1440x900 
0x37CA2318, 38092259944412592, 225482627, 225482635, 8, 1440x900 
0x37CA2318, 38092259945100456, 225482693, 225482701, 8, 1440x900 
0x37CA2318, 38092259945922712, 225482777, 225482785, 8, 1440x900 
0x37CA2318, 38092259946387888, 225482823, 225482833, 10, 1440x900 
0x37CA2318, 38092259947044400, 225482889, 225482896, 7, 1440x900 
0x37CA2318, 38092259947713528, 225482957, 225482965, 8, 1440x900 
0x37CA2318, 38092259948372064, 225483023, 225483032, 9, 1440x900 
0x37CA2318, 38092259949047360, 225483093, 225483102, 9, 1440x900 
0x37CA2318, 38092259949708904, 225483158, 225483166, 8, 1440x900 
0x37CA2318, 38092259950359752, 225483222, 225483230, 8, 1440x900 
0x37CA2318, 38092259951080912, 225483299, 225483309, 10, 1440x900 
0x37CA2318, 38092259951698560, 225483363, 225483371, 8, 1440x900 
0x37CA2318, 38092259952372456, 225483423, 225483430, 7, 1440x900 
0x37CA2318, 38092259952999896, 225483487, 225483495, 8, 1440x900 
0x37CA2318, 38092259953659528, 225483553, 225483561, 8, 1440x900 
0x37CA2318, 38092259954325800, 225483618, 225483627, 9, 1440x900 
0x37CA2318, 38092259954990248, 225483697, 225483706, 9, 1440x900 
0x37CA2318, 38092259955645128, 225483752, 225483760, 8, 1440x900 
0x37CA2318, 38092259956312848, 225483818, 225483825, 7, 1440x900 
0x37CA2318, 38092259956975488, 225483882, 225483892, 10, 1440x900 
0x37CA2318, 38092259957638248, 225483948, 225483960, 12, 1440x900 
0x37CA2318, 38092259958298184, 225484013, 225484021, 8, 1440x900 
0x37CA2318, 38092259958958208, 225484082, 225484090, 8, 1440x900 
0x37CA2318, 38092259959647888, 225484148, 225484157, 9, 1440x900 
0x37CA2318, 38092259960360000, 225484222, 225484229, 7, 1440x900 
0x37CA2318, 38092259961092400, 225484295, 225484307, 12, 1440x900 
0x37CA2318, 38092259961811704, 225484367, 225484375, 8, 1440x900 
0x37CA2318, 38092259962417968, 225484430, 225484448, 18, 1440x900 
0x37CA2318, 38092259963037744, 225484488, 225484497, 9, 1440x900 
0x37CA2318, 38092259963654768, 225484552, 225484560, 8, 1440x900 
0x37CA2318, 38092259964326688, 225484622, 225484630, 8, 1440x900 
0x37CA2318, 38092259964979552, 225484687, 225484696, 9, 1440x900 
0x37CA2318, 38092259965833688, 225484773, 225484781, 8, 1440x900 
0x37CA2318, 38092259966298880, 225484817, 225484827, 10, 1440x900 
0x37CA2318, 38092259966958840, 225484888, 225484897, 9, 1440x900 
0x37CA2318, 38092259967661304, 225484959, 225484967, 8, 1440x900 
0x37CA2318, 38092259968289880, 225485018, 225485026, 8, 1440x900 
0x37CA2318, 38092259968954176, 225485083, 225485092, 9, 1440x900 
0x37CA2318, 38092259969947112, 225485179, 225485190, 11, 1440x900 
0x37CA2318, 38092259970368592, 225485223, 225485236, 13, 1440x900 
0x37CA2318, 38092259970972656, 225485283, 225485290, 7, 1440x900 
0x37CA2318, 38092259971630904, 225485348, 225485356, 8, 1440x900 
0x37CA2318, 38092259972393184, 225485424, 225485432, 8, 1440x900 
0x37CA2318, 38092259972946232, 225485479, 225485487, 8, 1440x900 
0x37CA2318, 38092259973777000, 225485562, 225485570, 8, 1440x900 
0x37CA2318, 38092259974267168, 225485612, 225485620, 8, 1440x900 
0x37CA2318, 38092259974929328, 225485677, 225485685, 8, 1440x900 
0x37CA2318, 38092259975608880, 225485748, 225485756, 8, 1440x900 
0x37CA2318, 38092259976282296, 225485816, 225485824, 8, 1440x900 
0x37CA2318, 38092259976911920, 225485877, 225485884, 7, 1440x900 
0x37CA2318, 38092259977572224, 225485943, 225485951, 8, 1440x900 
0x37CA2318, 38092259978240160, 225486008, 225486016, 8, 1440x900 
0x37CA2318, 38092259979116304, 225486098, 225486106, 8, 1440x900 
0x37CA2318, 38092259979743840, 225486161, 225486168, 7, 1440x900 
0x37CA2318, 38092259980222352, 225486208, 225486215, 7, 1440x900 
0x37CA2318, 38092259980877376, 225486273, 225486280, 7, 1440x900 
0x37CA2318, 38092259981540056, 225486338, 225486346, 8, 1440x900 
0x37CA2318, 38092259982203048, 225486406, 225486414, 8, 1440x900 
0x37CA2318, 38092259983066488, 225486498, 225486506, 8, 1440x900 
0x37CA2318, 38092259983723384, 225486563, 225486571, 8, 1440x900 
0x37CA2318, 38092259984391024, 225486623, 225486631, 8, 1440x900 
0x37CA2318, 38092259985054416, 225486693, 225486702, 9, 1440x900 
0x37CA2318, 38092259985698656, 225486757, 225486766, 9, 1440x900 
0x37CA2318, 38092259986366160, 225486823, 225486832, 9, 1440x900 
0x37CA2318, 38092259987031632, 225486892, 225486900, 8, 1440x900 
0x37CA2318, 38092259987688192, 225486959, 225486969, 10, 1440x900 
0x37CA2318, 38092259988341752, 225487023, 225487030, 7, 1440x900 
0x37CA2318, 38092259988942256, 225487078, 225487087, 9, 1440x900 
0x37CA2318, 38092259990140632, 225487198, 225487207, 9, 1440x900 
0x37CA2318, 38092259990990792, 225487286, 225487295, 9, 1440x900 
0x37CA2318, 38092259991729456, 225487362, 225487372, 10, 1440x900 
0x37CA2318, 38092259992304744, 225487419, 225487430, 11, 1440x900 
0x37CA2318, 38092259992787184, 225487467, 225487474, 7, 1440x900 
0x37CA2318, 38092259993445888, 225487532, 225487539, 7, 1440x900 
0x37CA2318, 38092259994113648, 225487603, 225487611, 8, 1440x900 
0x37CA2318, 38092259994772032, 225487662, 225487670, 8, 1440x900 
0x37CA2318, 38092259995435024, 225487732, 225487739, 7, 1440x900 
0x37CA2318, 38092259996091792, 225487793, 225487801, 8, 1440x900 
0x37CA2318, 38092259996755104, 225487862, 225487869, 7, 1440x900 
0x37CA2318, 38092259997416208, 225487928, 225487936, 8, 1440x900 
0x37CA2318, 38092259998073840, 225487993, 225488001, 8, 1440x900 
0x37CA2318, 38092259998736512, 225488058, 225488067, 9, 1440x900 
0x37CA2318, 38092259999395168, 225488127, 225488134, 7, 1440x900 
0x37CA2318, 38092260000186400, 225488203, 225488213, 10, 1440x900 
0x37CA2318, 38092260000752232, 225488262, 225488270, 8, 1440x900 
0x37CA2318, 38092260001383720, 225488325, 225488336, 11, 1440x900 
0x37CA2318, 38092260002081024, 225488393, 225488401, 8, 1440x900 
0x37CA2318, 38092260002698272, 225488457, 225488464, 7, 1440x900 
0x37CA2318, 38092260003367136, 225488522, 225488529, 7, 1440x900 
0x37CA2318, 38092260004027432, 225488587, 225488595, 8, 1440x900 
0x37CA2318, 38092260004699728, 225488656, 225488663, 7, 1440x900 
0x37CA2318, 38092260005356680, 225488721, 225488729, 8, 1440x900 
0x37CA2318, 38092260006017352, 225488788, 225488795, 7, 1440x900 
0x37CA2318, 38092260006676696, 225488853, 225488860, 7, 1440x900 
0x37CA2318, 38092260007378424, 225488923, 225488931, 8, 1440x900 
0x37CA2318, 38092260008145184, 225489000, 225489012, 12, 1440x900 
0x37CA2318, 38092260008704384, 225489058, 225489065, 7, 1440x900 
0x37CA2318, 38092260009362976, 225489122, 225489129, 7, 1440x900 
0x37CA2318, 38092260010023096, 225489187, 225489195, 8, 1440x900 
0x37CA2318, 38092260010683680, 225489252, 225489260, 8, 1440x900 
0x37CA2318, 38092260011343656, 225489322, 225489329, 7, 1440x900 
0x37CA2318, 38092260012004832, 225489387, 225489394, 7, 1440x900 
0x37CA2318, 38092260012669408, 225489453, 225489461, 8, 1440x900 
0x37CA2318, 38092260013329632, 225489518, 225489526, 8, 1440x900 
0x37CA2318, 38092260013990064, 225489583, 225489590, 7, 1440x900 
0x37CA2318, 38092260014660840, 225489653, 225489660, 7, 1440x900 
0x37CA2318, 38092260015320464, 225489717, 225489724, 7, 1440x900 
0x37CA2318, 38092260015989088, 225489787, 225489796, 9, 1440x900 
0x37CA2318, 38092260016670208, 225489854, 225489861, 7, 1440x900 
0x37CA2318, 38092260017302880, 225489918, 225489924, 6, 1440x900 
0x37CA2318, 38092260017969672, 225489982, 225489989, 7, 1440x900 
0x37CA2318, 38092260018627032, 225490048, 225490055, 7, 1440x900 
0x37CA2318, 38092260019289688, 225490113, 225490121, 8, 1440x900 
0x37CA2318, 38092260019947952, 225490179, 225490187, 8, 1440x900 
0x37CA2318, 38092260020611864, 225490254, 225490261, 7, 1440x900 
0x37CA2318, 38092260021276656, 225490318, 225490327, 9, 1440x900 
0x37CA2318, 38092260021930000, 225490378, 225490386, 8, 1440x900 
0x37CA2318, 38092260022591592, 225490444, 225490452, 8, 1440x900 
0x37CA2318, 38092260023254704, 225490509, 225490517, 8, 1440x900 
0x37CA2318, 38092260023915112, 225490578, 225490585, 7, 1440x900 
0x37CA2318, 38092260024634464, 225490650, 225490677, 27, 1440x900 
0x37CA2318, 38092260025267672, 225490713, 225490720, 7, 1440x900 
0x37CA2318, 38092260025941312, 225490782, 225490789, 7, 1440x900 
0x37CA2318, 38092260026746784, 225490861, 225490870, 9, 1440x900 
0x37CA2318, 38092260027222896, 225490908, 225490915, 7, 1440x900 
0x37CA2318, 38092260027885768, 225490977, 225490984, 7, 1440x900 
0x37CA2318, 38092260028553272, 225491042, 225491049, 7, 1440x900 
0x37CA2318, 38092260029397040, 225491127, 225491135, 8, 1440x900 
0x37CA2318, 38092260030069160, 225491193, 225491200, 7, 1440x900 
0x37CA2318, 38092260030730320, 225491258, 225491266, 8, 1440x900 
0x37CA2318, 38092260031392632, 225491327, 225491335, 8, 1440x900 
0x37CA2318, 38092260032044256, 225491393, 225491401, 8, 1440x900 
0x37CA2318, 38092260032721552, 225491463, 225491471, 8, 1440x900 
0x37CA2318, 38092260033382008, 225491528, 225491536, 8, 1440x900 
0x37CA2318, 38092260034033664, 225491593, 225491601, 8, 1440x900 
0x37CA2318, 38092260034702520, 225491658, 225491666, 8, 1440x900 
0x37CA2318, 38092260035362192, 225491722, 225491731, 9, 1440x900 
0x37CA2318, 38092260036022808, 225491793, 225491801, 8, 1440x900 
0x37CA2318, 38092260036673424, 225491853, 225491860, 7, 1440x900 
0x37CA2318, 38092260037335600, 225491923, 225491931, 8, 1440x900 
0x37CA2318, 38092260038014352, 225491988, 225491996, 8, 1440x900 
0x37CA2318, 38092260038667056, 225492058, 225492066, 8, 1440x900 
0x37CA2318, 38092260039262328, 225492118, 225492126, 8, 1440x900 
0x37CA2318, 38092260039799072, 225492167, 225492175, 8, 1440x900 
0x37CA2318, 38092260040462992, 225492234, 225492241, 7, 1440x900 
0x37CA2318, 38092260041126080, 225492302, 225492310, 8, 1440x900 
0x37CA2318, 38092260041788616, 225492368, 225492376, 8, 1440x900 
0x37CA2318, 38092260042444016, 225492433, 225492440, 7, 1440x900 
0x37CA2318, 38092260043110480, 225492497, 225492504, 7, 1440x900 
0x37CA2318, 38092260043770736, 225492563, 225492570, 7, 1440x900 
0x37CA2318, 38092260044427432, 225492628, 225492636, 8, 1440x900 
0x37CA2318, 38092260045105560, 225492697, 225492705, 8, 1440x900 
0x37CA2318, 38092260045746536, 225492761, 225492769, 8, 1440x900 
0x37CA2318, 38092260046622504, 225492853, 225492861, 8, 1440x900 
0x37CA2318, 38092260047290832, 225492916, 225492923, 7, 1440x900 
0x37CA2318, 38092260047952304, 225492979, 225492987, 8, 1440x900 
0x37CA2318, 38092260048603760, 225493050, 225493058, 8, 1440x900 
0x37CA2318, 38092260049084512, 225493098, 225493106, 8, 1440x900 
0x37CA2318, 38092260049926840, 225493182, 225493190, 8, 1440x900 
0x37CA2318, 38092260050583280, 225493247, 225493256, 9, 1440x900 
0x37CA2318, 38092260051237728, 225493313, 225493321, 8, 1440x900 
0x37CA2318, 38092260051909144, 225493378, 225493387, 9, 1440x900 
0x37CA2318, 38092260052570008, 225493443, 225493452, 9, 1440x900 
0x37CA2318, 38092260053228944, 225493513, 225493521, 8, 1440x900 
0x37CA2318, 38092260054359456, 225493627, 225493635, 8, 1440x900 
0x37CA2318, 38092260055191048, 225493707, 225493716, 9, 1440x900 
0x37CA2318, 38092260055688144, 225493757, 225493765, 8, 1440x900 
0x37CA2318, 38092260056344768, 225493823, 225493832, 9, 1440x900 
0x37CA2318, 38092260057001368, 225493888, 225493895, 7, 1440x900 
0x37CA2318, 38092260057657680, 225493953, 225493960, 7, 1440x900 
0x37CA2318, 38092260058508560, 225494037, 225494044, 7, 1440x900 
0x37CA2318, 38092260058980208, 225494083, 225494091, 8, 1440x900 
0x37CA2318, 38092260059674000, 225494159, 225494166, 7, 1440x900 
0x37CA2318, 38092260060495872, 225494234, 225494242, 8, 1440x900 
0x37CA2318, 38092260060995928, 225494287, 225494294, 7, 1440x900 
0x37CA2318, 38092260061628704, 225494347, 225494355, 8, 1440x900 
0x37CA2318, 38092260062314240, 225494417, 225494425, 8, 1440x900 
0x37CA2318, 38092260062986048, 225494486, 225494493, 7, 1440x900 
0x37CA2318, 38092260063613040, 225494547, 225494555, 8, 1440x900 
0x37CA2318, 38092260064461152, 225494633, 225494642, 9, 1440x900 
0x37CA2318, 38092260065124096, 225494703, 225494711, 8, 1440x900 
0x37CA2318, 38092260065790632, 225494768, 225494777, 9, 1440x900 
0x37CA2318, 38092260066457856, 225494833, 225494841, 8, 1440x900 
0x37CA2318, 38092260067057024, 225494894, 225494902, 8, 1440x900 
0x37CA2318, 38092260067795376, 225494968, 225494979, 11, 1440x900 
0x37CA2318, 38092260068445440, 225495033, 225495040, 7, 1440x900 
0x37CA2318, 38092260069106704, 225495102, 225495109, 7, 1440x900 
0x37CA2318, 38092260069767648, 225495163, 225495172, 9, 1440x900 
0x37CA2318, 38092260070437176, 225495233, 225495240, 7, 1440x900 
0x37CA2318, 38092260071096208, 225495298, 225495305, 7, 1440x900 
0x37CA2318, 38092260071748152, 225495368, 225495376, 8, 1440x900 
0x37CA2318, 38092260072223184, 225495413, 225495421, 8, 1440x900 
0x37CA2318, 38092260073068464, 225495493, 225495502, 9, 1440x900 
0x37CA2318, 38092260073736960, 225495559, 225495569, 10, 1440x900 
0x37CA2318, 38092260074242176, 225495613, 225495622, 9, 1440x900 
0x37CA2318, 38092260074986848, 225495687, 225495696, 9, 1440x900 
0x37CA2318, 38092260075555368, 225495742, 225495750, 8, 1440x900 
0x37CA2318, 38092260076316952, 225495821, 225495854, 33, 1440x900 
0x37CA2318, 38092260076927344, 225495895, 225495921, 26, 1440x900 
0x37CA2318, 38092260077576544, 225495949, 225495969, 20, 1440x900 
0x37CA2318, 38092260078308152, 225496020, 225496035, 15, 1440x900 
0x37CA2318, 38092260078906168, 225496083, 225496091, 8, 1440x900 
0x37CA2318, 38092260079522848, 225496138, 225496145, 7, 1440x900 
0x37CA2318, 38092260080181880, 225496202, 225496211, 9, 1440x900 
0x37CA2318, 38092260080849792, 225496272, 225496280, 8, 1440x900 
0x37CA2318, 38092260081506560, 225496339, 225496347, 8, 1440x900 
0x37CA2318, 38092260082168912, 225496403, 225496413, 10, 1440x900 
0x37CA2318, 38092260082824520, 225496468, 225496476, 8, 1440x900 
0x37CA2318, 38092260083525072, 225496538, 225496548, 10, 1440x900 
0x37CA2318, 38092260084189632, 225496609, 225496620, 11, 1440x900 
0x37CA2318, 38092260084819280, 225496674, 225496684, 10, 1440x900 
0x37CA2318, 38092260085642296, 225496748, 225496757, 9, 1440x900 
0x37CA2318, 38092260086302328, 225496818, 225496825, 7, 1440x900 
0x37CA2318, 38092260086767776, 225496862, 225496869, 7, 1440x900 
0x37CA2318, 38092260087428208, 225496928, 225496935, 7, 1440x900 
0x37CA2318, 38092260088088112, 225496993, 225497000, 7, 1440x900 
0x37CA2318, 38092260088753912, 225497062, 225497069, 7, 1440x900 
0x37CA2318, 38092260089603976, 225497148, 225497156, 8, 1440x900 
0x37CA2318, 38092260090274992, 225497213, 225497222, 9, 1440x900 
0x37CA2318, 38092260090924712, 225497283, 225497290, 7, 1440x900 
0x37CA2318, 38092260091584864, 225497349, 225497356, 7, 1440x900 
0x37CA2318, 38092260092243120, 225497408, 225497416, 8, 1440x900 
0x37CA2318, 38092260092903496, 225497477, 225497483, 6, 1440x900 
0x37CA2318, 38092260093537040, 225497541, 225497547, 6, 1440x900 
0x37CA2318, 38092260094027984, 225497588, 225497594, 6, 1440x900 
0x37CA2318, 38092260094697576, 225497656, 225497662, 6, 1440x900 
0x37CA2318, 38092260095368256, 225497726, 225497733, 7, 1440x900 
0x37CA2318, 38092260096033008, 225497793, 225497799, 6, 1440x900 
0x37CA2318, 38092260096688744, 225497858, 225497865, 7, 1440x900 
0x37CA2318, 38092260097442408, 225497930, 225497938, 8, 1440x900 
0x37CA2318, 38092260098100344, 225497997, 225498003, 6, 1440x900 
0x37CA2318, 38092260098756480, 225498063, 225498069, 6, 1440x900 
0x37CA2318, 38092260099421216, 225498128, 225498135, 7, 1440x900 
0x37CA2318, 38092260100076480, 225498192, 225498199, 7, 1440x900 
0x37CA2318, 38092260100935912, 225498281, 225498288, 7, 1440x900 
0x37CA2318, 38092260101408944, 225498333, 225498341, 8, 1440x900 
0x37CA2318, 38092260102068512, 225498398, 225498406, 8, 1440x900 
0x37CA2318, 38092260102917280, 225498482, 225498490, 8, 1440x900 
0x37CA2318, 38092260103579392, 225498548, 225498555, 7, 1440x900 
0x37CA2318, 38092260104243536, 225498612, 225498620, 8, 1440x900 
0x37CA2318, 38092260104894200, 225498677, 225498685, 8, 1440x900 
0x37CA2318, 38092260105559792, 225498743, 225498751, 8, 1440x900 
0x37CA2318, 38092260106220640, 225498808, 225498816, 8, 1440x900 
0x37CA2318, 38092260106900192, 225498878, 225498886, 8, 1440x900 
0x37CA2318, 38092260107424992, 225498927, 225498934, 7, 1440x900 
0x37CA2318, 38092260108226816, 225499008, 225499015, 7, 1440x900 
0x37CA2318, 38092260108684832, 225499054, 225499072, 18, 1440x900 
0x37CA2318, 38092260109378960, 225499123, 225499130, 7, 1440x900 
0x37CA2318, 38092260110005888, 225499187, 225499194, 7, 1440x900 
0x37CA2318, 38092260110683344, 225499260, 225499269, 9, 1440x900 
0x37CA2318, 38092260111330288, 225499318, 225499326, 8, 1440x900 
0x37CA2318, 38092260111995168, 225499387, 225499395, 8, 1440x900 
0x37CA2318, 38092260112731888, 225499466, 225499478, 12, 1440x900 
0x37CA2318, 38092260113488384, 225499540, 225499563, 23, 1440x900 
0x37CA2318, 38092260114135480, 225499603, 225499623, 20, 1440x900 
0x37CA2318, 38092260114796720, 225499676, 225499691, 15, 1440x900 
0x37CA2318, 38092260115498520, 225499738, 225499747, 9, 1440x900 
0x37CA2318, 38092260116069616, 225499805, 225499813, 8, 1440x900 
0x37CA2318, 38092260116723280, 225499858, 225499865, 7, 1440x900 
0x37CA2318, 38092260117411760, 225499928, 225499936, 8, 1440x900 
0x37CA2318, 38092260118050296, 225499995, 225500007, 12, 1440x900 
0x37CA2318, 38092260118724928, 225500057, 225500065, 8, 1440x900 
0x37CA2318, 38092260119364064, 225500123, 225500132, 9, 1440x900 
0x37CA2318, 38092260120030096, 225500188, 225500206, 18, 1440x900 
0x37CA2318, 38092260120692112, 225500254, 225500263, 9, 1440x900 
0x37CA2318, 38092260121324056, 225500318, 225500327, 9, 1440x900 
0x37CA2318, 38092260121992872, 225500384, 225500392, 8, 1440x900 
0x37CA2318, 38092260122801136, 225500472, 225500481, 9, 1440x900 
0x37CA2318, 38092260123339648, 225500519, 225500537, 18, 1440x900 
0x37CA2318, 38092260124000456, 225500584, 225500592, 8, 1440x900 
0x37CA2318, 38092260124635560, 225500648, 225500655, 7, 1440x900 
0x37CA2318, 38092260125298392, 225500719, 225500726, 7, 1440x900 
0x37CA2318, 38092260125957160, 225500782, 225500789, 7, 1440x900 
0x37CA2318, 38092260126617256, 225500848, 225500855, 7, 1440x900 
0x37CA2318, 38092260127277208, 225500913, 225500921, 8, 1440x900 
0x37CA2318, 38092260127943008, 225500983, 225500992, 9, 1440x900 
0x37CA2318, 38092260128610800, 225501047, 225501054, 7, 1440x900 
0x37CA2318, 38092260129275048, 225501112, 225501120, 8, 1440x900 
0x37CA2318, 38092260129921104, 225501178, 225501187, 9, 1440x900 
0x37CA2318, 38092260130600720, 225501254, 225501262, 8, 1440x900 
0x37CA2318, 38092260131445392, 225501334, 225501342, 8, 1440x900 
0x37CA2318, 38092260132110056, 225501403, 225501411, 8, 1440x900 
0x37CA2318, 38092260132771016, 225501464, 225501473, 9, 1440x900 
0x37CA2318, 38092260133468256, 225501539, 225501547, 8, 1440x900 
0x37CA2318, 38092260134099376, 225501598, 225501606, 8, 1440x900 
0x37CA2318, 38092260134760728, 225501663, 225501671, 8, 1440x900 
0x37CA2318, 38092260135420840, 225501729, 225501737, 8, 1440x900 
0x37CA2318, 38092260136081592, 225501799, 225501808, 9, 1440x900 
0x37CA2318, 38092260136560600, 225501842, 225501850, 8, 1440x900 
0x37CA2318, 38092260137405736, 225501927, 225501935, 8, 1440x900 
0x37CA2318, 38092260137964184, 225501982, 225501989, 7, 1440x900 
0x37CA2318, 38092260138728256, 225502062, 225502069, 7, 1440x900 
0x37CA2318, 38092260139203136, 225502106, 225502113, 7, 1440x900 
0x37CA2318, 38092260140059688, 225502197, 225502205, 8, 1440x900 
0x37CA2318, 38092260140714448, 225502263, 225502271, 8, 1440x900 
0x37CA2318, 38092260141191280, 225502306, 225502314, 8, 1440x900 
0x37CA2318, 38092260142033728, 225502389, 225502397, 8, 1440x900 
0x37CA2318, 38092260142623304, 225502447, 225502456, 9, 1440x900 
0x37CA2318, 38092260143354736, 225502522, 225502530, 8, 1440x900 
0x37CA2318, 38092260144666648, 225502653, 225502660, 7, 1440x900 
0x37CA2318, 38092260145338728, 225502723, 225502731, 8, 1440x900 
0x37CA2318, 38092260146007480, 225502792, 225502800, 8, 1440x900 
0x37CA2318, 38092260146667096, 225502857, 225502865, 8, 1440x900 
0x37CA2318, 38092260147317952, 225502922, 225502930, 8, 1440x900 
0x37CA2318, 38092260147986928, 225502988, 225502996, 8, 1440x900 
0x37CA2318, 38092260148637008, 225503053, 225503061, 8, 1440x900 
0x37CA2318, 38092260149123728, 225503102, 225503110, 8, 1440x900 
0x37CA2318, 38092260149959136, 225503182, 225503189, 7, 1440x900 
0x37CA2318, 38092260150422480, 225503231, 225503238, 7, 1440x900 
0x37CA2318, 38092260151096672, 225503297, 225503304, 7, 1440x900 
0x37CA2318, 38092260151740592, 225503359, 225503367, 8, 1440x900 
0x37CA2318, 38092260152400592, 225503435, 225503446, 11, 1440x900 
0x37CA2318, 38092260153104544, 225503497, 225503503, 6, 1440x900 
0x37CA2318, 38092260153729504, 225503558, 225503566, 8, 1440x900 
0x37CA2318, 38092260154389744, 225503625, 225503644, 19, 1440x900 
0x37CA2318, 38092260155080160, 225503695, 225503703, 8, 1440x900 
0x37CA2318, 38092260155741576, 225503759, 225503768, 9, 1440x900 
0x37CA2318, 38092260156374552, 225503824, 225503833, 9, 1440x900 
0x37CA2318, 38092260157044624, 225503893, 225503900, 7, 1440x900 
0x37CA2318, 38092260157705416, 225503958, 225503967, 9, 1440x900 
0x37CA2318, 38092260158365832, 225504028, 225504035, 7, 1440x900 
0x37CA2318, 38092260159020064, 225504089, 225504098, 9, 1440x900 
0x37CA2318, 38092260159695792, 225504159, 225504167, 8, 1440x900 
0x37CA2318, 38092260160343280, 225504223, 225504231, 8, 1440x900 
0x37CA2318, 38092260161003968, 225504287, 225504294, 7, 1440x900 
0x37CA2318, 38092260161670816, 225504357, 225504367, 10, 1440x900 
0x37CA2318, 38092260162327344, 225504421, 225504430, 9, 1440x900 
0x37CA2318, 38092260162986784, 225504483, 225504492, 9, 1440x900 
0x37CA2318, 38092260163650888, 225504552, 225504560, 8, 1440x900 
0x37CA2318, 38092260164312264, 225504618, 225504626, 8, 1440x900 
0x37CA2318, 38092260164990072, 225504687, 225504695, 8, 1440x900 
0x37CA2318, 38092260165638944, 225504753, 225504760, 7, 1440x900 
0x37CA2318, 38092260166296112, 225504817, 225504825, 8, 1440x900 
0x37CA2318, 38092260166956080, 225504882, 225504890, 8, 1440x900 
0x37CA2318, 38092260167628376, 225504953, 225504961, 8, 1440x900 
0x37CA2318, 38092260168281136, 225505013, 225505021, 8, 1440x900 
0x37CA2318, 38092260168941744, 225505082, 225505089, 7, 1440x900 
0x37CA2318, 38092260169601832, 225505145, 225505153, 8, 1440x900 
0x37CA2318, 38092260170273128, 225505212, 225505220, 8, 1440x900 
0x37CA2318, 38092260170929304, 225505283, 225505292, 9, 1440x900 
0x37CA2318, 38092260171583896, 225505343, 225505362, 19, 1440x900 
0x37CA2318, 38092260172313952, 225505417, 225505424, 7, 1440x900 
0x37CA2318, 38092260173000384, 225505487, 225505519, 32, 1440x900 
0x37CA2318, 38092260173793784, 225505568, 225505577, 9, 1440x900 
0x37CA2318, 38092260174505680, 225505639, 225505649, 10, 1440x900 
0x37CA2318, 38092260174963664, 225505683, 225505690, 7, 1440x900 
0x37CA2318, 38092260175588800, 225505743, 225505751, 8, 1440x900 
0x37CA2318, 38092260176247744, 225505811, 225505821, 10, 1440x900 
0x37CA2318, 38092260176916184, 225505877, 225505886, 9, 1440x900 
0x37CA2318, 38092260177603080, 225505947, 225505954, 7, 1440x900 
0x37CA2318, 38092260178242576, 225506013, 225506021, 8, 1440x900 
0x37CA2318, 38092260178907224, 225506078, 225506087, 9, 1440x900 
0x37CA2318, 38092260179610848, 225506147, 225506159, 12, 1440x900 
0x37CA2318, 38092260180270152, 225506213, 225506222, 9, 1440x900 
0x37CA2318, 38092260180897344, 225506277, 225506284, 7, 1440x900 
0x37CA2318, 38092260181555608, 225506342, 225506352, 10, 1440x900 
0x37CA2318, 38092260188173408, 225507008, 225507017, 9, 1440x900 
0x37CA2318, 38092260188835288, 225507072, 225507080, 8, 1440x900 
0x37CA2318, 38092260189494936, 225507137, 225507145, 8, 1440x900 
0x37CA2318, 38092260190165480, 225507204, 225507212, 8, 1440x900 
0x37CA2318, 38092260190830344, 225507272, 225507281, 9, 1440x900 
0x37CA2318, 38092260191481184, 225507338, 225507347, 9, 1440x900 
0x37CA2318, 38092260192140448, 225507402, 225507410, 8, 1440x900 
0x37CA2318, 38092260192994216, 225507487, 225507496, 9, 1440x900 
0x37CA2318, 38092260193466680, 225507537, 225507545, 8, 1440x900 
0x37CA2318, 38092260194137616, 225507603, 225507611, 8, 1440x900 
0x37CA2318, 38092260194788128, 225507669, 225507678, 9, 1440x900 
0x37CA2318, 38092260195475072, 225507737, 225507745, 8, 1440x900 
0x37CA2318, 38092260196113344, 225507798, 225507806, 8, 1440x900 
0x37CA2318, 38092260196781096, 225507864, 225507873, 9, 1440x900 
0x37CA2318, 38092260197428576, 225507929, 225507938, 9, 1440x900 
0x37CA2318, 38092260198093544, 225507997, 225508005, 8, 1440x900 
0x37CA2318, 38092260198749568, 225508062, 225508070, 8, 1440x900 
0x37CA2318, 38092260199604784, 225508152, 225508161, 9, 1440x900 
0x37CA2318, 38092260200079328, 225508198, 225508206, 8, 1440x900 
0x37CA2318, 38092260200933328, 225508302, 225508313, 11, 1440x900 
0x37CA2318, 38092260201585776, 225508351, 225508358, 7, 1440x900 
0x37CA2318, 38092260202199752, 225508405, 225508415, 10, 1440x900 
0x37CA2318, 38092260202773112, 225508465, 225508473, 8, 1440x900 
0x37CA2318, 38092260203406384, 225508527, 225508534, 7, 1440x900 
0x37CA2318, 38092260204126448, 225508598, 225508606, 8, 1440x900 
0x37CA2318, 38092260204755592, 225508661, 225508669, 8, 1440x900 
0x37CA2318, 38092260205381136, 225508723, 225508731, 8, 1440x900 
0x37CA2318, 38092260206043320, 225508791, 225508799, 8, 1440x900 
0x37CA2318, 38092260206717840, 225508857, 225508865, 8, 1440x900 
0x37CA2318, 38092260207373864, 225508923, 225508931, 8, 1440x900 
0x37CA2318, 38092260208027696, 225508987, 225508996, 9, 1440x900 
0x37CA2318, 38092260208761920, 225509077, 225509085, 8, 1440x900 
0x37CA2318, 38092260209415048, 225509127, 225509135, 8, 1440x900 
0x37CA2318, 38092260210076736, 225509193, 225509201, 8, 1440x900 
0x37CA2318, 38092260210736704, 225509258, 225509266, 8, 1440x900 
0x37CA2318, 38092260211408928, 225509327, 225509335, 8, 1440x900 
0x37CA2318, 38092260212080736, 225509398, 225509406, 8, 1440x900 
0x37CA2318, 38092260212743440, 225509462, 225509470, 8, 1440x900 
0x37CA2318, 38092260213572808, 225509542, 225509552, 10, 1440x900 
0x37CA2318, 38092260214142152, 225509600, 225509609, 9, 1440x900 
0x37CA2318, 38092260214700080, 225509654, 225509662, 8, 1440x900 
0x37CA2318, 38092260215360160, 225509722, 225509730, 8, 1440x900 
0x37CA2318, 38092260216024848, 225509788, 225509797, 9, 1440x900 
0x37CA2318, 38092260216702168, 225509856, 225509864, 8, 1440x900 
0x37CA2318, 38092260218001016, 225509987, 225509994, 7, 1440x900 
0x37CA2318, 38092260218663032, 225510052, 225510060, 8, 1440x900 
0x37CA2318, 38092260219326512, 225510118, 225510125, 7, 1440x900 
0x37CA2318, 38092260219988464, 225510183, 225510191, 8, 1440x900 
0x37CA2318, 38092260220647984, 225510250, 225510257, 7, 1440x900 
0x37CA2318, 38092260221309352, 225510318, 225510325, 7, 1440x900 
0x37CA2318, 38092260221968144, 225510383, 225510390, 7, 1440x900 
0x37CA2318, 38092260222627984, 225510448, 225510456, 8, 1440x900 
0x37CA2318, 38092260223288128, 225510513, 225510521, 8, 1440x900 
0x37CA2318, 38092260223948360, 225510582, 225510589, 7, 1440x900 
0x37CA2318, 38092260224614992, 225510647, 225510654, 7, 1440x900 
0x37CA2318, 38092260225274736, 225510712, 225510720, 8, 1440x900 
0x37CA2318, 38092260225945512, 225510778, 225510786, 8, 1440x900 
0x37CA2318, 38092260226648960, 225510853, 225510863, 10, 1440x900 
0x37CA2318, 38092260227479768, 225510937, 225510945, 8, 1440x900 
0x37CA2318, 38092260228029056, 225510995, 225511006, 11, 1440x900 
0x37CA2318, 38092260228680776, 225511060, 225511072, 12, 1440x900 
0x37CA2318, 38092260229346176, 225511120, 225511128, 8, 1440x900 
0x37CA2318, 38092260230007112, 225511186, 225511197, 11, 1440x900 
0x37CA2318, 38092260230663456, 225511252, 225511262, 10, 1440x900 
0x37CA2318, 38092260231322536, 225511320, 225511335, 15, 1440x900 
0x37CA2318, 38092260232001128, 225511390, 225511405, 15, 1440x900 
0x37CA2318, 38092260232644008, 225511448, 225511456, 8, 1440x900 
0x37CA2318, 38092260233321912, 225511517, 225511525, 8, 1440x900 
0x37CA2318, 38092260233979520, 225511583, 225511592, 9, 1440x900 
0x37CA2318, 38092260234631232, 225511654, 225511667, 13, 1440x900 
0x37CA2318, 38092260235287256, 225511719, 225511726, 7, 1440x900 
0x37CA2318, 38092260235947536, 225511778, 225511791, 13, 1440x900 
0x37CA2318, 38092260236651880, 225511854, 225511869, 15, 1440x900 
0x37CA2318, 38092260237263968, 225511913, 225511920, 7, 1440x900 
0x37CA2318, 38092260237915216, 225511977, 225511984, 7, 1440x900 
0x37CA2318, 38092260238565176, 225512042, 225512050, 8, 1440x900 
0x37CA2318, 38092260239342368, 225512122, 225512129, 7, 1440x900 
0x37CA2318, 38092260239886040, 225512173, 225512181, 8, 1440x900 
0x37CA2318, 38092260240554568, 225512242, 225512251, 9, 1440x900 
0x37CA2318, 38092260241235352, 225512308, 225512317, 9, 1440x900 
0x37CA2318, 38092260241889904, 225512379, 225512387, 8, 1440x900 
0x37CA2318, 38092260242676056, 225512453, 225512461, 8, 1440x900 
0x37CA2318, 38092260243217144, 225512507, 225512514, 7, 1440x900 
0x37CA2318, 38092260243866576, 225512572, 225512582, 10, 1440x900 
0x37CA2318, 38092260244539216, 225512641, 225512648, 7, 1440x900 
0x37CA2318, 38092260245195360, 225512708, 225512716, 8, 1440x900 
0x37CA2318, 38092260245866128, 225512773, 225512780, 7, 1440x900 
0x37CA2318, 38092260246519696, 225512837, 225512846, 9, 1440x900 
0x37CA2318, 38092260247170752, 225512903, 225512911, 8, 1440x900 
0x37CA2318, 38092260247840120, 225512968, 225512977, 9, 1440x900 
0x37CA2318, 38092260248683872, 225513054, 225513062, 8, 1440x900 
0x37CA2318, 38092260249353440, 225513123, 225513130, 7, 1440x900 
0x37CA2318, 38092260249821080, 225513168, 225513175, 7, 1440x900 
0x37CA2318, 38092260250580688, 225513243, 225513251, 8, 1440x900 
0x37CA2318, 38092260251324416, 225513318, 225513326, 8, 1440x900 
0x37CA2318, 38092260251986968, 225513388, 225513397, 9, 1440x900 
0x37CA2318, 38092260252646592, 225513458, 225513467, 9, 1440x900 
0x37CA2318, 38092260253130976, 225513503, 225513511, 8, 1440x900 
0x37CA2318, 38092260253977544, 225513586, 225513593, 7, 1440x900 
0x37CA2318, 38092260254590504, 225513647, 225513655, 8, 1440x900 
0x37CA2318, 38092260255260296, 225513713, 225513722, 9, 1440x900 
0x37CA2318, 38092260255763984, 225513762, 225513769, 7, 1440x900 
0x37CA2318, 38092260256621120, 225513848, 225513855, 7, 1440x900 
0x37CA2318, 38092260257273248, 225513914, 225513922, 8, 1440x900 
0x37CA2318, 38092260257941872, 225513984, 225513992, 8, 1440x900 
0x37CA2318, 38092260258604616, 225514048, 225514056, 8, 1440x900 
0x37CA2318, 38092260259258368, 225514112, 225514119, 7, 1440x900 
0x37CA2318, 38092260259928360, 225514178, 225514186, 8, 1440x900 
0x37CA2318, 38092260260597008, 225514246, 225514253, 7, 1440x900 
0x37CA2318, 38092260261264392, 225514312, 225514320, 8, 1440x900 
0x37CA2318, 38092260261915232, 225514378, 225514385, 7, 1440x900 
0x37CA2318, 38092260262594800, 225514447, 225514455, 8, 1440x900 
0x37CA2318, 38092260263254536, 225514514, 225514522, 8, 1440x900 
0x37CA2318, 38092260263952384, 225514587, 225514595, 8, 1440x900 
0x37CA2318, 38092260264575016, 225514643, 225514651, 8, 1440x900 
0x37CA2318, 38092260265236984, 225514712, 225514720, 8, 1440x900 
0x37CA2318, 38092260265771256, 225514762, 225514770, 8, 1440x900 
0x37CA2318, 38092260266567056, 225514848, 225514857, 9, 1440x900 
0x37CA2318, 38092260267104728, 225514897, 225514905, 8, 1440x900 
0x37CA2318, 38092260267873672, 225514980, 225514995, 15, 1440x900 
0x37CA2318, 38092260268359720, 225515022, 225515029, 7, 1440x900 
0x37CA2318, 38092260269211520, 225515107, 225515115, 8, 1440x900 
0x37CA2318, 38092260269680088, 225515153, 225515161, 8, 1440x900 
0x37CA2318, 38092260270524200, 225515239, 225515246, 7, 1440x900 
0x37CA2318, 38092260271183472, 225515303, 225515311, 8, 1440x900 
0x37CA2318, 38092260271840392, 225515372, 225515380, 8, 1440x900 
0x37CA2318, 38092260272510864, 225515437, 225515445, 8, 1440x900 
0x37CA2318, 38092260273181320, 225515508, 225515516, 8, 1440x900 
0x37CA2318, 38092260273833760, 225515573, 225515581, 8, 1440x900 
0x37CA2318, 38092260274485304, 225515638, 225515646, 8, 1440x900 
0x37CA2318, 38092260274972320, 225515683, 225515690, 7, 1440x900 
0x37CA2318, 38092260275827392, 225515773, 225515781, 8, 1440x900 
0x37CA2318, 38092260276476912, 225515838, 225515847, 9, 1440x900 
0x37CA2318, 38092260276943232, 225515888, 225515896, 8, 1440x900 
0x37CA2318, 38092260277614160, 225515948, 225515957, 9, 1440x900 
0x37CA2318, 38092260278273608, 225516017, 225516028, 11, 1440x900 
0x37CA2318, 38092260278936216, 225516082, 225516089, 7, 1440x900 
0x37CA2318, 38092260279581920, 225516147, 225516154, 7, 1440x900 
0x37CA2318, 38092260280284496, 225516213, 225516221, 8, 1440x900 
0x37CA2318, 38092260280913600, 225516278, 225516285, 7, 1440x900 
0x37CA2318, 38092260281585216, 225516343, 225516351, 8, 1440x900 
0x37CA2318, 38092260282231464, 225516408, 225516416, 8, 1440x900 
0x37CA2318, 38092260282903744, 225516477, 225516484, 7, 1440x900 
0x37CA2318, 38092260283601152, 225516547, 225516554, 7, 1440x900 
0x37CA2318, 38092260284221056, 225516607, 225516615, 8, 1440x900 
0x37CA2318, 38092260284881896, 225516672, 225516680, 8, 1440x900 
0x37CA2318, 38092260285547288, 225516743, 225516750, 7, 1440x900 
0x37CA2318, 38092260286215680, 225516809, 225516818, 9, 1440x900 
0x37CA2318, 38092260286876352, 225516877, 225516886, 9, 1440x900 
0x37CA2318, 38092260287540296, 225516943, 225516952, 9, 1440x900 
0x37CA2318, 38092260288196072, 225517003, 225517011, 8, 1440x900 
0x37CA2318, 38092260288856496, 225517072, 225517080, 8, 1440x900 
0x37CA2318, 38092260289515568, 225517137, 225517145, 8, 1440x900 
0x37CA2318, 38092260290175568, 225517203, 225517211, 8, 1440x900 
0x37CA2318, 38092260290836400, 225517268, 225517276, 8, 1440x900 
0x37CA2318, 38092260291496816, 225517337, 225517345, 8, 1440x900 
0x37CA2318, 38092260292162816, 225517408, 225517416, 8, 1440x900 
0x37CA2318, 38092260292826568, 225517473, 225517482, 9, 1440x900 
0x37CA2318, 38092260293480256, 225517536, 225517544, 8, 1440x900 
0x37CA2318, 38092260294148056, 225517603, 225517610, 7, 1440x900 
0x37CA2318, 38092260295470552, 225517736, 225517744, 8, 1440x900 
0x37CA2318, 38092260296133224, 225517802, 225517810, 8, 1440x900 
0x37CA2318, 38092260296794224, 225517867, 225517875, 8, 1440x900 
0x37CA2318, 38092260297465552, 225517934, 225517943, 9, 1440x900 
0x37CA2318, 38092260298256488, 225518013, 225518022, 9, 1440x900 
0x37CA2318, 38092260298831328, 225518074, 225518095, 21, 1440x900 
0x37CA2318, 38092260299519472, 225518142, 225518172, 30, 1440x900 
0x37CA2318, 38092260300161464, 225518208, 225518228, 20, 1440x900 
0x37CA2318, 38092260300809600, 225518268, 225518276, 8, 1440x900 
0x37CA2318, 38092260301480608, 225518338, 225518349, 11, 1440x900 
0x37CA2318, 38092260302109248, 225518397, 225518404, 7, 1440x900 
0x37CA2318, 38092260302776024, 225518464, 225518472, 8, 1440x900 
0x37CA2318, 38092260303480880, 225518538, 225518547, 9, 1440x900 
0x37CA2318, 38092260304094960, 225518599, 225518611, 12, 1440x900 
0x37CA2318, 38092260304773528, 225518662, 225518670, 8, 1440x900 
0x37CA2318, 38092260305414112, 225518731, 225518746, 15, 1440x900 
0x37CA2318, 38092260306076632, 225518792, 225518800, 8, 1440x900 
0x37CA2318, 38092260306707600, 225518858, 225518867, 9, 1440x900 
0x37CA2318, 38092260307394512, 225518924, 225518932, 8, 1440x900 
0x37CA2318, 38092260308026608, 225518987, 225518995, 8, 1440x900 
0x37CA2318, 38092260308691872, 225519063, 225519071, 8, 1440x900 
0x37CA2318, 38092260309352400, 225519127, 225519137, 10, 1440x900 
0x37CA2318, 38092260310099808, 225519197, 225519204, 7, 1440x900 
0x37CA2318, 38092260310666944, 225519252, 225519259, 7, 1440x900 
0x37CA2318, 38092260311522664, 225519338, 225519345, 7, 1440x900 
0x37CA2318, 38092260312182240, 225519403, 225519411, 8, 1440x900 
0x37CA2318, 38092260312648472, 225519452, 225519459, 7, 1440x900 
0x37CA2318, 38092260313312720, 225519522, 225519530, 8, 1440x900 
0x37CA2318, 38092260313972760, 225519584, 225519592, 8, 1440x900 
0x37CA2318, 38092260314633960, 225519653, 225519661, 8, 1440x900 
0x37CA2318, 38092260315482728, 225519738, 225519746, 8, 1440x900 
0x37CA2318, 38092260316150600, 225519803, 225519812, 9, 1440x900 
0x37CA2318, 38092260316812272, 225519872, 225519880, 8, 1440x900 
0x37CA2318, 38092260317471512, 225519933, 225519942, 9, 1440x900 
0x37CA2318, 38092260318122632, 225520002, 225520010, 8, 1440x900 
0x37CA2318, 38092260318588544, 225520048, 225520056, 8, 1440x900 
0x37CA2318, 38092260319256096, 225520117, 225520125, 8, 1440x900 
0x37CA2318, 38092260319908984, 225520183, 225520191, 8, 1440x900 
0x37CA2318, 38092260320569160, 225520247, 225520255, 8, 1440x900 
0x37CA2318, 38092260321226608, 225520308, 225520316, 8, 1440x900 
0x37CA2318, 38092260321886880, 225520374, 225520382, 8, 1440x900 
0x37CA2318, 38092260322547328, 225520443, 225520450, 7, 1440x900 
0x37CA2318, 38092260323223064, 225520508, 225520515, 7, 1440x900 
0x37CA2318, 38092260323876384, 225520573, 225520581, 8, 1440x900 
0x37CA2318, 38092260324549176, 225520643, 225520650, 7, 1440x900 
0x37CA2318, 38092260325198416, 225520706, 225520717, 11, 1440x900 
0x37CA2318, 38092260325890712, 225520773, 225520782, 9, 1440x900 
0x37CA2318, 38092260326517656, 225520838, 225520845, 7, 1440x900 
0x37CA2318, 38092260327187960, 225520903, 225520912, 9, 1440x900 
0x37CA2318, 38092260327840672, 225520968, 225520976, 8, 1440x900 
0x37CA2318, 38092260328501864, 225521037, 225521044, 7, 1440x900 
0x37CA2318, 38092260329161568, 225521102, 225521108, 6, 1440x900 
0x37CA2318, 38092260329829344, 225521168, 225521176, 8, 1440x900 
0x37CA2318, 38092260330483568, 225521233, 225521241, 8, 1440x900 
0x37CA2318, 38092260331154048, 225521302, 225521310, 8, 1440x900 
0x37CA2318, 38092260331803888, 225521367, 225521374, 7, 1440x900 
0x37CA2318, 38092260332464312, 225521432, 225521439, 7, 1440x900 
0x37CA2318, 38092260333124912, 225521498, 225521506, 8, 1440x900 
0x37CA2318, 38092260333859528, 225521573, 225521584, 11, 1440x900 
0x37CA2318, 38092260334621168, 225521657, 225521667, 10, 1440x900 
0x37CA2318, 38092260335304272, 225521723, 225521738, 15, 1440x900 
0x37CA2318, 38092260335984488, 225521788, 225521814, 26, 1440x900 
0x37CA2318, 38092260336648352, 225521858, 225521873, 15, 1440x900 
0x37CA2318, 38092260337199072, 225521908, 225521925, 17, 1440x900 
0x37CA2318, 38092260337942568, 225521984, 225521995, 11, 1440x900 
0x37CA2318, 38092260338603672, 225522050, 225522057, 7, 1440x900 
0x37CA2318, 38092260339268480, 225522113, 225522122, 9, 1440x900 
0x37CA2318, 38092260339839864, 225522171, 225522178, 7, 1440x900 
0x37CA2318, 38092260340510352, 225522237, 225522245, 8, 1440x900 
0x37CA2318, 38092260341127784, 225522298, 225522305, 7, 1440x900 
0x37CA2318, 38092260341787296, 225522363, 225522371, 8, 1440x900 
0x37CA2318, 38092260342451168, 225522432, 225522440, 8, 1440x900 
0x37CA2318, 38092260343165488, 225522504, 225522515, 11, 1440x900 
0x37CA2318, 38092260343802184, 225522569, 225522577, 8, 1440x900 
0x37CA2318, 38092260344429168, 225522629, 225522637, 8, 1440x900 
0x37CA2318, 38092260345091680, 225522692, 225522701, 9, 1440x900 
0x37CA2318, 38092260347067800, 225522892, 225522899, 7, 1440x900 
0x37CA2318, 38092260347814296, 225522968, 225522975, 7, 1440x900 
0x37CA2318, 38092260348395832, 225523027, 225523034, 7, 1440x900 
0x37CA2318, 38092260349060480, 225523092, 225523100, 8, 1440x900 
0x37CA2318, 38092260349720384, 225523158, 225523164, 6, 1440x900 
0x37CA2318, 38092260350380280, 225523223, 225523230, 7, 1440x900 
0x37CA2318, 38092260351037696, 225523288, 225523296, 8, 1440x900 
0x37CA2318, 38092260351698424, 225523353, 225523360, 7, 1440x900 
0x37CA2318, 38092260352356448, 225523422, 225523428, 6, 1440x900 
0x37CA2318, 38092260353016560, 225523487, 225523495, 8, 1440x900 
0x37CA2318, 38092260353684312, 225523553, 225523560, 7, 1440x900 
0x37CA2318, 38092260354344288, 225523621, 225523628, 7, 1440x900 
0x37CA2318, 38092260355016104, 225523687, 225523694, 7, 1440x900 
0x37CA2318, 38092260355881792, 225523772, 225523780, 8, 1440x900 
0x37CA2318, 38092260356337552, 225523818, 225523825, 7, 1440x900 
0x37CA2318, 38092260356995536, 225523883, 225523890, 7, 1440x900 
0x37CA2318, 38092260357658248, 225523958, 225523965, 7, 1440x900 
0x37CA2318, 38092260358319432, 225524026, 225524033, 7, 1440x900 
0x37CA2318, 38092260358977536, 225524087, 225524094, 7, 1440x900 
0x37CA2318, 38092260359635896, 225524151, 225524158, 7, 1440x900 
0x37CA2318, 38092260360296568, 225524217, 225524224, 7, 1440x900 
0x37CA2318, 38092260360956176, 225524283, 225524290, 7, 1440x900 
0x37CA2318, 38092260361620872, 225524352, 225524359, 7, 1440x900 
0x37CA2318, 38092260362277936, 225524413, 225524421, 8, 1440x900 
0x37CA2318, 38092260363030776, 225524491, 225524499, 8, 1440x900 
0x37CA2318, 38092260363600088, 225524547, 225524554, 7, 1440x900 
0x37CA2318, 38092260364256728, 225524612, 225524619, 7, 1440x900 
0x37CA2318, 38092260364923584, 225524678, 225524685, 7, 1440x900 
0x37CA2318, 38092260366254032, 225524812, 225524819, 7, 1440x900 
0x37CA2318, 38092260366913776, 225524877, 225524884, 7, 1440x900 
0x37CA2318, 38092260367577696, 225524948, 225524955, 7, 1440x900 
0x37CA2318, 38092260368238208, 225525012, 225525020, 8, 1440x900 
0x37CA2318, 38092260368897128, 225525077, 225525084, 7, 1440x900 
0x37CA2318, 38092260369556832, 225525143, 225525151, 8, 1440x900 
0x37CA2318, 38092260370224456, 225525212, 225525219, 7, 1440x900 
0x37CA2318, 38092260370886824, 225525278, 225525286, 8, 1440x900 
0x37CA2318, 38092260371547608, 225525343, 225525351, 8, 1440x900 
0x37CA2318, 38092260372207232, 225525407, 225525414, 7, 1440x900 
0x37CA2318, 38092260372868160, 225525472, 225525480, 8, 1440x900 
0x37CA2318, 38092260373625184, 225525548, 225525556, 8, 1440x900 
0x37CA2318, 38092260374199616, 225525608, 225525616, 8, 1440x900 
0x37CA2318, 38092260375054504, 225525698, 225525706, 8, 1440x900 
0x37CA2318, 38092260375707480, 225525758, 225525766, 8, 1440x900 
0x37CA2318, 38092260376368448, 225525828, 225525836, 8, 1440x900 
0x37CA2318, 38092260377036648, 225525892, 225525900, 8, 1440x900 
0x37CA2318, 38092260377505192, 225525937, 225525944, 7, 1440x900 
0x37CA2318, 38092260378272104, 225526017, 225526025, 8, 1440x900 
0x37CA2318, 38092260379019744, 225526089, 225526096, 7, 1440x900 
0x37CA2318, 38092260379680096, 225526156, 225526163, 7, 1440x900 
0x37CA2318, 38092260380332456, 225526218, 225526226, 8, 1440x900 
0x37CA2318, 38092260381002400, 225526287, 225526294, 7, 1440x900 
0x37CA2318, 38092260381655800, 225526352, 225526360, 8, 1440x900 
0x37CA2318, 38092260382324920, 225526418, 225526426, 8, 1440x900 
0x37CA2318, 38092260383058600, 225526491, 225526507, 16, 1440x900 
0x37CA2318, 38092260383456992, 225526529, 225526565, 36, 1440x900 
0x37CA2318, 38092260384441456, 225526644, 225526686, 42, 1440x900 
0x37CA2318, 38092260385255224, 225526724, 225526739, 15, 1440x900 
0x37CA2318, 38092260385594864, 225526750, 225526788, 38, 1440x900 
0x37CA2318, 38092260386320800, 225526822, 225526849, 27, 1440x900 
0x37CA2318, 38092260386911736, 225526882, 225526916, 34, 1440x900 
0x37CA2318, 38092260387629448, 225526955, 225526963, 8, 1440x900 
0x37CA2318, 38092260388279032, 225527013, 225527020, 7, 1440x900 
0x37CA2318, 38092260388922360, 225527086, 225527096, 10, 1440x900 
0x37CA2318, 38092260389560064, 225527150, 225527164, 14, 1440x900 
0x37CA2318, 38092260390244472, 225527219, 225527229, 10, 1440x900 
0x37CA2318, 38092260390899656, 225527273, 225527283, 10, 1440x900 
0x37CA2318, 38092260391572272, 225527345, 225527368, 23, 1440x900 
0x37CA2318, 38092260392259320, 225527414, 225527433, 19, 1440x900 
0x37CA2318, 38092260392910896, 225527477, 225527483, 6, 1440x900 
0x37CA2318, 38092260393579648, 225527556, 225527564, 8, 1440x900 
0x37CA2318, 38092260394235056, 225527608, 225527615, 7, 1440x900 
0x37CA2318, 38092260394821432, 225527667, 225527673, 6, 1440x900 
0x37CA2318, 38092260395487056, 225527733, 225527740, 7, 1440x900 
0x37CA2318, 38092260396143400, 225527802, 225527809, 7, 1440x900 
0x37CA2318, 38092260396803208, 225527867, 225527874, 7, 1440x900 
0x37CA2318, 38092260397467488, 225527932, 225527939, 7, 1440x900 
0x37CA2318, 38092260398134224, 225528006, 225528014, 8, 1440x900 
0x37CA2318, 38092260398790928, 225528068, 225528074, 6, 1440x900 
0x37CA2318, 38092260399451256, 225528132, 225528139, 7, 1440x900 
0x37CA2318, 38092260400297512, 225528217, 225528224, 7, 1440x900 
0x37CA2318, 38092260400960616, 225528283, 225528291, 8, 1440x900 
0x37CA2318, 38092260401435488, 225528332, 225528340, 8, 1440x900 
0x37CA2318, 38092260402198264, 225528406, 225528412, 6, 1440x900 
0x37CA2318, 38092260402801680, 225528467, 225528475, 8, 1440x900 
0x37CA2318, 38092260403636112, 225528559, 225528568, 9, 1440x900 
0x37CA2318, 38092260404294840, 225528617, 225528626, 9, 1440x900 
0x37CA2318, 38092260404823224, 225528668, 225528678, 10, 1440x900 
0x37CA2318, 38092260405442664, 225528740, 225528767, 27, 1440x900 
0x37CA2318, 38092260406128200, 225528808, 225528820, 12, 1440x900 
0x37CA2318, 38092260406827304, 225528867, 225528874, 7, 1440x900 
0x37CA2318, 38092260407410160, 225528930, 225528968, 38, 1440x900 
0x37CA2318, 38092260408130080, 225529010, 225529022, 12, 1440x900 
0x37CA2318, 38092260408838816, 225529068, 225529077, 9, 1440x900 
0x37CA2318, 38092260409367200, 225529122, 225529127, 5, 1440x900 
0x37CA2318, 38092260410160720, 225529203, 225529209, 6, 1440x900 
0x37CA2318, 38092260410713776, 225529257, 225529265, 8, 1440x900 
0x37CA2318, 38092260411443040, 225529336, 225529351, 15, 1440x900 
0x37CA2318, 38092260412113088, 225529403, 225529418, 15, 1440x900 
0x37CA2318, 38092260412775656, 225529470, 225529483, 13, 1440x900 
0x37CA2318, 38092260413415768, 225529536, 225529547, 11, 1440x900 
0x37CA2318, 38092260414097432, 225529599, 225529614, 15, 1440x900 
0x37CA2318, 38092260414751776, 225529659, 225529682, 23, 1440x900 
0x37CA2318, 38092260415441672, 225529728, 225529738, 10, 1440x900 
0x37CA2318, 38092260416054704, 225529792, 225529798, 6, 1440x900 
0x37CA2318, 38092260416912048, 225529887, 225529906, 19, 1440x900 
0x37CA2318, 38092260417338712, 225529922, 225529928, 6, 1440x900 
0x37CA2318, 38092260418238040, 225530012, 225530017, 5, 1440x900 
0x37CA2318, 38092260418634688, 225530047, 225530054, 7, 1440x900 
0x37CA2318, 38092260419291248, 225530113, 225530120, 7, 1440x900 
0x37CA2318, 38092260420231456, 225530207, 225530215, 8, 1440x900 
0x37CA2318, 38092260420914872, 225530302, 225530312, 10, 1440x900 
0x37CA2318, 38092260421487960, 225530348, 225530354, 6, 1440x900 
0x37CA2318, 38092260422014712, 225530388, 225530395, 7, 1440x900 
0x37CA2318, 38092260422912640, 225530477, 225530484, 7, 1440x900 
0x37CA2318, 38092260423556376, 225530540, 225530550, 10, 1440x900 
0x37CA2318, 38092260424185024, 225530602, 225530614, 12, 1440x900 
0x37CA2318, 38092260424875272, 225530673, 225530679, 6, 1440x900 
0x37CA2318, 38092260425500840, 225530737, 225530743, 6, 1440x900 
0x37CA2318, 38092260426160848, 225530802, 225530808, 6, 1440x900 
0x37CA2318, 38092260426839520, 225530879, 225530889, 10, 1440x900 
0x37CA2318, 38092260427496840, 225530937, 225530943, 6, 1440x900 
0x37CA2318, 38092260428148656, 225531002, 225531010, 8, 1440x900 
0x37CA2318, 38092260428812816, 225531072, 225531079, 7, 1440x900 
0x37CA2318, 38092260429469512, 225531133, 225531138, 5, 1440x900 
0x37CA2318, 38092260431936808, 225531378, 225531385, 7, 1440x900 
0x37CA2318, 38092260432220616, 225531419, 225531427, 8, 1440x900 
0x37CA2318, 38092260432975064, 225531483, 225531492, 9, 1440x900 
0x37CA2318, 38092260433295352, 225531517, 225531526, 9, 1440x900 
0x37CA2318, 38092260434588048, 225531647, 225531653, 6, 1440x900 
0x37CA2318, 38092260435254960, 225531712, 225531724, 12, 1440x900 
0x37CA2318, 38092260436102288, 225531798, 225531804, 6, 1440x900 
0x37CA2318, 38092260436753256, 225531863, 225531870, 7, 1440x900 
0x37CA2318, 38092260437423096, 225531928, 225531934, 6, 1440x900 
0x37CA2318, 38092260438085680, 225531993, 225532001, 8, 1440x900 
0x37CA2318, 38092260438549984, 225532042, 225532049, 7, 1440x900 
0x37CA2318, 38092260439227776, 225532108, 225532116, 8, 1440x900 
0x37CA2318, 38092260439878320, 225532173, 225532181, 8, 1440x900 
0x37CA2318, 38092260440537368, 225532238, 225532245, 7, 1440x900 
0x37CA2318, 38092260441194456, 225532307, 225532313, 6, 1440x900 
0x37CA2318, 38092260441857824, 225532373, 225532379, 6, 1440x900 
0x37CA2318, 38092260442518008, 225532438, 225532444, 6, 1440x900 
0x37CA2318, 38092260443178832, 225532503, 225532510, 7, 1440x900 
0x37CA2318, 38092260443850288, 225532572, 225532579, 7, 1440x900 
0x37CA2318, 38092260444686104, 225532663, 225532684, 21, 1440x900 
0x37CA2318, 38092260445185288, 225532714, 225532726, 12, 1440x900 
0x37CA2318, 38092260445887400, 225532780, 225532795, 15, 1440x900 
0x37CA2318, 38092260446591216, 225532844, 225532853, 9, 1440x900 
0x37CA2318, 38092260447165816, 225532916, 225532934, 18, 1440x900 
0x37CA2318, 38092260448057240, 225532990, 225532998, 8, 1440x900 
0x37CA2318, 38092260448520680, 225533038, 225533062, 24, 1440x900 
0x37CA2318, 38092260449195064, 225533110, 225533124, 14, 1440x900 
0x37CA2318, 38092260449817280, 225533167, 225533174, 7, 1440x900 
0x37CA2318, 38092260450448872, 225533232, 225533237, 5, 1440x900 
0x37CA2318, 38092260451115720, 225533298, 225533306, 8, 1440x900 
0x37CA2318, 38092260451816776, 225533368, 225533375, 7, 1440x900 
0x37CA2318, 38092260452447160, 225533432, 225533437, 5, 1440x900 
0x37CA2318, 38092260453098824, 225533496, 225533501, 5, 1440x900 
0x37CA2318, 38092260453769760, 225533562, 225533567, 5, 1440x900 
0x37CA2318, 38092260454424976, 225533628, 225533635, 7, 1440x900 
0x37CA2318, 38092260455140288, 225533702, 225533708, 6, 1440x900 
0x37CA2318, 38092260455744336, 225533762, 225533769, 7, 1440x900 
0x37CA2318, 38092260456410232, 225533827, 225533834, 7, 1440x900 
0x37CA2318, 38092260457260752, 225533913, 225533919, 6, 1440x900 
0x37CA2318, 38092260457923208, 225533984, 225533991, 7, 1440x900 
0x37CA2318, 38092260458416304, 225534037, 225534046, 9, 1440x900 
0x37CA2318, 38092260459070192, 225534092, 225534099, 7, 1440x900 
0x37CA2318, 38092260459717656, 225534157, 225534167, 10, 1440x900 
0x37CA2318, 38092260460390048, 225534228, 225534235, 7, 1440x900 
0x37CA2318, 38092260461062488, 225534298, 225534305, 7, 1440x900 
0x37CA2318, 38092260461702816, 225534361, 225534369, 8, 1440x900 
0x37CA2318, 38092260462376816, 225534426, 225534432, 6, 1440x900 
0x37CA2318, 38092260463020472, 225534487, 225534494, 7, 1440x900 
0x37CA2318, 38092260463680384, 225534553, 225534560, 7, 1440x900 
0x37CA2318, 38092260464535800, 225534641, 225534647, 6, 1440x900 
0x37CA2318, 38092260465206824, 225534708, 225534714, 6, 1440x900 
0x37CA2318, 38092260465866464, 225534773, 225534779, 6, 1440x900 
0x37CA2318, 38092260466523520, 225534838, 225534845, 7, 1440x900 
0x37CA2318, 38092260466998832, 225534887, 225534894, 7, 1440x900 
0x37CA2318, 38092260467656496, 225534952, 225534958, 6, 1440x900 
0x37CA2318, 38092260468307224, 225535017, 225535023, 6, 1440x900 
0x37CA2318, 38092260469155616, 225535102, 225535108, 6, 1440x900 
0x37CA2318, 38092260469627888, 225535152, 225535161, 9, 1440x900 
0x37CA2318, 38092260470341368, 225535221, 225535227, 6, 1440x900 
0x37CA2318, 38092260470956992, 225535283, 225535289, 6, 1440x900 
0x37CA2318, 38092260471629544, 225535353, 225535361, 8, 1440x900 
0x37CA2318, 38092260472348632, 225535421, 225535428, 7, 1440x900 
0x37CA2318, 38092260472952992, 225535483, 225535490, 7, 1440x900 
0x37CA2318, 38092260473623704, 225535548, 225535554, 6, 1440x900 
0x37CA2318, 38092260474270096, 225535612, 225535619, 7, 1440x900 
0x37CA2318, 38092260474929824, 225535678, 225535685, 7, 1440x900 
0x37CA2318, 38092260475589944, 225535744, 225535752, 8, 1440x900 
0x37CA2318, 38092260476250008, 225535808, 225535816, 8, 1440x900 
0x37CA2318, 38092260476910024, 225535877, 225535883, 6, 1440x900 
0x37CA2318, 38092260477576152, 225535943, 225535950, 7, 1440x900 
0x37CA2318, 38092260478245184, 225536012, 225536019, 7, 1440x900 
0x37CA2318, 38092260478899512, 225536077, 225536084, 7, 1440x900 
0x37CA2318, 38092260479556184, 225536142, 225536150, 8, 1440x900 
0x37CA2318, 38092260480217888, 225536208, 225536216, 8, 1440x900 
0x37CA2318, 38092260480876288, 225536273, 225536280, 7, 1440x900 
0x37CA2318, 38092260481536504, 225536338, 225536346, 8, 1440x900 
0x37CA2318, 38092260482235312, 225536408, 225536416, 8, 1440x900 
0x37CA2318, 38092260482856296, 225536469, 225536477, 8, 1440x900 
0x37CA2318, 38092260483525224, 225536538, 225536545, 7, 1440x900 
0x37CA2318, 38092260484185768, 225536603, 225536611, 8, 1440x900 
0x37CA2318, 38092260484849024, 225536672, 225536680, 8, 1440x900 
0x37CA2318, 38092260485510304, 225536743, 225536751, 8, 1440x900 
0x37CA2318, 38092260486169720, 225536807, 225536815, 8, 1440x900 
0x37CA2318, 38092260486827376, 225536872, 225536880, 8, 1440x900 
0x37CA2318, 38092260487493328, 225536937, 225536945, 8, 1440x900 
0x37CA2318, 38092260488162400, 225537002, 225537010, 8, 1440x900 
0x37CA2318, 38092260488834728, 225537072, 225537079, 7, 1440x900 
0x37CA2318, 38092260489510808, 225537142, 225537151, 9, 1440x900 
0x37CA2318, 38092260490162024, 225537200, 225537209, 9, 1440x900 
0x37CA2318, 38092260490823064, 225537267, 225537275, 8, 1440x900 
0x37CA2318, 38092260491479048, 225537332, 225537340, 8, 1440x900 
0x37CA2318, 38092260492180536, 225537402, 225537410, 8, 1440x900 
0x37CA2318, 38092260492801528, 225537467, 225537474, 7, 1440x900 
0x37CA2318, 38092260493469456, 225537534, 225537541, 7, 1440x900 
0x37CA2318, 38092260494128984, 225537599, 225537606, 7, 1440x900 
0x37CA2318, 38092260494789408, 225537667, 225537674, 7, 1440x900 
0x37CA2318, 38092260495449576, 225537733, 225537740, 7, 1440x900 
0x37CA2318, 38092260496106280, 225537797, 225537804, 7, 1440x900 
0x37CA2318, 38092260497433808, 225537928, 225537936, 8, 1440x900 
0x37CA2318, 38092260498093888, 225537993, 225538001, 8, 1440x900 
0x37CA2318, 38092260498749424, 225538062, 225538070, 8, 1440x900 
0x37CA2318, 38092260499411832, 225538128, 225538136, 8, 1440x900 
0x37CA2318, 38092260500072424, 225538192, 225538200, 8, 1440x900 
0x37CA2318, 38092260500748808, 225538263, 225538275, 12, 1440x900 
0x37CA2318, 38092260501406440, 225538327, 225538334, 7, 1440x900 
0x37CA2318, 38092260502195592, 225538406, 225538413, 7, 1440x900 
0x37CA2318, 38092260502715616, 225538457, 225538464, 7, 1440x900 
0x37CA2318, 38092260503377088, 225538522, 225538530, 8, 1440x900 
0x37CA2318, 38092260504093960, 225538597, 225538604, 7, 1440x900 
0x37CA2318, 38092260504699856, 225538657, 225538664, 7, 1440x900 
0x37CA2318, 38092260505358208, 225538722, 225538729, 7, 1440x900 
0x37CA2318, 38092260506021648, 225538788, 225538795, 7, 1440x900 
0x37CA2318, 38092260506876128, 225538873, 225538880, 7, 1440x900 
0x37CA2318, 38092260507351912, 225538921, 225538928, 7, 1440x900 
0x37CA2318, 38092260508004168, 225538987, 225538994, 7, 1440x900 
0x37CA2318, 38092260508664136, 225539052, 225539061, 9, 1440x900 
0x37CA2318, 38092260509366408, 225539122, 225539129, 7, 1440x900 
0x37CA2318, 38092260509983776, 225539186, 225539193, 7, 1440x900 
0x37CA2318, 38092260510643104, 225539248, 225539257, 9, 1440x900 
0x37CA2318, 38092260511303984, 225539314, 225539323, 9, 1440x900 
0x37CA2318, 38092260511965456, 225539383, 225539403, 20, 1440x900 
0x37CA2318, 38092260512659736, 225539452, 225539459, 7, 1440x900 
0x37CA2318, 38092260513283448, 225539513, 225539521, 8, 1440x900 
0x37CA2318, 38092260513945760, 225539578, 225539586, 8, 1440x900 
0x37CA2318, 38092260514604928, 225539647, 225539654, 7, 1440x900 
0x37CA2318, 38092260515264192, 225539713, 225539720, 7, 1440x900 
0x37CA2318, 38092260515925480, 225539778, 225539785, 7, 1440x900 
0x37CA2318, 38092260516585544, 225539842, 225539850, 8, 1440x900 
0x37CA2318, 38092260517244704, 225539908, 225539915, 7, 1440x900 
0x37CA2318, 38092260517910304, 225539978, 225539986, 8, 1440x900 
0x37CA2318, 38092260518571536, 225540043, 225540052, 9, 1440x900 
0x37CA2318, 38092260519230128, 225540113, 225540122, 9, 1440x900 
0x37CA2318, 38092260519891248, 225540173, 225540181, 8, 1440x900 
0x37CA2318, 38092260520551184, 225540242, 225540250, 8, 1440x900 
0x37CA2318, 38092260521214016, 225540308, 225540315, 7, 1440x900 
0x37CA2318, 38092260521872376, 225540372, 225540381, 9, 1440x900 
0x37CA2318, 38092260522788784, 225540469, 225540492, 23, 1440x900 
0x37CA2318, 38092260523529856, 225540544, 225540561, 17, 1440x900 
0x37CA2318, 38092260524088528, 225540599, 225540618, 19, 1440x900 
0x37CA2318, 38092260524666776, 225540653, 225540672, 19, 1440x900 
0x37CA2318, 38092260525339944, 225540718, 225540729, 11, 1440x900 
0x37CA2318, 38092260525986528, 225540784, 225540791, 7, 1440x900 
0x37CA2318, 38092260526658184, 225540852, 225540858, 6, 1440x900 
0x37CA2318, 38092260527324112, 225540921, 225540929, 8, 1440x900 
0x37CA2318, 38092260527989312, 225540983, 225540993, 10, 1440x900 
0x37CA2318, 38092260528600072, 225541043, 225541053, 10, 1440x900 
0x37CA2318, 38092260529258120, 225541112, 225541129, 17, 1440x900 
0x37CA2318, 38092260529995008, 225541187, 225541197, 10, 1440x900 
0x37CA2318, 38092260530598152, 225541247, 225541271, 24, 1440x900 
0x37CA2318, 38092260531351464, 225541322, 225541328, 6, 1440x900 
0x37CA2318, 38092260532158296, 225541403, 225541412, 9, 1440x900 
0x37CA2318, 38092260532534912, 225541441, 225541449, 8, 1440x900 
0x37CA2318, 38092260533198760, 225541507, 225541514, 7, 1440x900 
0x37CA2318, 38092260533857904, 225541577, 225541585, 8, 1440x900 
0x37CA2318, 38092260534532760, 225541638, 225541645, 7, 1440x900 
0x37CA2318, 38092260535174160, 225541703, 225541710, 7, 1440x900 
0x37CA2318, 38092260535835520, 225541768, 225541775, 7, 1440x900 
0x37CA2318, 38092260536499008, 225541841, 225541851, 10, 1440x900 
0x37CA2318, 38092260537190832, 225541903, 225541910, 7, 1440x900 
0x37CA2318, 38092260538023592, 225541988, 225541995, 7, 1440x900 
0x37CA2318, 38092260538745560, 225542064, 225542072, 8, 1440x900 
0x37CA2318, 38092260539335296, 225542122, 225542130, 8, 1440x900 
0x37CA2318, 38092260539806504, 225542167, 225542175, 8, 1440x900 
0x37CA2318, 38092260540466016, 225542236, 225542244, 8, 1440x900 
0x37CA2318, 38092260541126536, 225542298, 225542307, 9, 1440x900 
0x37CA2318, 38092260541785552, 225542367, 225542375, 8, 1440x900 
0x37CA2318, 38092260542448648, 225542432, 225542439, 7, 1440x900 
0x37CA2318, 38092260543298760, 225542518, 225542526, 8, 1440x900 
0x37CA2318, 38092260543959456, 225542583, 225542591, 8, 1440x900 
0x37CA2318, 38092260544620440, 225542648, 225542657, 9, 1440x900 
0x37CA2318, 38092260545273856, 225542714, 225542723, 9, 1440x900 
0x37CA2318, 38092260545943696, 225542782, 225542791, 9, 1440x900 
0x37CA2318, 38092260546604744, 225542849, 225542858, 9, 1440x900 
0x37CA2318, 38092260547272936, 225542913, 225542920, 7, 1440x900 
0x37CA2318, 38092260547933080, 225542978, 225542986, 8, 1440x900 
0x37CA2318, 38092260548395296, 225543027, 225543035, 8, 1440x900 
0x37CA2318, 38092260549049536, 225543092, 225543099, 7, 1440x900 
0x37CA2318, 38092260549709344, 225543157, 225543163, 6, 1440x900 
0x37CA2318, 38092260550369960, 225543223, 225543230, 7, 1440x900 
0x37CA2318, 38092260551027784, 225543288, 225543296, 8, 1440x900 
0x37CA2318, 38092260551687984, 225543353, 225543360, 7, 1440x900 
0x37CA2318, 38092260552348048, 225543421, 225543429, 8, 1440x900 
0x37CA2318, 38092260553008600, 225543487, 225543494, 7, 1440x900 
0x37CA2318, 38092260553688464, 225543554, 225543564, 10, 1440x900 
0x37CA2318, 38092260554348088, 225543622, 225543629, 7, 1440x900 
0x37CA2318, 38092260555008728, 225543687, 225543697, 10, 1440x900 
0x37CA2318, 38092260555653160, 225543753, 225543760, 7, 1440x900 
0x37CA2318, 38092260556328048, 225543817, 225543825, 8, 1440x900 
0x37CA2318, 38092260556973568, 225543883, 225543889, 6, 1440x900 
0x37CA2318, 38092260557634368, 225543948, 225543956, 8, 1440x900 
0x37CA2318, 38092260558498280, 225544038, 225544045, 7, 1440x900 
0x37CA2318, 38092260558966184, 225544082, 225544090, 8, 1440x900 
0x37CA2318, 38092260559641472, 225544153, 225544161, 8, 1440x900 
0x37CA2318, 38092260560419552, 225544232, 225544240, 8, 1440x900 
0x37CA2318, 38092260560968528, 225544287, 225544295, 8, 1440x900 
0x37CA2318, 38092260561617304, 225544349, 225544356, 7, 1440x900 
0x37CA2318, 38092260562475224, 225544438, 225544446, 8, 1440x900 
0x37CA2318, 38092260563139576, 225544511, 225544519, 8, 1440x900 
0x37CA2318, 38092260563610568, 225544547, 225544554, 7, 1440x900 
0x37CA2318, 38092260564533832, 225544638, 225544647, 9, 1440x900 
0x37CA2318, 38092260564919272, 225544677, 225544685, 8, 1440x900 
0x37CA2318, 38092260565579008, 225544743, 225544750, 7, 1440x900 
0x37CA2318, 38092260566241840, 225544812, 225544819, 7, 1440x900 
0x37CA2318, 38092260566898376, 225544877, 225544884, 7, 1440x900 
0x37CA2318, 38092260567558592, 225544941, 225544949, 8, 1440x900 
0x37CA2318, 38092260568233944, 225545008, 225545017, 9, 1440x900 
0x37CA2318, 38092260568903520, 225545075, 225545083, 8, 1440x900 
0x37CA2318, 38092260569552672, 225545142, 225545149, 7, 1440x900 
0x37CA2318, 38092260570891032, 225545273, 225545281, 8, 1440x900 
0x37CA2318, 38092260571527272, 225545338, 225545346, 8, 1440x900 
0x37CA2318, 38092260572185864, 225545403, 225545411, 8, 1440x900 
0x37CA2318, 38092260572845864, 225545468, 225545476, 8, 1440x900 
0x37CA2318, 38092260573505640, 225545537, 225545544, 7, 1440x900 
0x37CA2318, 38092260574166280, 225545602, 225545609, 7, 1440x900 
0x37CA2318, 38092260574826240, 225545668, 225545676, 8, 1440x900 
0x37CA2318, 38092260575570480, 225545742, 225545750, 8, 1440x900 
0x37CA2318, 38092260576146840, 225545802, 225545809, 7, 1440x900 
0x37CA2318, 38092260576807600, 225545867, 225545874, 7, 1440x900 
0x37CA2318, 38092260577660960, 225545960, 225545968, 8, 1440x900 
0x37CA2318, 38092260578228712, 225546007, 225546028, 21, 1440x900 
0x37CA2318, 38092260578824328, 225546068, 225546086, 18, 1440x900 
0x37CA2318, 38092260579549264, 225546142, 225546150, 8, 1440x900 
0x37CA2318, 38092260580209368, 225546209, 225546217, 8, 1440x900 
0x37CA2318, 38092260580887512, 225546275, 225546283, 8, 1440x900 
0x37CA2318, 38092260581479824, 225546333, 225546342, 9, 1440x900 
0x37CA2318, 38092260582143264, 225546402, 225546419, 17, 1440x900 
0x37CA2318, 38092260582907400, 225546479, 225546495, 16, 1440x900 
0x37CA2318, 38092260583544856, 225546541, 225546548, 7, 1440x900 
0x37CA2318, 38092260584135048, 225546598, 225546608, 10, 1440x900 
0x37CA2318, 38092260584809768, 225546667, 225546676, 9, 1440x900 
0x37CA2318, 38092260585534544, 225546739, 225546751, 12, 1440x900 
0x37CA2318, 38092260586112256, 225546797, 225546804, 7, 1440x900 
0x37CA2318, 38092260586757544, 225546864, 225546871, 7, 1440x900 
0x37CA2318, 38092260587422944, 225546943, 225546951, 8, 1440x900 
0x37CA2318, 38092260588116128, 225547004, 225547025, 21, 1440x900 
0x37CA2318, 38092260588739096, 225547062, 225547070, 8, 1440x900 
0x37CA2318, 38092260589367896, 225547122, 225547130, 8, 1440x900 
0x37CA2318, 38092260590030352, 225547187, 225547195, 8, 1440x900 
0x37CA2318, 38092260590702544, 225547258, 225547265, 7, 1440x900 
0x37CA2318, 38092260591348288, 225547322, 225547329, 7, 1440x900 
0x37CA2318, 38092260592042752, 225547388, 225547397, 9, 1440x900 
0x37CA2318, 38092260592669136, 225547452, 225547460, 8, 1440x900 
0x37CA2318, 38092260593325968, 225547518, 225547525, 7, 1440x900 
0x37CA2318, 38092260593991544, 225547583, 225547591, 8, 1440x900 
0x37CA2318, 38092260594656192, 225547651, 225547658, 7, 1440x900 
0x37CA2318, 38092260595316032, 225547717, 225547729, 12, 1440x900 
0x37CA2318, 38092260595974768, 225547783, 225547791, 8, 1440x900 
0x37CA2318, 38092260596635128, 225547848, 225547856, 8, 1440x900 
0x37CA2318, 38092260597292328, 225547913, 225547920, 7, 1440x900 
0x37CA2318, 38092260597951536, 225547982, 225547989, 7, 1440x900 
0x37CA2318, 38092260598611536, 225548047, 225548054, 7, 1440x900 
0x37CA2318, 38092260599381688, 225548128, 225548137, 9, 1440x900 
0x37CA2318, 38092260599943312, 225548184, 225548192, 8, 1440x900 
0x37CA2318, 38092260600594784, 225548247, 225548255, 8, 1440x900 
0x37CA2318, 38092260601255960, 225548313, 225548320, 7, 1440x900 
0x37CA2318, 38092260601918080, 225548377, 225548385, 8, 1440x900 
0x37CA2318, 38092260602577856, 225548442, 225548450, 8, 1440x900 
0x37CA2318, 38092260603237640, 225548508, 225548517, 9, 1440x900 
0x37CA2318, 38092260604100192, 225548596, 225548603, 7, 1440x900 
0x37CA2318, 38092260604567472, 225548642, 225548650, 8, 1440x900 
0x37CA2318, 38092260605223368, 225548709, 225548717, 8, 1440x900 
0x37CA2318, 38092260605883800, 225548773, 225548781, 8, 1440x900 
0x37CA2318, 38092260606554080, 225548842, 225548849, 7, 1440x900 
0x37CA2318, 38092260607226472, 225548909, 225548919, 10, 1440x900 
0x37CA2318, 38092260607873248, 225548972, 225548980, 8, 1440x900 
0x37CA2318, 38092260608533280, 225549038, 225549046, 8, 1440x900 
0x37CA2318, 38092260609399168, 225549127, 225549134, 7, 1440x900 
0x37CA2318, 38092260610068712, 225549199, 225549206, 7, 1440x900 
0x37CA2318, 38092260610526400, 225549237, 225549245, 8, 1440x900 
0x37CA2318, 38092260611387912, 225549322, 225549330, 8, 1440x900 
0x37CA2318, 38092260611935248, 225549382, 225549389, 7, 1440x900 
0x37CA2318, 38092260612510376, 225549437, 225549446, 9, 1440x900 
0x37CA2318, 38092260613182720, 225549507, 225549514, 7, 1440x900 
0x37CA2318, 38092260613829896, 225549568, 225549576, 8, 1440x900 
0x37CA2318, 38092260614491160, 225549637, 225549646, 9, 1440x900 
0x37CA2318, 38092260615166864, 225549702, 225549710, 8, 1440x900 
0x37CA2318, 38092260615829184, 225549768, 225549778, 10, 1440x900 
0x37CA2318, 38092260616493808, 225549833, 225549842, 9, 1440x900 
0x37CA2318, 38092260617139336, 225549898, 225549906, 8, 1440x900 
0x37CA2318, 38092260617801720, 225549964, 225549973, 9, 1440x900 
0x37CA2318, 38092260618464312, 225550031, 225550039, 8, 1440x900 
0x37CA2318, 38092260619127360, 225550098, 225550106, 8, 1440x900 
0x37CA2318, 38092260619787424, 225550162, 225550170, 8, 1440x900 
0x37CA2318, 38092260620449680, 225550228, 225550236, 8, 1440x900 
0x37CA2318, 38092260621117304, 225550299, 225550305, 6, 1440x900 
0x37CA2318, 38092260621779472, 225550362, 225550370, 8, 1440x900 
0x37CA2318, 38092260622435880, 225550428, 225550436, 8, 1440x900 
0x37CA2318, 38092260623095448, 225550493, 225550501, 8, 1440x900 
0x37CA2318, 38092260623756656, 225550561, 225550569, 8, 1440x900 
0x37CA2318, 38092260624422424, 225550628, 225550635, 7, 1440x900 
0x37CA2318, 38092260625085264, 225550693, 225550700, 7, 1440x900 
0x37CA2318, 38092260625742232, 225550762, 225550769, 7, 1440x900 
0x37CA2318, 38092260626402600, 225550827, 225550833, 6, 1440x900 
0x37CA2318, 38092260627062712, 225550892, 225550899, 7, 1440x900 
0x37CA2318, 38092260627925744, 225550982, 225550990, 8, 1440x900 
0x37CA2318, 38092260628584944, 225551049, 225551057, 8, 1440x900 
0x37CA2318, 38092260629246744, 225551113, 225551122, 9, 1440x900 
0x37CA2318, 38092260629711632, 225551158, 225551165, 7, 1440x900 
0x37CA2318, 38092260630370496, 225551223, 225551231, 8, 1440x900 
0x37CA2318, 38092260631037152, 225551293, 225551300, 7, 1440x900 
0x37CA2318, 38092260631695128, 225551353, 225551362, 9, 1440x900 
0x37CA2318, 38092260632414488, 225551427, 225551434, 7, 1440x900 
0x37CA2318, 38092260633024888, 225551488, 225551495, 7, 1440x900 
0x37CA2318, 38092260633685520, 225551553, 225551561, 8, 1440x900 
0x37CA2318, 38092260634345152, 225551618, 225551626, 8, 1440x900 
0x37CA2318, 38092260635005072, 225551687, 225551694, 7, 1440x900 
0x37CA2318, 38092260635667952, 225551753, 225551761, 8, 1440x900 
0x37CA2318, 38092260636333928, 225551823, 225551831, 8, 1440x900 
0x37CA2318, 38092260637782960, 225551972, 225551980, 8, 1440x900 
0x37CA2318, 38092260638319792, 225552023, 225552031, 8, 1440x900 
0x37CA2318, 38092260639181192, 225552107, 225552114, 7, 1440x900 
0x37CA2318, 38092260639634432, 225552147, 225552155, 8, 1440x900 
0x37CA2318, 38092260640294392, 225552213, 225552221, 8, 1440x900 
0x37CA2318, 38092260641160856, 225552302, 225552309, 7, 1440x900 
0x37CA2318, 38092260641821440, 225552373, 225552380, 7, 1440x900 
0x37CA2318, 38092260642480752, 225552438, 225552448, 10, 1440x900 
0x37CA2318, 38092260642956624, 225552488, 225552495, 7, 1440x900 
0x37CA2318, 38092260643595112, 225552547, 225552555, 8, 1440x900 
0x37CA2318, 38092260644277568, 225552613, 225552621, 8, 1440x900 
0x37CA2318, 38092260644942416, 225552683, 225552692, 9, 1440x900 
0x37CA2318, 38092260645598096, 225552747, 225552756, 9, 1440x900 
0x37CA2318, 38092260646259304, 225552813, 225552820, 7, 1440x900 
0x37CA2318, 38092260646919056, 225552878, 225552888, 10, 1440x900 
0x37CA2318, 38092260647580120, 225552943, 225552951, 8, 1440x900 
0x37CA2318, 38092260648239992, 225553012, 225553019, 7, 1440x900 
0x37CA2318, 38092260648899664, 225553077, 225553085, 8, 1440x900 
0x37CA2318, 38092260649560624, 225553142, 225553149, 7, 1440x900 
0x37CA2318, 38092260650220488, 225553208, 225553215, 7, 1440x900 
0x37CA2318, 38092260650880336, 225553273, 225553282, 9, 1440x900 
0x37CA2318, 38092260651545472, 225553343, 225553350, 7, 1440x900 
0x37CA2318, 38092260652210392, 225553410, 225553417, 7, 1440x900 
0x37CA2318, 38092260652866720, 225553473, 225553480, 7, 1440x900 
0x37CA2318, 38092260653528120, 225553543, 225553551, 8, 1440x900 
0x37CA2318, 38092260654187336, 225553604, 225553611, 7, 1440x900 
0x37CA2318, 38092260654855400, 225553673, 225553680, 7, 1440x900 
0x37CA2318, 38092260655499536, 225553738, 225553745, 7, 1440x900 
0x37CA2318, 38092260656157936, 225553803, 225553809, 6, 1440x900 
0x37CA2318, 38092260656828424, 225553867, 225553876, 9, 1440x900 
0x37CA2318, 38092260657509224, 225553938, 225553945, 7, 1440x900 
0x37CA2318, 38092260658148368, 225554004, 225554012, 8, 1440x900 
0x37CA2318, 38092260658822480, 225554069, 225554076, 7, 1440x900 
0x37CA2318, 38092260659471784, 225554133, 225554141, 8, 1440x900 
0x37CA2318, 38092260660145320, 225554202, 225554209, 7, 1440x900 
0x37CA2318, 38092260660794984, 225554268, 225554276, 8, 1440x900 
0x37CA2318, 38092260661647320, 225554357, 225554365, 8, 1440x900 
0x37CA2318, 38092260662310608, 225554418, 225554427, 9, 1440x900 
0x37CA2318, 38092260662973696, 225554488, 225554496, 8, 1440x900 
0x37CA2318, 38092260663642440, 225554553, 225554561, 8, 1440x900 
0x37CA2318, 38092260664293240, 225554613, 225554621, 8, 1440x900 
0x37CA2318, 38092260664973264, 225554683, 225554690, 7, 1440x900 
0x37CA2318, 38092260665425560, 225554727, 225554735, 8, 1440x900 
0x37CA2318, 38092260666085584, 225554794, 225554801, 7, 1440x900 
0x37CA2318, 38092260666745528, 225554858, 225554866, 8, 1440x900 
0x37CA2318, 38092260667411064, 225554930, 225554939, 9, 1440x900 
0x37CA2318, 38092260668068632, 225554993, 225555001, 8, 1440x900 
0x37CA2318, 38092260668727968, 225555064, 225555071, 7, 1440x900 
0x37CA2318, 38092260669388080, 225555128, 225555135, 7, 1440x900 
0x37CA2318, 38092260670052224, 225555192, 225555199, 7, 1440x900 
0x37CA2318, 38092260670711064, 225555258, 225555265, 7, 1440x900 
0x37CA2318, 38092260671370832, 225555322, 225555330, 8, 1440x900 
0x37CA2318, 38092260672036968, 225555393, 225555402, 9, 1440x900 
0x37CA2318, 38092260672692448, 225555457, 225555465, 8, 1440x900 
0x37CA2318, 38092260673358944, 225555523, 225555532, 9, 1440x900 
0x37CA2318, 38092260674025376, 225555593, 225555601, 8, 1440x900 
0x37CA2318, 38092260674682216, 225555657, 225555665, 8, 1440x900 
0x37CA2318, 38092260675343440, 225555722, 225555729, 7, 1440x900 
0x37CA2318, 38092260676002576, 225555789, 225555796, 7, 1440x900 
0x37CA2318, 38092260676662400, 225555852, 225555860, 8, 1440x900 
0x37CA2318, 38092260677320440, 225555918, 225555925, 7, 1440x900 
0x37CA2318, 38092260677980832, 225555983, 225555991, 8, 1440x900 
0x37CA2318, 38092260678648816, 225556052, 225556059, 7, 1440x900 
0x37CA2318, 38092260679308544, 225556117, 225556124, 7, 1440x900 
0x37CA2318, 38092260680021136, 225556193, 225556201, 8, 1440x900 
0x37CA2318, 38092260680633440, 225556252, 225556261, 9, 1440x900 
0x37CA2318, 38092260681293416, 225556318, 225556326, 8, 1440x900 
0x37CA2318, 38092260681953920, 225556388, 225556396, 8, 1440x900 
0x37CA2318, 38092260682611456, 225556458, 225556466, 8, 1440x900 
0x37CA2318, 38092260683272944, 225556513, 225556520, 7, 1440x900 
0x37CA2318, 38092260683931656, 225556578, 225556586, 8, 1440x900 
0x37CA2318, 38092260684592800, 225556647, 225556655, 8, 1440x900 
0x37CA2318, 38092260685252280, 225556712, 225556720, 8, 1440x900 
0x37CA2318, 38092260685911672, 225556777, 225556785, 8, 1440x900 
0x37CA2318, 38092260686576784, 225556847, 225556854, 7, 1440x900 
0x37CA2318, 38092260687231512, 225556908, 225556915, 7, 1440x900 
0x37CA2318, 38092260687894032, 225556973, 225556981, 8, 1440x900 
0x37CA2318, 38092260688575096, 225557043, 225557052, 9, 1440x900 
0x37CA2318, 38092260689214488, 225557108, 225557114, 6, 1440x900 
0x37CA2318, 38092260689874440, 225557173, 225557180, 7, 1440x900 
0x37CA2318, 38092260690543296, 225557241, 225557248, 7, 1440x900 
0x37CA2318, 38092260691220560, 225557307, 225557315, 8, 1440x900 
0x37CA2318, 38092260691864648, 225557373, 225557383, 10, 1440x900 
0x37CA2318, 38092260692527608, 225557442, 225557450, 8, 1440x900 
0x37CA2318, 38092260693184704, 225557508, 225557516, 8, 1440x900 
0x37CA2318, 38092260694512456, 225557643, 225557651, 8, 1440x900 
0x37CA2318, 38092260695173384, 225557708, 225557716, 8, 1440x900 
0x37CA2318, 38092260695832768, 225557773, 225557780, 7, 1440x900 
0x37CA2318, 38092260696490528, 225557838, 225557846, 8, 1440x900 
0x37CA2318, 38092260697151080, 225557903, 225557910, 7, 1440x900 
0x37CA2318, 38092260697811392, 225557968, 225557975, 7, 1440x900 
0x37CA2318, 38092260698481344, 225558038, 225558046, 8, 1440x900 
0x37CA2318, 38092260699129424, 225558097, 225558104, 7, 1440x900 
0x37CA2318, 38092260699789536, 225558162, 225558170, 8, 1440x900 
0x37CA2318, 38092260700451448, 225558232, 225558240, 8, 1440x900 
0x37CA2318, 38092260701112504, 225558297, 225558305, 8, 1440x900 
0x37CA2318, 38092260701779568, 225558367, 225558375, 8, 1440x900 
0x37CA2318, 38092260702458232, 225558432, 225558439, 7, 1440x900 
0x37CA2318, 38092260703099200, 225558497, 225558505, 8, 1440x900 
0x37CA2318, 38092260703770944, 225558562, 225558569, 7, 1440x900 
0x37CA2318, 38092260704424376, 225558627, 225558634, 7, 1440x900 
0x37CA2318, 38092260705086040, 225558697, 225558704, 7, 1440x900 
0x37CA2318, 38092260705860688, 225558777, 225558787, 10, 1440x900 
0x37CA2318, 38092260706411488, 225558828, 225558835, 7, 1440x900 
0x37CA2318, 38092260707073272, 225558894, 225558901, 7, 1440x900 
0x37CA2318, 38092260707917656, 225558978, 225558985, 7, 1440x900 
0x37CA2318, 38092260708387840, 225559023, 225559031, 8, 1440x900 
0x37CA2318, 38092260709249904, 225559111, 225559119, 8, 1440x900 
0x37CA2318, 38092260709916192, 225559178, 225559185, 7, 1440x900 
0x37CA2318, 38092260710582064, 225559247, 225559255, 8, 1440x900 
0x37CA2318, 38092260711047192, 225559298, 225559306, 8, 1440x900 
0x37CA2318, 38092260711706392, 225559363, 225559371, 8, 1440x900 
0x37CA2318, 38092260712560376, 225559443, 225559451, 8, 1440x900 
0x37CA2318, 38092260713222808, 225559512, 225559520, 8, 1440x900 
0x37CA2318, 38092260713879560, 225559578, 225559586, 8, 1440x900 
0x37CA2318, 38092260714549920, 225559644, 225559652, 8, 1440x900 
0x37CA2318, 38092260715219264, 225559709, 225559717, 8, 1440x900 
0x37CA2318, 38092260715870616, 225559778, 225559786, 8, 1440x900 
0x37CA2318, 38092260716529776, 225559838, 225559847, 9, 1440x900 
0x37CA2318, 38092260717190184, 225559908, 225559917, 9, 1440x900 
0x37CA2318, 38092260717667024, 225559953, 225559961, 8, 1440x900 
0x37CA2318, 38092260718515728, 225560038, 225560046, 8, 1440x900 
0x37CA2318, 38092260719175880, 225560103, 225560111, 8, 1440x900 
0x37CA2318, 38092260719633408, 225560148, 225560169, 21, 1440x900 
0x37CA2318, 38092260720333848, 225560218, 225560226, 8, 1440x900 
0x37CA2318, 38092260720964272, 225560283, 225560290, 7, 1440x900 
0x37CA2318, 38092260721625392, 225560348, 225560356, 8, 1440x900 
0x37CA2318, 38092260722284256, 225560413, 225560421, 8, 1440x900 
0x37CA2318, 38092260722944576, 225560481, 225560488, 7, 1440x900 
0x37CA2318, 38092260723604384, 225560547, 225560554, 7, 1440x900 
0x37CA2318, 38092260724265976, 225560612, 225560620, 8, 1440x900 
0x37CA2318, 38092260724929920, 225560678, 225560688, 10, 1440x900 
0x37CA2318, 38092260725587776, 225560743, 225560751, 8, 1440x900 
0x37CA2318, 38092260726247568, 225560809, 225560817, 8, 1440x900 
0x37CA2318, 38092260726922904, 225560877, 225560885, 8, 1440x900 
0x37CA2318, 38092260727615872, 225560947, 225560956, 9, 1440x900 
0x37CA2318, 38092260728304648, 225561019, 225561027, 8, 1440x900 
0x37CA2318, 38092260728906576, 225561077, 225561084, 7, 1440x900 
0x37CA2318, 38092260729557600, 225561143, 225561152, 9, 1440x900 
0x37CA2318, 38092260730231768, 225561212, 225561220, 8, 1440x900 
0x37CA2318, 38092260730908896, 225561278, 225561285, 7, 1440x900 
0x37CA2318, 38092260731546256, 225561338, 225561347, 9, 1440x900 
0x37CA2318, 38092260732207696, 225561408, 225561417, 9, 1440x900 
0x37CA2318, 38092260732891880, 225561473, 225561488, 15, 1440x900 
0x37CA2318, 38092260733548344, 225561542, 225561550, 8, 1440x900 
0x37CA2318, 38092260734214368, 225561607, 225561614, 7, 1440x900 
0x37CA2318, 38092260734856008, 225561672, 225561679, 7, 1440x900 
0x37CA2318, 38092260735538176, 225561752, 225561761, 9, 1440x900 
0x37CA2318, 38092260736289968, 225561825, 225561834, 9, 1440x900 
0x37CA2318, 38092260736968584, 225561895, 225561929, 34, 1440x900 
0x37CA2318, 38092260737567864, 225561942, 225561967, 25, 1440x900 
0x37CA2318, 38092260738274768, 225562016, 225562044, 28, 1440x900 
0x37CA2318, 38092260738948168, 225562086, 225562102, 16, 1440x900 
0x37CA2318, 38092260739561560, 225562142, 225562149, 7, 1440x900 
0x37CA2318, 38092260740227808, 225562208, 225562218, 10, 1440x900 
0x37CA2318, 38092260740854240, 225562271, 225562278, 7, 1440x900 
0x37CA2318, 38092260741590688, 225562344, 225562362, 18, 1440x900 
0x37CA2318, 38092260742261984, 225562414, 225562429, 15, 1440x900 
0x37CA2318, 38092260742890152, 225562473, 225562480, 7, 1440x900 
0x37CA2318, 38092260743561520, 225562542, 225562551, 9, 1440x900 
0x37CA2318, 38092260744229656, 225562607, 225562619, 12, 1440x900 
0x37CA2318, 38092260744895448, 225562674, 225562684, 10, 1440x900 
0x37CA2318, 38092260745496488, 225562737, 225562746, 9, 1440x900 
0x37CA2318, 38092260746161552, 225562804, 225562821, 17, 1440x900 
0x37CA2318, 38092260746958336, 225562882, 225562890, 8, 1440x900 
0x37CA2318, 38092260747564512, 225562943, 225562950, 7, 1440x900 
0x37CA2318, 38092260748234856, 225563011, 225563018, 7, 1440x900 
0x37CA2318, 38092260748947872, 225563095, 225563102, 7, 1440x900 
0x37CA2318, 38092260749599136, 225563148, 225563155, 7, 1440x900 
0x37CA2318, 38092260750118360, 225563198, 225563205, 7, 1440x900 
0x37CA2318, 38092260750775072, 225563263, 225563271, 8, 1440x900 
0x37CA2318, 38092260751437960, 225563327, 225563335, 8, 1440x900 
0x37CA2318, 38092260752095536, 225563394, 225563404, 10, 1440x900 
0x37CA2318, 38092260752812736, 225563467, 225563474, 7, 1440x900 
0x37CA2318, 38092260753423672, 225563527, 225563535, 8, 1440x900 
0x37CA2318, 38092260754080960, 225563593, 225563601, 8, 1440x900 
0x37CA2318, 38092260754739176, 225563657, 225563665, 8, 1440x900 
0x37CA2318, 38092260755403408, 225563727, 225563734, 7, 1440x900 
0x37CA2318, 38092260756063240, 225563793, 225563799, 6, 1440x900 
0x37CA2318, 38092260756722992, 225563858, 225563866, 8, 1440x900 
0x37CA2318, 38092260757382584, 225563923, 225563931, 8, 1440x900 
0x37CA2318, 38092260758039480, 225563991, 225563999, 8, 1440x900 
0x37CA2318, 38092260758700776, 225564058, 225564066, 8, 1440x900 
0x37CA2318, 38092260759375392, 225564122, 225564130, 8, 1440x900 
0x37CA2318, 38092260760022408, 225564188, 225564194, 6, 1440x900 
0x37CA2318, 38092260760683856, 225564257, 225564265, 8, 1440x900 
0x37CA2318, 38092260761346976, 225564323, 225564331, 8, 1440x900 
0x37CA2318, 38092260762211832, 225564412, 225564420, 8, 1440x900 
0x37CA2318, 38092260762871968, 225564477, 225564485, 8, 1440x900 
0x37CA2318, 38092260763520400, 225564543, 225564551, 8, 1440x900 
0x37CA2318, 38092260764200512, 225564607, 225564615, 8, 1440x900 
0x37CA2318, 38092260764851192, 225564672, 225564681, 9, 1440x900 
0x37CA2318, 38092260765317792, 225564722, 225564730, 8, 1440x900 
0x37CA2318, 38092260765978288, 225564787, 225564795, 8, 1440x900 
0x37CA2318, 38092260766647680, 225564853, 225564861, 8, 1440x900 
0x37CA2318, 38092260767307664, 225564918, 225564926, 8, 1440x900 
0x37CA2318, 38092260767968144, 225564988, 225564996, 8, 1440x900 
0x37CA2318, 38092260768632464, 225565052, 225565060, 8, 1440x900 
0x37CA2318, 38092260769286352, 225565116, 225565124, 8, 1440x900 
0x37CA2318, 38092260769956888, 225565187, 225565193, 6, 1440x900 
0x37CA2318, 38092260770624952, 225565252, 225565260, 8, 1440x900 
0x37CA2318, 38092260771293528, 225565324, 225565334, 10, 1440x900 
0x37CA2318, 38092260771931088, 225565379, 225565387, 8, 1440x900 
0x37CA2318, 38092260772590424, 225565443, 225565451, 8, 1440x900 
0x37CA2318, 38092260773445344, 225565532, 225565539, 7, 1440x900 
0x37CA2318, 38092260774576992, 225565647, 225565655, 8, 1440x900 
0x37CA2318, 38092260775232152, 225565713, 225565721, 8, 1440x900 
0x37CA2318, 38092260775892376, 225565779, 225565787, 8, 1440x900 
0x37CA2318, 38092260776559584, 225565848, 225565856, 8, 1440x900 
0x37CA2318, 38092260777211560, 225565907, 225565915, 8, 1440x900 
0x37CA2318, 38092260777870064, 225565972, 225565980, 8, 1440x900 
0x37CA2318, 38092260778731928, 225566058, 225566066, 8, 1440x900 
0x37CA2318, 38092260779201200, 225566107, 225566115, 8, 1440x900 
0x37CA2318, 38092260779860224, 225566172, 225566180, 8, 1440x900 
0x37CA2318, 38092260780520688, 225566237, 225566245, 8, 1440x900 
0x37CA2318, 38092260781178088, 225566303, 225566310, 7, 1440x900 
0x37CA2318, 38092260781834168, 225566368, 225566377, 9, 1440x900 
0x37CA2318, 38092260782494880, 225566433, 225566441, 8, 1440x900 
0x37CA2318, 38092260783154000, 225566502, 225566509, 7, 1440x900 
0x37CA2318, 38092260783977344, 225566584, 225566592, 8, 1440x900 
0x37CA2318, 38092260784494128, 225566633, 225566641, 8, 1440x900 
0x37CA2318, 38092260785143824, 225566698, 225566706, 8, 1440x900 
0x37CA2318, 38092260785796416, 225566764, 225566772, 8, 1440x900 
0x37CA2318, 38092260786458512, 225566833, 225566842, 9, 1440x900 
0x37CA2318, 38092260787121120, 225566903, 225566911, 8, 1440x900 
0x37CA2318, 38092260787778072, 225566963, 225566971, 8, 1440x900 
0x37CA2318, 38092260788445680, 225567032, 225567039, 7, 1440x900 
0x37CA2318, 38092260789097504, 225567098, 225567105, 7, 1440x900 
0x37CA2318, 38092260789757576, 225567163, 225567171, 8, 1440x900 
0x37CA2318, 38092260790430296, 225567232, 225567240, 8, 1440x900 
0x37CA2318, 38092260791179632, 225567308, 225567316, 8, 1440x900 
0x37CA2318, 38092260791756336, 225567363, 225567372, 9, 1440x900 
0x37CA2318, 38092260792427536, 225567432, 225567440, 8, 1440x900 
0x37CA2318, 38092260793273168, 225567518, 225567526, 8, 1440x900 
0x37CA2318, 38092260793943896, 225567583, 225567591, 8, 1440x900 
0x37CA2318, 38092260794594440, 225567649, 225567656, 7, 1440x900 
0x37CA2318, 38092260795262512, 225567713, 225567722, 9, 1440x900 
0x37CA2318, 38092260795913616, 225567778, 225567786, 8, 1440x900 
0x37CA2318, 38092260796584160, 225567849, 225567857, 8, 1440x900 
0x37CA2318, 38092260797254288, 225567913, 225567922, 9, 1440x900 
0x37CA2318, 38092260797905600, 225567979, 225567987, 8, 1440x900 
0x37CA2318, 38092260798559848, 225568048, 225568056, 8, 1440x900 
0x37CA2318, 38092260799230768, 225568112, 225568121, 9, 1440x900 
0x37CA2318, 38092260799891280, 225568177, 225568186, 9, 1440x900 
0x37CA2318, 38092260800553312, 225568242, 225568250, 8, 1440x900 
0x37CA2318, 38092260801217200, 225568308, 225568317, 9, 1440x900 
0x37CA2318, 38092260801874528, 225568375, 225568383, 8, 1440x900 
0x37CA2318, 38092260802529400, 225568442, 225568450, 8, 1440x900 
0x37CA2318, 38092260803199872, 225568512, 225568520, 8, 1440x900 
0x37CA2318, 38092260803851040, 225568573, 225568581, 8, 1440x900 
0x37CA2318, 38092260804521792, 225568642, 225568650, 8, 1440x900 
0x37CA2318, 38092260805180576, 225568708, 225568716, 8, 1440x900 
0x37CA2318, 38092260805843496, 225568772, 225568780, 8, 1440x900 
0x37CA2318, 38092260806522872, 225568844, 225568851, 7, 1440x900 
0x37CA2318, 38092260807173296, 225568902, 225568910, 8, 1440x900 
0x37CA2318, 38092260807818208, 225568971, 225568979, 8, 1440x900 
0x37CA2318, 38092260808487928, 225569039, 225569048, 9, 1440x900 
0x37CA2318, 38092260809150376, 225569102, 225569109, 7, 1440x900 
0x37CA2318, 38092260809805184, 225569169, 225569177, 8, 1440x900 
0x37CA2318, 38092260810474872, 225569237, 225569243, 6, 1440x900 
0x37CA2318, 38092260811125120, 225569303, 225569311, 8, 1440x900 
0x37CA2318, 38092260811787232, 225569367, 225569375, 8, 1440x900 
0x37CA2318, 38092260812448512, 225569437, 225569445, 8, 1440x900 
0x37CA2318, 38092260813108864, 225569502, 225569510, 8, 1440x900 
0x37CA2318, 38092260813760952, 225569568, 225569576, 8, 1440x900 
0x37CA2318, 38092260814441000, 225569632, 225569642, 10, 1440x900 
0x37CA2318, 38092260815099376, 225569697, 225569704, 7, 1440x900 
0x37CA2318, 38092260815759688, 225569761, 225569768, 7, 1440x900 
0x37CA2318, 38092260816411872, 225569827, 225569835, 8, 1440x900 
0x37CA2318, 38092260817081680, 225569893, 225569901, 8, 1440x900 
0x37CA2318, 38092260817742320, 225569963, 225569971, 8, 1440x900 
0x37CA2318, 38092260818394224, 225570028, 225570035, 7, 1440x900 
0x37CA2318, 38092260819059024, 225570092, 225570100, 8, 1440x900 
0x37CA2318, 38092260819737792, 225570162, 225570170, 8, 1440x900 
0x37CA2318, 38092260820389984, 225570227, 225570234, 7, 1440x900 
0x37CA2318, 38092260821113288, 225570297, 225570305, 8, 1440x900 
0x37CA2318, 38092260821711136, 225570357, 225570364, 7, 1440x900 
0x37CA2318, 38092260822363352, 225570422, 225570429, 7, 1440x900 
0x37CA2318, 38092260823042504, 225570488, 225570496, 8, 1440x900 
0x37CA2318, 38092260823693056, 225570553, 225570561, 8, 1440x900 
0x37CA2318, 38092260824192200, 225570610, 225570623, 13, 1440x900 
0x37CA2318, 38092260824851856, 225570672, 225570679, 7, 1440x900 
0x37CA2318, 38092260825477856, 225570733, 225570740, 7, 1440x900 
0x37CA2318, 38092260826137736, 225570798, 225570806, 8, 1440x900 
0x37CA2318, 38092260826801360, 225570868, 225570874, 6, 1440x900 
0x37CA2318, 38092260827461176, 225570932, 225570939, 7, 1440x900 
0x37CA2318, 38092260828122240, 225570998, 225571005, 7, 1440x900 
0x37CA2318, 38092260828783064, 225571063, 225571070, 7, 1440x900 
0x37CA2318, 38092260829442336, 225571128, 225571136, 8, 1440x900 
0x37CA2318, 38092260830101976, 225571197, 225571204, 7, 1440x900 
0x37CA2318, 38092260830766856, 225571262, 225571269, 7, 1440x900 
0x37CA2318, 38092260831427752, 225571328, 225571336, 8, 1440x900 
0x37CA2318, 38092260832086504, 225571393, 225571401, 8, 1440x900 
0x37CA2318, 38092260832751312, 225571462, 225571469, 7, 1440x900 
0x37CA2318, 38092260833417704, 225571528, 225571538, 10, 1440x900 
0x37CA2318, 38092260834104120, 225571597, 225571604, 7, 1440x900 
0x37CA2318, 38092260835392936, 225571723, 225571731, 8, 1440x900 
0x37CA2318, 38092260836051736, 225571792, 225571799, 7, 1440x900 
0x37CA2318, 38092260836712304, 225571858, 225571866, 8, 1440x900 
0x37CA2318, 38092260837370832, 225571923, 225571931, 8, 1440x900 
0x37CA2318, 38092260838039744, 225571988, 225571995, 7, 1440x900 
0x37CA2318, 38092260838700544, 225572057, 225572064, 7, 1440x900 
0x37CA2318, 38092260839378000, 225572122, 225572130, 8, 1440x900 
0x37CA2318, 38092260840026520, 225572195, 225572211, 16, 1440x900 
0x37CA2318, 38092260840755376, 225572269, 225572291, 22, 1440x900 
0x37CA2318, 38092260841380320, 225572323, 225572331, 8, 1440x900 
0x37CA2318, 38092260841999832, 225572383, 225572405, 22, 1440x900 
0x37CA2318, 38092260842696816, 225572453, 225572472, 19, 1440x900 
0x37CA2318, 38092260843352784, 225572522, 225572531, 9, 1440x900 
0x37CA2318, 38092260843982976, 225572582, 225572592, 10, 1440x900 
0x37CA2318, 38092260844643216, 225572648, 225572655, 7, 1440x900 
0x37CA2318, 38092260845299616, 225572717, 225572726, 9, 1440x900 
0x37CA2318, 38092260845959704, 225572782, 225572788, 6, 1440x900 
0x37CA2318, 38092260846619720, 225572847, 225572854, 7, 1440x900 
0x37CA2318, 38092260847279648, 225572913, 225572920, 7, 1440x900 
0x37CA2318, 38092260847950088, 225572982, 225572990, 8, 1440x900 
0x37CA2318, 38092260848618104, 225573054, 225573062, 8, 1440x900 
0x37CA2318, 38092260849276056, 225573115, 225573124, 9, 1440x900 
0x37CA2318, 38092260849933464, 225573182, 225573189, 7, 1440x900 
0x37CA2318, 38092260850599744, 225573247, 225573255, 8, 1440x900 
0x37CA2318, 38092260851266744, 225573312, 225573319, 7, 1440x900 
0x37CA2318, 38092260851922408, 225573377, 225573385, 8, 1440x900 
0x37CA2318, 38092260852590072, 225573448, 225573455, 7, 1440x900 
0x37CA2318, 38092260853252304, 225573517, 225573525, 8, 1440x900 
0x37CA2318, 38092260853924672, 225573583, 225573591, 8, 1440x900 
0x37CA2318, 38092260854575944, 225573647, 225573655, 8, 1440x900 
0x37CA2318, 38092260855229392, 225573712, 225573719, 7, 1440x900 
0x37CA2318, 38092260855900608, 225573777, 225573784, 7, 1440x900 
0x37CA2318, 38092260856558280, 225573843, 225573851, 8, 1440x900 
0x37CA2318, 38092260857210728, 225573908, 225573917, 9, 1440x900 
0x37CA2318, 38092260857881824, 225573973, 225573981, 8, 1440x900 
0x37CA2318, 38092260858544896, 225574042, 225574051, 9, 1440x900 
0x37CA2318, 38092260859187040, 225574103, 225574111, 8, 1440x900 
0x37CA2318, 38092260859941880, 225574183, 225574192, 9, 1440x900 
0x37CA2318, 38092260860510600, 225574238, 225574247, 9, 1440x900 
0x37CA2318, 38092260861357928, 225574328, 225574337, 9, 1440x900 
0x37CA2318, 38092260862028728, 225574392, 225574400, 8, 1440x900 
0x37CA2318, 38092260862636304, 225574448, 225574456, 8, 1440x900 
0x37CA2318, 38092260863151200, 225574502, 225574509, 7, 1440x900 
0x37CA2318, 38092260863810992, 225574567, 225574575, 8, 1440x900 
0x37CA2318, 38092260864485584, 225574638, 225574645, 7, 1440x900 
0x37CA2318, 38092260865140344, 225574702, 225574710, 8, 1440x900 
0x37CA2318, 38092260865793696, 225574766, 225574773, 7, 1440x900 
0x37CA2318, 38092260866456400, 225574832, 225574840, 8, 1440x900 
0x37CA2318, 38092260867115432, 225574897, 225574904, 7, 1440x900 
0x37CA2318, 38092260867784288, 225574963, 225574971, 8, 1440x900 
0x37CA2318, 38092260868447552, 225575032, 225575039, 7, 1440x900 
0x37CA2318, 38092260869105176, 225575097, 225575104, 7, 1440x900 
0x37CA2318, 38092260869956888, 225575183, 225575192, 9, 1440x900 
0x37CA2318, 38092260870486856, 225575237, 225575244, 7, 1440x900 
0x37CA2318, 38092260871385760, 225575323, 225575331, 8, 1440x900 
0x37CA2318, 38092260871957712, 225575382, 225575389, 7, 1440x900 
0x37CA2318, 38092260872618016, 225575448, 225575456, 8, 1440x900 
0x37CA2318, 38092260873293864, 225575523, 225575531, 8, 1440x900 
0x37CA2318, 38092260873932368, 225575578, 225575586, 8, 1440x900 
0x37CA2318, 38092260874596360, 225575647, 225575655, 8, 1440x900 
0x37CA2318, 38092260875259864, 225575718, 225575726, 8, 1440x900 
0x37CA2318, 38092260875920984, 225575782, 225575790, 8, 1440x900 
0x37CA2318, 38092260876574344, 225575848, 225575856, 8, 1440x900 
0x37CA2318, 38092260877238744, 225575912, 225575920, 8, 1440x900 
0x37CA2318, 38092260877900160, 225575982, 225575990, 8, 1440x900 
0x37CA2318, 38092260878564984, 225576047, 225576057, 10, 1440x900 
0x37CA2318, 38092260879031488, 225576088, 225576096, 8, 1440x900 
0x37CA2318, 38092260879885504, 225576173, 225576181, 8, 1440x900 
0x37CA2318, 38092260880543968, 225576238, 225576247, 9, 1440x900 
0x37CA2318, 38092260881207224, 225576312, 225576320, 8, 1440x900 
0x37CA2318, 38092260881868064, 225576378, 225576386, 8, 1440x900 
0x37CA2318, 38092260882537712, 225576442, 225576450, 8, 1440x900 
0x37CA2318, 38092260883188648, 225576508, 225576516, 8, 1440x900 
0x37CA2318, 38092260883857352, 225576574, 225576582, 8, 1440x900 
0x37CA2318, 38092260884315744, 225576616, 225576626, 10, 1440x900 
0x37CA2318, 38092260885000696, 225576688, 225576697, 9, 1440x900 
0x37CA2318, 38092260885743000, 225576765, 225576778, 13, 1440x900 
0x37CA2318, 38092260886334616, 225576817, 225576827, 10, 1440x900 
0x37CA2318, 38092260886969760, 225576885, 225576892, 7, 1440x900 
0x37CA2318, 38092260887650360, 225576949, 225576959, 10, 1440x900 
0x37CA2318, 38092260888280064, 225577013, 225577020, 7, 1440x900 
0x37CA2318, 38092260888940568, 225577079, 225577087, 8, 1440x900 
0x37CA2318, 38092260889600032, 225577143, 225577151, 8, 1440x900 
0x37CA2318, 38092260890262072, 225577212, 225577219, 7, 1440x900 
0x37CA2318, 38092260890924384, 225577278, 225577287, 9, 1440x900 
0x37CA2318, 38092260891584344, 225577347, 225577355, 8, 1440x900 
0x37CA2318, 38092260892245112, 225577412, 225577419, 7, 1440x900 
0x37CA2318, 38092260892904088, 225577476, 225577484, 8, 1440x900 
0x37CA2318, 38092260893636688, 225577552, 225577560, 8, 1440x900 
0x37CA2318, 38092260894223456, 225577607, 225577616, 9, 1440x900 
0x37CA2318, 38092260894883640, 225577673, 225577682, 9, 1440x900 
0x37CA2318, 38092260895544576, 225577741, 225577749, 8, 1440x900 
0x37CA2318, 38092260896239656, 225577809, 225577817, 8, 1440x900 
0x37CA2318, 38092260896922184, 225577878, 225577885, 7, 1440x900 
0x37CA2318, 38092260897755792, 225577963, 225577983, 20, 1440x900 
0x37CA2318, 38092260898406648, 225578027, 225578034, 7, 1440x900 
0x37CA2318, 38092260899066280, 225578092, 225578100, 8, 1440x900 
0x37CA2318, 38092260899736416, 225578158, 225578166, 8, 1440x900 
0x37CA2318, 38092260900398272, 225578227, 225578234, 7, 1440x900 
0x37CA2318, 38092260901067528, 225578293, 225578300, 7, 1440x900 
0x37CA2318, 38092260901537696, 225578341, 225578348, 7, 1440x900 
0x37CA2318, 38092260902371016, 225578423, 225578430, 7, 1440x900 
0x37CA2318, 38092260903046200, 225578492, 225578500, 8, 1440x900 
0x37CA2318, 38092260903710560, 225578562, 225578570, 8, 1440x900 
0x37CA2318, 38092260904178376, 225578608, 225578616, 8, 1440x900 
0x37CA2318, 38092260905032512, 225578688, 225578695, 7, 1440x900 
0x37CA2318, 38092260905684336, 225578753, 225578761, 8, 1440x900 
0x37CA2318, 38092260906344560, 225578822, 225578830, 8, 1440x900 
0x37CA2318, 38092260906824336, 225578869, 225578878, 9, 1440x900 
0x37CA2318, 38092260907683968, 225578954, 225578961, 7, 1440x900 
0x37CA2318, 38092260908345280, 225579023, 225579031, 8, 1440x900 
0x37CA2318, 38092260909005448, 225579089, 225579097, 8, 1440x900 
0x37CA2318, 38092260909674184, 225579153, 225579161, 8, 1440x900 
0x37CA2318, 38092260910337496, 225579223, 225579231, 8, 1440x900 
0x37CA2318, 38092260910987920, 225579288, 225579296, 8, 1440x900 
0x37CA2318, 38092260911647680, 225579352, 225579361, 9, 1440x900 
0x37CA2318, 38092260912144240, 225579404, 225579412, 8, 1440x900 
0x37CA2318, 38092260912969352, 225579488, 225579496, 8, 1440x900 
0x37CA2318, 38092260913622808, 225579553, 225579561, 8, 1440x900 
0x37CA2318, 38092260914300752, 225579618, 225579626, 8, 1440x900 
0x37CA2318, 38092260914951648, 225579681, 225579688, 7, 1440x900 
0x37CA2318, 38092260915611208, 225579747, 225579755, 8, 1440x900 
0x37CA2318, 38092260916266048, 225579817, 225579824, 7, 1440x900 
0x37CA2318, 38092260916936952, 225579883, 225579891, 8, 1440x900 
0x37CA2318, 38092260918249184, 225580013, 225580020, 7, 1440x900 
0x37CA2318, 38092260918917976, 225580078, 225580086, 8, 1440x900 
0x37CA2318, 38092260919578416, 225580147, 225580154, 7, 1440x900 
0x37CA2318, 38092260920240800, 225580212, 225580219, 7, 1440x900 
0x37CA2318, 38092260920901920, 225580278, 225580286, 8, 1440x900 
0x37CA2318, 38092260921561200, 225580342, 225580350, 8, 1440x900 
0x37CA2318, 38092260922220408, 225580408, 225580417, 9, 1440x900 
0x37CA2318, 38092260922788872, 225580466, 225580474, 8, 1440x900 
0x37CA2318, 38092260923570160, 225580544, 225580553, 9, 1440x900 
0x37CA2318, 38092260924225368, 225580613, 225580621, 8, 1440x900 
0x37CA2318, 38092260924887848, 225580678, 225580686, 8, 1440x900 
0x37CA2318, 38092260925549304, 225580744, 225580751, 7, 1440x900 
0x37CA2318, 38092260926211120, 225580807, 225580814, 7, 1440x900 
0x37CA2318, 38092260926873392, 225580873, 225580882, 9, 1440x900 
0x37CA2318, 38092260927527096, 225580942, 225580950, 8, 1440x900 
0x37CA2318, 38092260928011552, 225580992, 225581000, 8, 1440x900 
0x37CA2318, 38092260928850856, 225581072, 225581081, 9, 1440x900 
0x37CA2318, 38092260929502584, 225581139, 225581147, 8, 1440x900 
0x37CA2318, 38092260930171680, 225581202, 225581210, 8, 1440x900 
0x37CA2318, 38092260930827136, 225581273, 225581282, 9, 1440x900 
0x37CA2318, 38092260931499216, 225581342, 225581350, 8, 1440x900 
0x37CA2318, 38092260932159072, 225581403, 225581412, 9, 1440x900 
0x37CA2318, 38092260932820576, 225581472, 225581480, 8, 1440x900 
0x37CA2318, 38092260933299352, 225581522, 225581530, 8, 1440x900 
0x37CA2318, 38092260934134248, 225581604, 225581612, 8, 1440x900 
0x37CA2318, 38092260934795424, 225581668, 225581676, 8, 1440x900 
0x37CA2318, 38092260935455392, 225581737, 225581745, 8, 1440x900 
0x37CA2318, 38092260936124096, 225581798, 225581805, 7, 1440x900 
0x37CA2318, 38092260936775664, 225581868, 225581876, 8, 1440x900 
0x37CA2318, 38092260937446336, 225581932, 225581941, 9, 1440x900 
0x37CA2318, 38092260938097744, 225581998, 225582006, 8, 1440x900 
0x37CA2318, 38092260938590320, 225582048, 225582056, 8, 1440x900 
0x37CA2318, 38092260939426464, 225582132, 225582140, 8, 1440x900 
0x37CA2318, 38092260940086656, 225582197, 225582205, 8, 1440x900 
0x37CA2318, 38092260940750160, 225582262, 225582269, 7, 1440x900 
0x37CA2318, 38092260941402944, 225582328, 225582336, 8, 1440x900 
0x37CA2318, 38092260942078944, 225582398, 225582406, 8, 1440x900 
0x37CA2318, 38092260942731720, 225582463, 225582471, 8, 1440x900 
0x37CA2318, 38092260943400816, 225582528, 225582536, 8, 1440x900 
0x37CA2318, 38092260943886248, 225582579, 225582588, 9, 1440x900 
0x37CA2318, 38092260944715776, 225582662, 225582669, 7, 1440x900 
0x37CA2318, 38092260945381184, 225582727, 225582735, 8, 1440x900 
0x37CA2318, 38092260946050936, 225582793, 225582801, 8, 1440x900 
0x37CA2318, 38092260946701816, 225582857, 225582864, 7, 1440x900 
0x37CA2318, 38092260947362120, 225582922, 225582929, 7, 1440x900 
0x37CA2318, 38092260948025360, 225582993, 225583001, 8, 1440x900 
0x37CA2318, 38092260948688192, 225583059, 225583068, 9, 1440x900 
0x37CA2318, 38092260949171816, 225583107, 225583115, 8, 1440x900 
0x37CA2318, 38092260950000504, 225583188, 225583196, 8, 1440x900 
0x37CA2318, 38092260950671488, 225583258, 225583266, 8, 1440x900 
0x37CA2318, 38092260951323952, 225583323, 225583331, 8, 1440x900 
0x37CA2318, 38092260951994560, 225583388, 225583396, 8, 1440x900 
0x37CA2318, 38092260952653408, 225583452, 225583460, 8, 1440x900 
0x37CA2318, 38092260953316800, 225583523, 225583531, 8, 1440x900 
0x37CA2318, 38092260953972408, 225583588, 225583597, 9, 1440x900 
0x37CA2318, 38092260954460912, 225583633, 225583641, 8, 1440x900 
0x37CA2318, 38092260955312416, 225583717, 225583724, 7, 1440x900 
0x37CA2318, 38092260955971896, 225583783, 225583791, 8, 1440x900 
0x37CA2318, 38092260956621728, 225583848, 225583855, 7, 1440x900 
0x37CA2318, 38092260957293696, 225583915, 225583923, 8, 1440x900 
0x37CA2318, 38092260957945104, 225583982, 225583989, 7, 1440x900 
0x37CA2318, 38092260958602072, 225584046, 225584053, 7, 1440x900 
0x37CA2318, 38092260959282528, 225584117, 225584124, 7, 1440x900 
0x37CA2318, 38092260959754592, 225584162, 225584170, 8, 1440x900 
0x37CA2318, 38092260960595816, 225584248, 225584255, 7, 1440x900 
0x37CA2318, 38092260961252152, 225584312, 225584320, 8, 1440x900 
0x37CA2318, 38092260961915720, 225584378, 225584386, 8, 1440x900 
0x37CA2318, 38092260962578880, 225584448, 225584456, 8, 1440x900 
0x37CA2318, 38092260963245064, 225584513, 225584522, 9, 1440x900 
0x37CA2318, 38092260963899824, 225584576, 225584584, 8, 1440x900 
0x37CA2318, 38092260964555912, 225584643, 225584650, 7, 1440x900 
0x37CA2318, 38092260965044168, 225584694, 225584702, 8, 1440x900 
0x37CA2318, 38092260965886272, 225584777, 225584785, 8, 1440x900 
0x37CA2318, 38092260966545760, 225584843, 225584852, 9, 1440x900 
0x37CA2318, 38092260967203992, 225584908, 225584915, 7, 1440x900 
0x37CA2318, 38092260967875024, 225584973, 225584980, 7, 1440x900 
0x37CA2318, 38092260968522048, 225585038, 225585045, 7, 1440x900 
0x37CA2318, 38092260969196016, 225585107, 225585115, 8, 1440x900 
0x37CA2318, 38092260969847520, 225585172, 225585179, 7, 1440x900 
0x37CA2318, 38092260970325280, 225585218, 225585226, 8, 1440x900 
0x37CA2318, 38092260971162104, 225585302, 225585310, 8, 1440x900 
0x37CA2318, 38092260971837960, 225585372, 225585380, 8, 1440x900 
0x37CA2318, 38092260972488888, 225585436, 225585444, 8, 1440x900 
0x37CA2318, 38092260973150944, 225585502, 225585509, 7, 1440x900 
0x37CA2318, 38092260973812864, 225585567, 225585574, 7, 1440x900 
0x37CA2318, 38092260974470888, 225585638, 225585646, 8, 1440x900 
0x37CA2318, 38092260975131520, 225585703, 225585711, 8, 1440x900 
0x37CA2318, 38092260975615744, 225585753, 225585761, 8, 1440x900 
0x37CA2318, 38092260976461280, 225585834, 225585842, 8, 1440x900 
0x37CA2318, 38092260977130664, 225585902, 225585910, 8, 1440x900 
0x37CA2318, 38092260977782232, 225585963, 225585970, 7, 1440x900 
0x37CA2318, 38092260978436232, 225586033, 225586041, 8, 1440x900 
0x37CA2318, 38092260979113168, 225586113, 225586121, 8, 1440x900 
0x37CA2318, 38092260979763440, 225586162, 225586170, 8, 1440x900 
0x37CA2318, 38092260980426536, 225586233, 225586241, 8, 1440x900 
0x37CA2318, 38092260980925544, 225586282, 225586289, 7, 1440x900 
0x37CA2318, 38092260981751904, 225586362, 225586370, 8, 1440x900 
0x37CA2318, 38092260982406304, 225586432, 225586440, 8, 1440x900 
0x37CA2318, 38092260983075816, 225586497, 225586505, 8, 1440x900 
0x37CA2318, 38092260983725480, 225586563, 225586571, 8, 1440x900 
0x37CA2318, 38092260984386512, 225586628, 225586636, 8, 1440x900 
0x37CA2318, 38092260985056152, 225586698, 225586706, 8, 1440x900 
0x37CA2318, 38092260985776128, 225586763, 225586770, 7, 1440x900 
0x37CA2318, 38092260986252536, 225586812, 225586819, 7, 1440x900 
0x37CA2318, 38092260987100896, 225586897, 225586904, 7, 1440x900 
0x37CA2318, 38092260987762304, 225586963, 225586971, 8, 1440x900 
0x37CA2318, 38092260988423088, 225587028, 225587037, 9, 1440x900 
0x37CA2318, 38092260989083744, 225587098, 225587106, 8, 1440x900 
0x37CA2318, 38092260989752464, 225587164, 225587172, 8, 1440x900 
0x37CA2318, 38092260990405168, 225587233, 225587241, 8, 1440x900 
0x37CA2318, 38092260991074096, 225587297, 225587304, 7, 1440x900 
0x37CA2318, 38092260992377400, 225587423, 225587431, 8, 1440x900 
0x37CA2318, 38092260993048024, 225587492, 225587499, 7, 1440x900 
0x37CA2318, 38092260993700288, 225587557, 225587564, 7, 1440x900 
0x37CA2318, 38092260994362336, 225587622, 225587630, 8, 1440x900 
0x37CA2318, 38092260995033552, 225587693, 225587701, 8, 1440x900 
0x37CA2318, 38092260995695048, 225587757, 225587765, 8, 1440x900 
0x37CA2318, 38092260996363712, 225587828, 225587836, 8, 1440x900 
0x37CA2318, 38092260996830792, 225587868, 225587876, 8, 1440x900 
0x37CA2318, 38092260997675888, 225587958, 225587966, 8, 1440x900 
0x37CA2318, 38092260998337136, 225588021, 225588028, 7, 1440x900 
0x37CA2318, 38092260998994880, 225588088, 225588096, 8, 1440x900 
0x37CA2318, 38092260999657424, 225588157, 225588165, 8, 1440x900 
0x37CA2318, 38092261000318784, 225588222, 225588230, 8, 1440x900 
0x37CA2318, 38092261000971320, 225588288, 225588296, 8, 1440x900 
0x37CA2318, 38092261001650664, 225588353, 225588360, 7, 1440x900 
0x37CA2318, 38092261002119344, 225588403, 225588410, 7, 1440x900 
0x37CA2318, 38092261002973504, 225588484, 225588492, 8, 1440x900 
0x37CA2318, 38092261003623648, 225588552, 225588560, 8, 1440x900 
0x37CA2318, 38092261004280704, 225588613, 225588621, 8, 1440x900 
0x37CA2318, 38092261004953008, 225588682, 225588690, 8, 1440x900 
0x37CA2318, 38092261005621384, 225588752, 225588760, 8, 1440x900 
0x37CA2318, 38092261006272816, 225588817, 225588825, 8, 1440x900 
0x37CA2318, 38092261006941696, 225588882, 225588890, 8, 1440x900 
0x37CA2318, 38092261007464032, 225588938, 225588946, 8, 1440x900 
0x37CA2318, 38092261008263376, 225589018, 225589026, 8, 1440x900 
0x37CA2318, 38092261008932632, 225589078, 225589085, 7, 1440x900 
0x37CA2318, 38092261009590560, 225589143, 225589151, 8, 1440x900 
0x37CA2318, 38092261010252880, 225589211, 225589218, 7, 1440x900 
0x37CA2318, 38092261010914112, 225589278, 225589285, 7, 1440x900 
0x37CA2318, 38092261011576304, 225589348, 225589356, 8, 1440x900 
0x37CA2318, 38092261012237680, 225589413, 225589421, 8, 1440x900 
0x37CA2318, 38092261012725248, 225589463, 225589473, 10, 1440x900 
0x37CA2318, 38092261013557504, 225589542, 225589549, 7, 1440x900 
0x37CA2318, 38092261014212328, 225589607, 225589614, 7, 1440x900 
0x37CA2318, 38092261014883016, 225589677, 225589685, 8, 1440x900 
0x37CA2318, 38092261015543232, 225589743, 225589751, 8, 1440x900 
0x37CA2318, 38092261016204360, 225589808, 225589816, 8, 1440x900 
0x37CA2318, 38092261016875136, 225589877, 225589886, 9, 1440x900 
0x37CA2318, 38092261017525576, 225589942, 225589950, 8, 1440x900 
0x37CA2318, 38092261018006944, 225589992, 225590000, 8, 1440x900 
0x37CA2318, 38092261018848416, 225590079, 225590087, 8, 1440x900 
0x37CA2318, 38092261019497480, 225590137, 225590144, 7, 1440x900 
0x37CA2318, 38092261020167608, 225590203, 225590210, 7, 1440x900 
0x37CA2318, 38092261020836928, 225590272, 225590279, 7, 1440x900 
0x37CA2318, 38092261021496448, 225590337, 225590344, 7, 1440x900 
0x37CA2318, 38092261022156312, 225590402, 225590409, 7, 1440x900 
0x37CA2318, 38092261022825688, 225590467, 225590474, 7, 1440x900 
0x37CA2318, 38092261023293472, 225590516, 225590523, 7, 1440x900 
0x37CA2318, 38092261024136704, 225590598, 225590606, 8, 1440x900 
0x37CA2318, 38092261024790104, 225590666, 225590674, 8, 1440x900 
0x37CA2318, 38092261025469320, 225590733, 225590740, 7, 1440x900 
0x37CA2318, 38092261026130232, 225590803, 225590811, 8, 1440x900 
0x37CA2318, 38092261026781176, 225590867, 225590875, 8, 1440x900 
0x37CA2318, 38092261027445056, 225590934, 225590942, 8, 1440x900 
0x37CA2318, 38092261028104664, 225590998, 225591006, 8, 1440x900 
0x37CA2318, 38092261028644848, 225591052, 225591060, 8, 1440x900 
0x37CA2318, 38092261029432808, 225591128, 225591135, 7, 1440x900 
0x37CA2318, 38092261030093712, 225591198, 225591205, 7, 1440x900 
0x37CA2318, 38092261030763144, 225591259, 225591268, 9, 1440x900 
0x37CA2318, 38092261031414232, 225591328, 225591335, 7, 1440x900 
0x37CA2318, 38092261032065408, 225591392, 225591400, 8, 1440x900 
0x37CA2318, 38092261032739096, 225591462, 225591469, 7, 1440x900 
0x37CA2318, 38092261033407656, 225591528, 225591536, 8, 1440x900 
0x37CA2318, 38092261033891112, 225591577, 225591585, 8, 1440x900 
0x37CA2318, 38092261034729640, 225591663, 225591671, 8, 1440x900 
0x37CA2318, 38092261035397856, 225591728, 225591734, 6, 1440x900 
0x37CA2318, 38092261036047880, 225591792, 225591798, 6, 1440x900 
0x37CA2318, 38092261036718168, 225591857, 225591864, 7, 1440x900 
0x37CA2318, 38092261037382792, 225591926, 225591934, 8, 1440x900 
0x37CA2318, 38092261038032232, 225591988, 225591996, 8, 1440x900 
0x37CA2318, 38092261038695184, 225592058, 225592066, 8, 1440x900 
0x37CA2318, 38092261039187136, 225592109, 225592117, 8, 1440x900 
0x37CA2318, 38092261040026728, 225592193, 225592201, 8, 1440x900 
0x37CA2318, 38092261040687640, 225592258, 225592266, 8, 1440x900 
0x37CA2318, 38092261041348776, 225592324, 225592332, 8, 1440x900 
0x37CA2318, 38092261042008768, 225592390, 225592398, 8, 1440x900 
0x37CA2318, 38092261042669912, 225592453, 225592462, 9, 1440x900 
0x37CA2318, 38092261043339064, 225592521, 225592528, 7, 1440x900 
0x37CA2318, 38092261044002648, 225592587, 225592594, 7, 1440x900 
0x37CA2318, 38092261044491888, 225592637, 225592644, 7, 1440x900 
0x37CA2318, 38092261045333400, 225592718, 225592726, 8, 1440x900 
0x37CA2318, 38092261045982792, 225592788, 225592796, 8, 1440x900 
0x37CA2318, 38092261046642416, 225592852, 225592860, 8, 1440x900 
0x37CA2318, 38092261047304656, 225592918, 225592927, 9, 1440x900 
0x37CA2318, 38092261047966864, 225592988, 225592996, 8, 1440x900 
0x37CA2318, 38092261048625120, 225593053, 225593060, 7, 1440x900 
0x37CA2318, 38092261049292784, 225593118, 225593126, 8, 1440x900 
0x37CA2318, 38092261049837104, 225593173, 225593182, 9, 1440x900 
0x37CA2318, 38092261050617352, 225593252, 225593260, 8, 1440x900 
0x37CA2318, 38092261051219728, 225593314, 225593322, 8, 1440x900 
0x37CA2318, 38092261051743104, 225593368, 225593376, 8, 1440x900 
0x37CA2318, 38092261052403904, 225593428, 225593445, 17, 1440x900 
0x37CA2318, 38092261053103912, 225593498, 225593505, 7, 1440x900 
0x37CA2318, 38092261053738544, 225593562, 225593569, 7, 1440x900 
0x37CA2318, 38092261054398664, 225593627, 225593636, 9, 1440x900 
0x37CA2318, 38092261055092720, 225593693, 225593702, 9, 1440x900 
0x37CA2318, 38092261055763648, 225593762, 225593783, 21, 1440x900 
0x37CA2318, 38092261056443656, 225593832, 225593839, 7, 1440x900 
0x37CA2318, 38092261057049664, 225593892, 225593899, 7, 1440x900 
0x37CA2318, 38092261058367376, 225594022, 225594029, 7, 1440x900 
0x37CA2318, 38092261059067224, 225594092, 225594099, 7, 1440x900 
0x37CA2318, 38092261059693592, 225594153, 225594160, 7, 1440x900 
0x37CA2318, 38092261060396968, 225594223, 225594243, 20, 1440x900 
0x37CA2318, 38092261061057624, 225594292, 225594300, 8, 1440x900 
0x37CA2318, 38092261061689928, 225594353, 225594361, 8, 1440x900 
0x37CA2318, 38092261062355632, 225594424, 225594434, 10, 1440x900 
0x37CA2318, 38092261063041056, 225594488, 225594496, 8, 1440x900 
0x37CA2318, 38092261063679864, 225594554, 225594561, 7, 1440x900 
0x37CA2318, 38092261064340528, 225594622, 225594636, 14, 1440x900 
0x37CA2318, 38092261065110312, 225594698, 225594705, 7, 1440x900 
0x37CA2318, 38092261065677144, 225594753, 225594760, 7, 1440x900 
0x37CA2318, 38092261066360128, 225594822, 225594830, 8, 1440x900 
0x37CA2318, 38092261067013832, 225594890, 225594900, 10, 1440x900 
0x37CA2318, 38092261067678832, 225594953, 225594962, 9, 1440x900 
0x37CA2318, 38092261068334448, 225595017, 225595025, 8, 1440x900 
0x37CA2318, 38092261069027704, 225595087, 225595095, 8, 1440x900 
0x37CA2318, 38092261069644464, 225595152, 225595160, 8, 1440x900 
0x37CA2318, 38092261070328320, 225595217, 225595225, 8, 1440x900 
0x37CA2318, 38092261070979984, 225595288, 225595295, 7, 1440x900 
0x37CA2318, 38092261071652936, 225595353, 225595359, 6, 1440x900 
0x37CA2318, 38092261072351192, 225595423, 225595431, 8, 1440x900 
0x37CA2318, 38092261072961680, 225595483, 225595491, 8, 1440x900 
0x37CA2318, 38092261073615504, 225595550, 225595558, 8, 1440x900 
0x37CA2318, 38092261074276680, 225595613, 225595624, 11, 1440x900 
0x37CA2318, 38092261074943056, 225595678, 225595690, 12, 1440x900 
0x37CA2318, 38092261075602648, 225595749, 225595756, 7, 1440x900 
0x37CA2318, 38092261076262960, 225595813, 225595824, 11, 1440x900 
0x37CA2318, 38092261076927088, 225595881, 225595889, 8, 1440x900 
0x37CA2318, 38092261077584568, 225595944, 225595952, 8, 1440x900 
0x37CA2318, 38092261078442976, 225596032, 225596040, 8, 1440x900 
0x37CA2318, 38092261079068496, 225596092, 225596101, 9, 1440x900 
0x37CA2318, 38092261079834864, 225596173, 225596187, 14, 1440x900 
0x37CA2318, 38092261080251208, 225596209, 225596219, 10, 1440x900 
0x37CA2318, 38092261081161584, 225596305, 225596334, 29, 1440x900 
0x37CA2318, 38092261081587400, 225596343, 225596451, 108, 1440x900 
0x37CA2318, 38092261082748808, 225596469, 225596546, 77, 1440x900 
0x37CA2318, 38092261083687024, 225596557, 225596568, 11, 1440x900 
0x37CA2318, 38092261083929048, 225596578, 225596591, 13, 1440x900 
0x37CA2318, 38092261084405320, 225596627, 225596635, 8, 1440x900 
0x37CA2318, 38092261085026816, 225596688, 225596695, 7, 1440x900 
0x37CA2318, 38092261085850280, 225596772, 225596779, 7, 1440x900 
0x37CA2318, 38092261086355488, 225596822, 225596829, 7, 1440x900 
0x37CA2318, 38092261087671184, 225596952, 225596959, 7, 1440x900 
0x37CA2318, 38092261088334976, 225597023, 225597030, 7, 1440x900 
0x37CA2318, 38092261088994632, 225597088, 225597095, 7, 1440x900 
0x37CA2318, 38092261089655296, 225597152, 225597160, 8, 1440x900 
0x37CA2318, 38092261090314736, 225597217, 225597224, 7, 1440x900 
0x37CA2318, 38092261090980384, 225597284, 225597291, 7, 1440x900 
0x37CA2318, 38092261091646328, 225597353, 225597362, 9, 1440x900 
0x37CA2318, 38092261092291080, 225597417, 225597424, 7, 1440x900 
0x37CA2318, 38092261092984632, 225597483, 225597491, 8, 1440x900 
0x37CA2318, 38092261093618104, 225597549, 225597555, 6, 1440x900 
0x37CA2318, 38092261094279720, 225597613, 225597620, 7, 1440x900 
0x37CA2318, 38092261094935888, 225597678, 225597686, 8, 1440x900 
0x37CA2318, 38092261095595648, 225597747, 225597753, 6, 1440x900 
0x37CA2318, 38092261096260416, 225597812, 225597819, 7, 1440x900 
0x37CA2318, 38092261096915752, 225597878, 225597884, 6, 1440x900 
0x37CA2318, 38092261097577368, 225597943, 225597950, 7, 1440x900 
0x37CA2318, 38092261098908496, 225598079, 225598088, 9, 1440x900 
0x37CA2318, 38092261099441472, 225598128, 225598137, 9, 1440x900 
0x37CA2318, 38092261100058712, 225598193, 225598199, 6, 1440x900 
0x37CA2318, 38092261100721232, 225598258, 225598267, 9, 1440x900 
0x37CA2318, 38092261101571232, 225598342, 225598349, 7, 1440x900 
0x37CA2318, 38092261102250344, 225598412, 225598419, 7, 1440x900 
0x37CA2318, 38092261102901912, 225598476, 225598483, 7, 1440x900 
0x37CA2318, 38092261103559656, 225598542, 225598549, 7, 1440x900 
0x37CA2318, 38092261104229608, 225598607, 225598615, 8, 1440x900 
0x37CA2318, 38092261104882192, 225598673, 225598680, 7, 1440x900 
0x37CA2318, 38092261105560960, 225598742, 225598750, 8, 1440x900 
0x37CA2318, 38092261106020816, 225598788, 225598795, 7, 1440x900 
0x37CA2318, 38092261106885048, 225598873, 225598881, 8, 1440x900 
0x37CA2318, 38092261107554632, 225598942, 225598948, 6, 1440x900 
0x37CA2318, 38092261108206376, 225599007, 225599014, 7, 1440x900 
0x37CA2318, 38092261108866320, 225599073, 225599081, 8, 1440x900 
0x37CA2318, 38092261109535360, 225599138, 225599146, 8, 1440x900 
0x37CA2318, 38092261110196424, 225599207, 225599214, 7, 1440x900 
0x37CA2318, 38092261110843024, 225599268, 225599276, 8, 1440x900 
0x37CA2318, 38092261111518000, 225599337, 225599344, 7, 1440x900 
0x37CA2318, 38092261112178560, 225599402, 225599410, 8, 1440x900 
0x37CA2318, 38092261112632928, 225599448, 225599457, 9, 1440x900 
0x37CA2318, 38092261113324880, 225599518, 225599525, 7, 1440x900 
0x37CA2318, 38092261114092048, 225599601, 225599613, 12, 1440x900 
0x37CA2318, 38092261114699384, 225599657, 225599665, 8, 1440x900 
0x37CA2318, 38092261115364824, 225599723, 225599730, 7, 1440x900 
0x37CA2318, 38092261116208136, 225599807, 225599814, 7, 1440x900 
0x37CA2318, 38092261116878488, 225599873, 225599880, 7, 1440x900 
0x37CA2318, 38092261117538120, 225599938, 225599946, 8, 1440x900 
0x37CA2318, 38092261118197952, 225600007, 225600015, 8, 1440x900 
0x37CA2318, 38092261118737280, 225600061, 225600069, 8, 1440x900 
0x37CA2318, 38092261119327440, 225600118, 225600126, 8, 1440x900 
0x37CA2318, 38092261119988456, 225600185, 225600192, 7, 1440x900 
0x37CA2318, 38092261120646928, 225600252, 225600259, 7, 1440x900 
0x37CA2318, 38092261121317824, 225600318, 225600326, 8, 1440x900 
0x37CA2318, 38092261121974976, 225600382, 225600390, 8, 1440x900 
0x37CA2318, 38092261122640096, 225600448, 225600457, 9, 1440x900 
0x37CA2318, 38092261123297568, 225600518, 225600525, 7, 1440x900 
0x37CA2318, 38092261123956000, 225600584, 225600591, 7, 1440x900 
0x37CA2318, 38092261124611248, 225600648, 225600656, 8, 1440x900 
0x37CA2318, 38092261125268024, 225600713, 225600720, 7, 1440x900 
0x37CA2318, 38092261125933120, 225600783, 225600791, 8, 1440x900 
0x37CA2318, 38092261126594216, 225600848, 225600856, 8, 1440x900 
0x37CA2318, 38092261127258528, 225600912, 225600919, 7, 1440x900 
0x37CA2318, 38092261127914320, 225600977, 225600985, 8, 1440x900 
0x37CA2318, 38092261128580008, 225601043, 225601050, 7, 1440x900 
0x37CA2318, 38092261129241632, 225601108, 225601116, 8, 1440x900 
0x37CA2318, 38092261129902272, 225601177, 225601185, 8, 1440x900 
0x37CA2318, 38092261130566736, 225601243, 225601251, 8, 1440x900 
0x37CA2318, 38092261131225792, 225601308, 225601316, 8, 1440x900 
0x37CA2318, 38092261131884304, 225601376, 225601384, 8, 1440x900 
0x37CA2318, 38092261132545680, 225601442, 225601450, 8, 1440x900 
0x37CA2318, 38092261133225296, 225601513, 225601521, 8, 1440x900 
0x37CA2318, 38092261133873600, 225601572, 225601580, 8, 1440x900 
0x37CA2318, 38092261134532176, 225601638, 225601646, 8, 1440x900 
0x37CA2318, 38092261135200032, 225601707, 225601715, 8, 1440x900 
0x37CA2318, 38092261135860512, 225601770, 225601779, 9, 1440x900 
0x37CA2318, 38092261136522128, 225601838, 225601846, 8, 1440x900 
0x37CA2318, 38092261137194224, 225601908, 225601916, 8, 1440x900 
0x37CA2318, 38092261137853968, 225601977, 225601985, 8, 1440x900 
0x37CA2318, 38092261138713360, 225602058, 225602067, 9, 1440x900 
0x37CA2318, 38092261139219280, 225602110, 225602119, 9, 1440x900 
0x37CA2318, 38092261139834704, 225602172, 225602180, 8, 1440x900 
0x37CA2318, 38092261140504704, 225602237, 225602246, 9, 1440x900 
0x37CA2318, 38092261141353424, 225602327, 225602335, 8, 1440x900 
0x37CA2318, 38092261142023024, 225602393, 225602402, 9, 1440x900 
0x37CA2318, 38092261142487456, 225602438, 225602447, 9, 1440x900 
0x37CA2318, 38092261143334384, 225602523, 225602531, 8, 1440x900 
0x37CA2318, 38092261143825448, 225602567, 225602576, 9, 1440x900 
0x37CA2318, 38092261144770360, 225602670, 225602689, 19, 1440x900 
0x37CA2318, 38092261145155592, 225602703, 225602712, 9, 1440x900 
0x37CA2318, 38092261146063360, 225602793, 225602799, 6, 1440x900 
0x37CA2318, 38092261146668856, 225602855, 225602887, 32, 1440x900 
0x37CA2318, 38092261147144352, 225602903, 225602911, 8, 1440x900 
0x37CA2318, 38092261147984640, 225602988, 225602996, 8, 1440x900 
0x37CA2318, 38092261148423240, 225603027, 225603086, 59, 1440x900 
0x37CA2318, 38092261149139856, 225603098, 225603107, 9, 1440x900 
0x37CA2318, 38092261149990288, 225603190, 225603198, 8, 1440x900 
0x37CA2318, 38092261150750080, 225603268, 225603276, 8, 1440x900 
0x37CA2318, 38092261151104272, 225603298, 225603353, 55, 1440x900 
0x37CA2318, 38092261151778120, 225603362, 225603371, 9, 1440x900 
0x37CA2318, 38092261152621464, 225603448, 225603455, 7, 1440x900 
0x37CA2318, 38092261153260544, 225603512, 225603519, 7, 1440x900 
0x37CA2318, 38092261153724888, 225603557, 225603564, 7, 1440x900 
0x37CA2318, 38092261154587728, 225603643, 225603652, 9, 1440x900 
0x37CA2318, 38092261155094424, 225603701, 225603713, 12, 1440x900 
0x37CA2318, 38092261155807336, 225603768, 225603776, 8, 1440x900 
0x37CA2318, 38092261156403184, 225603827, 225603834, 7, 1440x900 
0x37CA2318, 38092261157060560, 225603892, 225603899, 7, 1440x900 
0x37CA2318, 38092261157723152, 225603957, 225603965, 8, 1440x900 
0x37CA2318, 38092261158378128, 225604023, 225604031, 8, 1440x900 
0x37CA2318, 38092261159037944, 225604088, 225604096, 8, 1440x900 
0x37CA2318, 38092261159697368, 225604157, 225604165, 8, 1440x900 
0x37CA2318, 38092261160365760, 225604223, 225604230, 7, 1440x900 
0x37CA2318, 38092261161023528, 225604287, 225604296, 9, 1440x900 
0x37CA2318, 38092261161687152, 225604357, 225604364, 7, 1440x900 
0x37CA2318, 38092261162347000, 225604421, 225604429, 8, 1440x900 
0x37CA2318, 38092261163201016, 225604508, 225604516, 8, 1440x900 
0x37CA2318, 38092261163862032, 225604579, 225604588, 9, 1440x900 
0x37CA2318, 38092261164530656, 225604637, 225604646, 9, 1440x900 
0x37CA2318, 38092261165193184, 225604708, 225604717, 9, 1440x900 
0x37CA2318, 38092261165652808, 225604752, 225604760, 8, 1440x900 
0x37CA2318, 38092261166320104, 225604823, 225604831, 8, 1440x900 
0x37CA2318, 38092261166974664, 225604883, 225604891, 8, 1440x900 
0x37CA2318, 38092261167632976, 225604948, 225604956, 8, 1440x900 
0x37CA2318, 38092261168299360, 225605017, 225605024, 7, 1440x900 
0x37CA2318, 38092261168957440, 225605083, 225605091, 8, 1440x900 
0x37CA2318, 38092261169619024, 225605147, 225605154, 7, 1440x900 
0x37CA2318, 38092261170284784, 225605212, 225605220, 8, 1440x900 
0x37CA2318, 38092261170944608, 225605282, 225605289, 7, 1440x900 
0x37CA2318, 38092261171605144, 225605347, 225605354, 7, 1440x900 
0x37CA2318, 38092261172272968, 225605413, 225605422, 9, 1440x900 
0x37CA2318, 38092261172926536, 225605477, 225605485, 8, 1440x900 
0x37CA2318, 38092261173588664, 225605543, 225605551, 8, 1440x900 
0x37CA2318, 38092261174277128, 225605618, 225605626, 8, 1440x900 
0x37CA2318, 38092261174937048, 225605682, 225605689, 7, 1440x900 
0x37CA2318, 38092261175589056, 225605743, 225605752, 9, 1440x900 
0x37CA2318, 38092261176912312, 225605878, 225605885, 7, 1440x900 
0x37CA2318, 38092261177572192, 225605942, 225605950, 8, 1440x900 
0x37CA2318, 38092261178230272, 225606007, 225606015, 8, 1440x900 
0x37CA2318, 38092261179095728, 225606097, 225606105, 8, 1440x900 
0x37CA2318, 38092261179551616, 225606144, 225606153, 9, 1440x900 
0x37CA2318, 38092261180218968, 225606213, 225606221, 8, 1440x900 
0x37CA2318, 38092261180889224, 225606278, 225606286, 8, 1440x900 
0x37CA2318, 38092261181549720, 225606342, 225606351, 9, 1440x900 
0x37CA2318, 38092261182205264, 225606407, 225606416, 9, 1440x900 
0x37CA2318, 38092261183052624, 225606493, 225606501, 8, 1440x900 
0x37CA2318, 38092261183714000, 225606562, 225606570, 8, 1440x900 
0x37CA2318, 38092261184379072, 225606628, 225606637, 9, 1440x900 
0x37CA2318, 38092261185032168, 225606691, 225606699, 8, 1440x900 
0x37CA2318, 38092261185704896, 225606759, 225606766, 7, 1440x900 
0x37CA2318, 38092261186361920, 225606822, 225606830, 8, 1440x900 
0x37CA2318, 38092261187023480, 225606888, 225606897, 9, 1440x900 
0x37CA2318, 38092261187687168, 225606958, 225606965, 7, 1440x900 
0x37CA2318, 38092261188349184, 225607022, 225607031, 9, 1440x900 
0x37CA2318, 38092261189009184, 225607093, 225607102, 9, 1440x900 
0x37CA2318, 38092261189670544, 225607154, 225607163, 9, 1440x900 
0x37CA2318, 38092261190331248, 225607223, 225607231, 8, 1440x900 
0x37CA2318, 38092261191000856, 225607292, 225607300, 8, 1440x900 
0x37CA2318, 38092261191670528, 225607353, 225607362, 9, 1440x900 
0x37CA2318, 38092261192324408, 225607424, 225607433, 9, 1440x900 
0x37CA2318, 38092261192994336, 225607487, 225607495, 8, 1440x900 
0x37CA2318, 38092261193654008, 225607552, 225607561, 9, 1440x900 
0x37CA2318, 38092261194304704, 225607618, 225607627, 9, 1440x900 
0x37CA2318, 38092261194964312, 225607687, 225607696, 9, 1440x900 
0x37CA2318, 38092261195635088, 225607752, 225607760, 8, 1440x900 
0x37CA2318, 38092261196295248, 225607818, 225607826, 8, 1440x900 
0x37CA2318, 38092261196956408, 225607882, 225607890, 8, 1440x900 
0x37CA2318, 38092261197625032, 225607953, 225607961, 8, 1440x900 
0x37CA2318, 38092261198284856, 225608019, 225608027, 8, 1440x900 
0x37CA2318, 38092261198943264, 225608083, 225608092, 9, 1440x900 
0x37CA2318, 38092261199602800, 225608147, 225608155, 8, 1440x900 
0x37CA2318, 38092261200253736, 225608212, 225608222, 10, 1440x900 
0x37CA2318, 38092261200919992, 225608283, 225608291, 8, 1440x900 
0x37CA2318, 38092261201576088, 225608347, 225608355, 8, 1440x900 
0x37CA2318, 38092261202244888, 225608413, 225608421, 8, 1440x900 
0x37CA2318, 38092261202905592, 225608479, 225608487, 8, 1440x900 
0x37CA2318, 38092261203556464, 225608548, 225608556, 8, 1440x900 
0x37CA2318, 38092261204236096, 225608613, 225608621, 8, 1440x900 
0x37CA2318, 38092261204890080, 225608678, 225608687, 9, 1440x900 
0x37CA2318, 38092261205541432, 225608743, 225608751, 8, 1440x900 
0x37CA2318, 38092261206216416, 225608809, 225608817, 8, 1440x900 
0x37CA2318, 38092261206886008, 225608877, 225608884, 7, 1440x900 
0x37CA2318, 38092261207545080, 225608942, 225608949, 7, 1440x900 
0x37CA2318, 38092261208204896, 225609007, 225609014, 7, 1440x900 
0x37CA2318, 38092261208874304, 225609073, 225609081, 8, 1440x900 
0x37CA2318, 38092261209543888, 225609138, 225609146, 8, 1440x900 
0x37CA2318, 38092261210193672, 225609204, 225609212, 8, 1440x900 
0x37CA2318, 38092261210863288, 225609273, 225609279, 6, 1440x900 
0x37CA2318, 38092261211532736, 225609337, 225609345, 8, 1440x900 
0x37CA2318, 38092261212182512, 225609402, 225609410, 8, 1440x900 
0x37CA2318, 38092261212852136, 225609468, 225609476, 8, 1440x900 
0x37CA2318, 38092261213521648, 225609537, 225609545, 8, 1440x900 
0x37CA2318, 38092261214191200, 225609607, 225609614, 7, 1440x900 
0x37CA2318, 38092261214850944, 225609672, 225609679, 7, 1440x900 
0x37CA2318, 38092261215512576, 225609737, 225609745, 8, 1440x900 
0x37CA2318, 38092261216174088, 225609807, 225609815, 8, 1440x900 
0x37CA2318, 38092261216834968, 225609872, 225609880, 8, 1440x900 
0x37CA2318, 38092261217504704, 225609938, 225609945, 7, 1440x900 
0x37CA2318, 38092261218163784, 225610002, 225610010, 8, 1440x900 
0x37CA2318, 38092261218822600, 225610068, 225610076, 8, 1440x900 
0x37CA2318, 38092261219492160, 225610133, 225610141, 8, 1440x900 
0x37CA2318, 38092261220143648, 225610204, 225610213, 9, 1440x900 
0x37CA2318, 38092261220806864, 225610273, 225610281, 8, 1440x900 
0x37CA2318, 38092261221476160, 225610338, 225610346, 8, 1440x900 
0x37CA2318, 38092261222133544, 225610402, 225610410, 8, 1440x900 
0x37CA2318, 38092261222785392, 225610468, 225610476, 8, 1440x900 
0x37CA2318, 38092261223456160, 225610538, 225610546, 8, 1440x900 
0x37CA2318, 38092261224116784, 225610602, 225610610, 8, 1440x900 
0x37CA2318, 38092261224776512, 225610668, 225610676, 8, 1440x900 
0x37CA2318, 38092261225438520, 225610731, 225610739, 8, 1440x900 
0x37CA2318, 38092261226090984, 225610797, 225610805, 8, 1440x900 
0x37CA2318, 38092261226761216, 225610864, 225610873, 9, 1440x900 
0x37CA2318, 38092261227422368, 225610932, 225610940, 8, 1440x900 
0x37CA2318, 38092261228082656, 225610998, 225611006, 8, 1440x900 
0x37CA2318, 38092261228734544, 225611063, 225611071, 8, 1440x900 
0x37CA2318, 38092261229413808, 225611128, 225611137, 9, 1440x900 
0x37CA2318, 38092261230064312, 225611193, 225611203, 10, 1440x900 
0x37CA2318, 38092261230724728, 225611259, 225611269, 10, 1440x900 
0x37CA2318, 38092261231387024, 225611328, 225611336, 8, 1440x900 
0x37CA2318, 38092261232047872, 225611393, 225611402, 9, 1440x900 
0x37CA2318, 38092261232717536, 225611463, 225611471, 8, 1440x900 
0x37CA2318, 38092261233371072, 225611528, 225611536, 8, 1440x900 
0x37CA2318, 38092261234030888, 225611592, 225611600, 8, 1440x900 
0x37CA2318, 38092261234690944, 225611658, 225611666, 8, 1440x900 
0x37CA2318, 38092261235352664, 225611728, 225611737, 9, 1440x900 
0x37CA2318, 38092261236005088, 225611787, 225611795, 8, 1440x900 
0x37CA2318, 38092261236668536, 225611854, 225611863, 9, 1440x900 
0x37CA2318, 38092261237347528, 225611923, 225611931, 8, 1440x900 
0x37CA2318, 38092261238006840, 225611992, 225612000, 8, 1440x900 
0x37CA2318, 38092261238658648, 225612053, 225612062, 9, 1440x900 
0x37CA2318, 38092261239330080, 225612123, 225612131, 8, 1440x900 
0x37CA2318, 38092261239972968, 225612188, 225612196, 8, 1440x900 
0x37CA2318, 38092261240633640, 225612253, 225612262, 9, 1440x900 
0x37CA2318, 38092261241297920, 225612322, 225612330, 8, 1440x900 
0x37CA2318, 38092261241953392, 225612383, 225612391, 8, 1440x900 
0x37CA2318, 38092261242626536, 225612454, 225612463, 9, 1440x900 
0x37CA2318, 38092261243286832, 225612513, 225612521, 8, 1440x900 
0x37CA2318, 38092261243938456, 225612581, 225612588, 7, 1440x900 
0x37CA2318, 38092261244609888, 225612648, 225612657, 9, 1440x900 
0x37CA2318, 38092261245269896, 225612717, 225612725, 8, 1440x900 
0x37CA2318, 38092261245929968, 225612778, 225612787, 9, 1440x900 
0x37CA2318, 38092261246593912, 225612847, 225612855, 8, 1440x900 
0x37CA2318, 38092261247251936, 225612912, 225612920, 8, 1440x900 
0x37CA2318, 38092261247912136, 225612978, 225612986, 8, 1440x900 
0x37CA2318, 38092261248573752, 225613043, 225613051, 8, 1440x900 
0x37CA2318, 38092261249223728, 225613107, 225613115, 8, 1440x900 
0x37CA2318, 38092261249893104, 225613176, 225613184, 8, 1440x900 
0x37CA2318, 38092261250555360, 225613247, 225613256, 9, 1440x900 
0x37CA2318, 38092261251218280, 225613312, 225613320, 8, 1440x900 
0x37CA2318, 38092261251870304, 225613378, 225613386, 8, 1440x900 
0x37CA2318, 38092261252550336, 225613442, 225613450, 8, 1440x900 
0x37CA2318, 38092261253209072, 225613507, 225613515, 8, 1440x900 
0x37CA2318, 38092261253862400, 225613577, 225613585, 8, 1440x900 
0x37CA2318, 38092261254515224, 225613643, 225613651, 8, 1440x900 
0x37CA2318, 38092261255193832, 225613708, 225613716, 8, 1440x900 
0x37CA2318, 38092261255844672, 225613773, 225613781, 8, 1440x900 
0x37CA2318, 38092261256505032, 225613837, 225613845, 8, 1440x900 
0x37CA2318, 38092261257166296, 225613903, 225613912, 9, 1440x900 
0x37CA2318, 38092261257837816, 225613972, 225613980, 8, 1440x900 
0x37CA2318, 38092261258487136, 225614038, 225614047, 9, 1440x900 
0x37CA2318, 38092261259148528, 225614103, 225614111, 8, 1440x900 
0x37CA2318, 38092261259800480, 225614168, 225614176, 8, 1440x900 
0x37CA2318, 38092261260466176, 225614237, 225614245, 8, 1440x900 
0x37CA2318, 38092261261127848, 225614303, 225614311, 8, 1440x900 
0x37CA2318, 38092261261788200, 225614368, 225614377, 9, 1440x900 
0x37CA2318, 38092261262457776, 225614433, 225614441, 8, 1440x900 
0x37CA2318, 38092261263117760, 225614499, 225614507, 8, 1440x900 
0x37CA2318, 38092261263770296, 225614564, 225614573, 9, 1440x900 
0x37CA2318, 38092261265087120, 225614698, 225614706, 8, 1440x900 
0x37CA2318, 38092261265762672, 225614768, 225614776, 8, 1440x900 
0x37CA2318, 38092261266432336, 225614833, 225614842, 9, 1440x900 
0x37CA2318, 38092261267084744, 225614897, 225614906, 9, 1440x900 
0x37CA2318, 38092261267743312, 225614965, 225614973, 8, 1440x900 
0x37CA2318, 38092261268404760, 225615027, 225615035, 8, 1440x900 
0x37CA2318, 38092261269065552, 225615097, 225615105, 8, 1440x900 
0x37CA2318, 38092261269715784, 225615157, 225615165, 8, 1440x900 
0x37CA2318, 38092261270386800, 225615223, 225615232, 9, 1440x900 
0x37CA2318, 38092261271048672, 225615292, 225615300, 8, 1440x900 
0x37CA2318, 38092261271711600, 225615357, 225615365, 8, 1440x900 
0x37CA2318, 38092261272378864, 225615428, 225615436, 8, 1440x900 
0x37CA2318, 38092261273039424, 225615493, 225615501, 8, 1440x900 
0x37CA2318, 38092261273699992, 225615557, 225615566, 9, 1440x900 
0x37CA2318, 38092261274352424, 225615623, 225615631, 8, 1440x900 
0x37CA2318, 38092261275024016, 225615692, 225615702, 10, 1440x900 
0x37CA2318, 38092261275691560, 225615758, 225615766, 8, 1440x900 
0x37CA2318, 38092261276350464, 225615823, 225615833, 10, 1440x900 
0x37CA2318, 38092261277013376, 225615887, 225615895, 8, 1440x900 
0x37CA2318, 38092261277666888, 225615958, 225615967, 9, 1440x900 
0x37CA2318, 38092261278328824, 225616022, 225616030, 8, 1440x900 
0x37CA2318, 38092261278993816, 225616088, 225616097, 9, 1440x900 
0x37CA2318, 38092261279656304, 225616153, 225616161, 8, 1440x900 
0x37CA2318, 38092261280325456, 225616223, 225616231, 8, 1440x900 
0x37CA2318, 38092261280977448, 225616288, 225616296, 8, 1440x900 
0x37CA2318, 38092261281629456, 225616352, 225616360, 8, 1440x900 
0x37CA2318, 38092261282300936, 225616418, 225616426, 8, 1440x900 
0x37CA2318, 38092261282966992, 225616488, 225616496, 8, 1440x900 
0x37CA2318, 38092261283618568, 225616548, 225616558, 10, 1440x900 
0x37CA2318, 38092261284278720, 225616617, 225616625, 8, 1440x900 
0x37CA2318, 38092261284939792, 225616684, 225616692, 8, 1440x900 
0x37CA2318, 38092261285601592, 225616748, 225616756, 8, 1440x900 
0x37CA2318, 38092261286271792, 225616818, 225616826, 8, 1440x900 
0x37CA2318, 38092261286923496, 225616882, 225616890, 8, 1440x900 
0x37CA2318, 38092261287595576, 225616953, 225616961, 8, 1440x900 
0x37CA2318, 38092261288264152, 225617014, 225617024, 10, 1440x900 
0x37CA2318, 38092261288924336, 225617083, 225617091, 8, 1440x900 
0x37CA2318, 38092261289594256, 225617148, 225617156, 8, 1440x900 
0x37CA2318, 38092261290243576, 225617209, 225617217, 8, 1440x900 
0x37CA2318, 38092261290915144, 225617283, 225617292, 9, 1440x900 
0x37CA2318, 38092261291571472, 225617347, 225617355, 8, 1440x900 
0x37CA2318, 38092261292227352, 225617412, 225617420, 8, 1440x900 
0x37CA2318, 38092261292898304, 225617478, 225617486, 8, 1440x900 
0x37CA2318, 38092261293552224, 225617542, 225617551, 9, 1440x900 
0x37CA2318, 38092261294212480, 225617612, 225617620, 8, 1440x900 
0x37CA2318, 38092261294873176, 225617678, 225617686, 8, 1440x900 
0x37CA2318, 38092261295534792, 225617743, 225617751, 8, 1440x900 
0x37CA2318, 38092261296195712, 225617813, 225617821, 8, 1440x900 
0x37CA2318, 38092261296855384, 225617872, 225617879, 7, 1440x900 
0x37CA2318, 38092261297508256, 225617937, 225617945, 8, 1440x900 
0x37CA2318, 38092261298184416, 225618007, 225618015, 8, 1440x900 
0x37CA2318, 38092261298853424, 225618073, 225618081, 8, 1440x900 
0x37CA2318, 38092261299515464, 225618138, 225618147, 9, 1440x900 
0x37CA2318, 38092261300165904, 225618204, 225618213, 9, 1440x900 
0x37CA2318, 38092261300816432, 225618268, 225618276, 8, 1440x900 
0x37CA2318, 38092261301491840, 225618338, 225618346, 8, 1440x900 
0x37CA2318, 38092261302159784, 225618404, 225618413, 9, 1440x900 
0x37CA2318, 38092261302813240, 225618467, 225618476, 9, 1440x900 
0x37CA2318, 38092261303481840, 225618538, 225618546, 8, 1440x900 
0x37CA2318, 38092261304152040, 225618602, 225618612, 10, 1440x900 
0x37CA2318, 38092261304803392, 225618668, 225618676, 8, 1440x900 
0x37CA2318, 38092261305466264, 225618738, 225618746, 8, 1440x900 
0x37CA2318, 38092261306126400, 225618803, 225618811, 8, 1440x900 
0x37CA2318, 38092261306782848, 225618868, 225618877, 9, 1440x900 
0x37CA2318, 38092261307443768, 225618933, 225618941, 8, 1440x900 
0x37CA2318, 38092261308104840, 225618999, 225619007, 8, 1440x900 
0x37CA2318, 38092261308758904, 225619067, 225619075, 8, 1440x900 
0x37CA2318, 38092261309425616, 225619132, 225619140, 8, 1440x900 
0x37CA2318, 38092261310087376, 225619198, 225619205, 7, 1440x900 
0x37CA2318, 38092261310746968, 225619268, 225619277, 9, 1440x900 
0x37CA2318, 38092261311417712, 225619328, 225619337, 9, 1440x900 
0x37CA2318, 38092261312076528, 225619393, 225619401, 8, 1440x900 
0x37CA2318, 38092261312738960, 225619467, 225619475, 8, 1440x900 
0x37CA2318, 38092261313399240, 225619532, 225619540, 8, 1440x900 
0x37CA2318, 38092261314062416, 225619593, 225619602, 9, 1440x900 
0x37CA2318, 38092261314723216, 225619663, 225619671, 8, 1440x900 
0x37CA2318, 38092261315383712, 225619727, 225619735, 8, 1440x900 
0x37CA2318, 38092261316045784, 225619793, 225619801, 8, 1440x900 
0x37CA2318, 38092261316714720, 225619862, 225619870, 8, 1440x900 
0x37CA2318, 38092261317365264, 225619928, 225619936, 8, 1440x900 
0x37CA2318, 38092261318034816, 225619993, 225620001, 8, 1440x900 
0x37CA2318, 38092261318695048, 225620059, 225620067, 8, 1440x900 
0x37CA2318, 38092261319353760, 225620122, 225620130, 8, 1440x900 
0x37CA2318, 38092261320016904, 225620193, 225620201, 8, 1440x900 
0x37CA2318, 38092261320670176, 225620253, 225620262, 9, 1440x900 
0x37CA2318, 38092261321332992, 225620323, 225620332, 9, 1440x900 
0x37CA2318, 38092261322002520, 225620387, 225620396, 9, 1440x900 
0x37CA2318, 38092261322672592, 225620458, 225620466, 8, 1440x900 
0x37CA2318, 38092261323323304, 225620522, 225620530, 8, 1440x900 
0x37CA2318, 38092261323983712, 225620588, 225620596, 8, 1440x900 
0x37CA2318, 38092261324653432, 225620652, 225620661, 9, 1440x900 
0x37CA2318, 38092261325311888, 225620718, 225620727, 9, 1440x900 
0x37CA2318, 38092261325972920, 225620783, 225620793, 10, 1440x900 
0x37CA2318, 38092261326631448, 225620853, 225620861, 8, 1440x900 
0x37CA2318, 38092261327290744, 225620913, 225620921, 8, 1440x900 
0x37CA2318, 38092261327952424, 225620983, 225620991, 8, 1440x900 
0x37CA2318, 38092261328622496, 225621048, 225621057, 9, 1440x900 
0x37CA2318, 38092261329273264, 225621113, 225621123, 10, 1440x900 
0x37CA2318, 38092261329942792, 225621183, 225621191, 8, 1440x900 
0x37CA2318, 38092261330596680, 225621249, 225621257, 8, 1440x900 
0x37CA2318, 38092261331258736, 225621313, 225621322, 9, 1440x900 
0x37CA2318, 38092261331916720, 225621383, 225621391, 8, 1440x900 
0x37CA2318, 38092261332586504, 225621448, 225621456, 8, 1440x900 
0x37CA2318, 38092261333249240, 225621513, 225621521, 8, 1440x900 
0x37CA2318, 38092261333908408, 225621583, 225621591, 8, 1440x900 
0x37CA2318, 38092261334579688, 225621647, 225621655, 8, 1440x900 
0x37CA2318, 38092261335230848, 225621713, 225621721, 8, 1440x900 
0x37CA2318, 38092261335890144, 225621777, 225621786, 9, 1440x900 
0x37CA2318, 38092261336542480, 225621843, 225621852, 9, 1440x900 
0x37CA2318, 38092261337212184, 225621907, 225621915, 8, 1440x900 
0x37CA2318, 38092261337873032, 225621973, 225621982, 9, 1440x900 
0x37CA2318, 38092261338533408, 225622042, 225622050, 8, 1440x900 
0x37CA2318, 38092261339193424, 225622112, 225622120, 8, 1440x900 
0x37CA2318, 38092261339853800, 225622172, 225622181, 9, 1440x900 
0x37CA2318, 38092261340506240, 225622243, 225622251, 8, 1440x900 
0x37CA2318, 38092261341185856, 225622308, 225622316, 8, 1440x900 
0x37CA2318, 38092261341838168, 225622377, 225622385, 8, 1440x900 
0x37CA2318, 38092261342503568, 225622438, 225622447, 9, 1440x900 
0x37CA2318, 38092261343156576, 225622502, 225622511, 9, 1440x900 
0x37CA2318, 38092261343819664, 225622573, 225622581, 8, 1440x900 
0x37CA2318, 38092261344474720, 225622637, 225622645, 8, 1440x900 
0x37CA2318, 38092261345146256, 225622702, 225622711, 9, 1440x900 
0x37CA2318, 38092261345800592, 225622767, 225622776, 9, 1440x900 
0x37CA2318, 38092261346475152, 225622838, 225622847, 9, 1440x900 
0x37CA2318, 38092261347126416, 225622903, 225622911, 8, 1440x900 
0x37CA2318, 38092261347793904, 225622967, 225622975, 8, 1440x900 
0x37CA2318, 38092261348446832, 225623037, 225623045, 8, 1440x900 
0x37CA2318, 38092261349119200, 225623102, 225623110, 8, 1440x900 
0x37CA2318, 38092261350424368, 225623234, 225623242, 8, 1440x900 
0x37CA2318, 38092261351087264, 225623297, 225623305, 8, 1440x900 
0x37CA2318, 38092261351746320, 225623363, 225623371, 8, 1440x900 
0x37CA2318, 38092261352422760, 225623433, 225623441, 8, 1440x900 
0x37CA2318, 38092261353069392, 225623498, 225623506, 8, 1440x900 
0x37CA2318, 38092261353732360, 225623558, 225623567, 9, 1440x900 
0x37CA2318, 38092261354390024, 225623627, 225623635, 8, 1440x900 
0x37CA2318, 38092261355051264, 225623694, 225623702, 8, 1440x900 
0x37CA2318, 38092261355704984, 225623762, 225623770, 8, 1440x900 
0x37CA2318, 38092261356375688, 225623828, 225623836, 8, 1440x900 
0x37CA2318, 38092261357045160, 225623897, 225623905, 8, 1440x900 
0x37CA2318, 38092261357708344, 225623963, 225623971, 8, 1440x900 
0x37CA2318, 38092261358367704, 225624027, 225624035, 8, 1440x900 
0x37CA2318, 38092261359028056, 225624092, 225624101, 9, 1440x900 
0x37CA2318, 38092261359691248, 225624158, 225624167, 9, 1440x900 
0x37CA2318, 38092261360360544, 225624222, 225624230, 8, 1440x900 
0x37CA2318, 38092261361013448, 225624293, 225624301, 8, 1440x900 
0x37CA2318, 38092261361666016, 225624357, 225624365, 8, 1440x900 
0x37CA2318, 38092261362345488, 225624422, 225624431, 9, 1440x900 
0x37CA2318, 38092261363008480, 225624488, 225624497, 9, 1440x900 
0x37CA2318, 38092261363658136, 225624558, 225624566, 8, 1440x900 
0x37CA2318, 38092261364328824, 225624618, 225624626, 8, 1440x900 
0x37CA2318, 38092261364988792, 225624686, 225624694, 8, 1440x900 
0x37CA2318, 38092261365642368, 225624753, 225624760, 7, 1440x900 
0x37CA2318, 38092261366308784, 225624817, 225624825, 8, 1440x900 
0x37CA2318, 38092261366972640, 225624888, 225624897, 9, 1440x900 
0x37CA2318, 38092261367633984, 225624952, 225624960, 8, 1440x900 
0x37CA2318, 38092261368293608, 225625017, 225625025, 8, 1440x900 
0x37CA2318, 38092261368953960, 225625083, 225625092, 9, 1440x900 
0x37CA2318, 38092261369624560, 225625153, 225625162, 9, 1440x900 
0x37CA2318, 38092261370275808, 225625217, 225625225, 8, 1440x900 
0x37CA2318, 38092261370936296, 225625283, 225625291, 8, 1440x900 
0x37CA2318, 38092261371597312, 225625348, 225625356, 8, 1440x900 
0x37CA2318, 38092261372267232, 225625417, 225625425, 8, 1440x900 
0x37CA2318, 38092261372919928, 225625482, 225625490, 8, 1440x900 
0x37CA2318, 38092261373576880, 225625548, 225625556, 8, 1440x900 
0x37CA2318, 38092261374246512, 225625617, 225625625, 8, 1440x900 
0x37CA2318, 38092261374904848, 225625677, 225625684, 7, 1440x900 
0x37CA2318, 38092261375559064, 225625743, 225625752, 9, 1440x900 
0x37CA2318, 38092261376226424, 225625813, 225625821, 8, 1440x900 
0x37CA2318, 38092261376896944, 225625877, 225625886, 9, 1440x900 
0x37CA2318, 38092261377556512, 225625947, 225625955, 8, 1440x900 
0x37CA2318, 38092261378201480, 225626007, 225626016, 9, 1440x900 
0x37CA2318, 38092261378867992, 225626074, 225626083, 9, 1440x900 
0x37CA2318, 38092261379532424, 225626143, 225626151, 8, 1440x900 
0x37CA2318, 38092261380192360, 225626207, 225626216, 9, 1440x900 
0x37CA2318, 38092261380847736, 225626277, 225626285, 8, 1440x900 
0x37CA2318, 38092261381509136, 225626338, 225626347, 9, 1440x900 
0x37CA2318, 38092261382177848, 225626407, 225626415, 8, 1440x900 
0x37CA2318, 38092261382830128, 225626472, 225626480, 8, 1440x900 
0x37CA2318, 38092261383494416, 225626538, 225626547, 9, 1440x900 
0x37CA2318, 38092261384156864, 225626607, 225626615, 8, 1440x900 
0x37CA2318, 38092261384817144, 225626668, 225626677, 9, 1440x900 
0x37CA2318, 38092261385479056, 225626733, 225626741, 8, 1440x900 
0x37CA2318, 38092261386135504, 225626802, 225626810, 8, 1440x900 
0x37CA2318, 38092261386808216, 225626868, 225626875, 7, 1440x900 
0x37CA2318, 38092261387467032, 225626936, 225626944, 8, 1440x900 
0x37CA2318, 38092261388137112, 225627001, 225627009, 8, 1440x900 
0x37CA2318, 38092261388786816, 225627066, 225627074, 8, 1440x900 
0x37CA2318, 38092261389448344, 225627132, 225627140, 8, 1440x900 
0x37CA2318, 38092261390111840, 225627198, 225627207, 9, 1440x900 
0x37CA2318, 38092261390768232, 225627268, 225627276, 8, 1440x900 
0x37CA2318, 38092261391428960, 225627333, 225627341, 8, 1440x900 
0x37CA2318, 38092261392092104, 225627397, 225627405, 8, 1440x900 
0x37CA2318, 38092261392761120, 225627463, 225627472, 9, 1440x900 
0x37CA2318, 38092261393412344, 225627528, 225627537, 9, 1440x900 
0x37CA2318, 38092261394081736, 225627598, 225627607, 9, 1440x900 
0x37CA2318, 38092261394733048, 225627663, 225627672, 9, 1440x900 
0x37CA2318, 38092261395393760, 225627727, 225627735, 8, 1440x900 
0x37CA2318, 38092261396053416, 225627798, 225627806, 8, 1440x900 
0x37CA2318, 38092261396712992, 225627857, 225627865, 8, 1440x900 
0x37CA2318, 38092261397370000, 225627925, 225627934, 9, 1440x900 
0x37CA2318, 38092261398040760, 225627992, 225628000, 8, 1440x900 
0x37CA2318, 38092261398710520, 225628063, 225628072, 9, 1440x900 
0x37CA2318, 38092261399360536, 225628123, 225628131, 8, 1440x900 
0x37CA2318, 38092261400015872, 225628193, 225628201, 8, 1440x900 
0x37CA2318, 38092261400687744, 225628257, 225628265, 8, 1440x900 
0x37CA2318, 38092261401339768, 225628322, 225628331, 9, 1440x900 
0x37CA2318, 38092261402000448, 225628392, 225628400, 8, 1440x900 
0x37CA2318, 38092261402663528, 225628458, 225628466, 8, 1440x900 
0x37CA2318, 38092261403326712, 225628522, 225628530, 8, 1440x900 
0x37CA2318, 38092261403997088, 225628592, 225628600, 8, 1440x900 
0x37CA2318, 38092261404657776, 225628657, 225628665, 8, 1440x900 
0x37CA2318, 38092261405308168, 225628718, 225628727, 9, 1440x900 
0x37CA2318, 38092261405960192, 225628783, 225628792, 9, 1440x900 
0x37CA2318, 38092261406622712, 225628852, 225628861, 9, 1440x900 
0x37CA2318, 38092261407291880, 225628913, 225628921, 8, 1440x900 
0x37CA2318, 38092261407953392, 225628983, 225628990, 7, 1440x900 
0x37CA2318, 38092261408606200, 225629048, 225629057, 9, 1440x900 
0x37CA2318, 38092261409285816, 225629118, 225629126, 8, 1440x900 
0x37CA2318, 38092261409936808, 225629183, 225629191, 8, 1440x900 
0x37CA2318, 38092261410606928, 225629253, 225629261, 8, 1440x900 
0x37CA2318, 38092261411266480, 225629318, 225629326, 8, 1440x900 
0x37CA2318, 38092261411917560, 225629382, 225629390, 8, 1440x900 
0x37CA2318, 38092261412578488, 225629449, 225629457, 8, 1440x900 
0x37CA2318, 38092261413240192, 225629517, 225629525, 8, 1440x900 
0x37CA2318, 38092261413904712, 225629578, 225629586, 8, 1440x900 
0x37CA2318, 38092261414565576, 225629647, 225629655, 8, 1440x900 
0x37CA2318, 38092261415227648, 225629713, 225629721, 8, 1440x900 
0x37CA2318, 38092261415881336, 225629777, 225629785, 8, 1440x900 
0x37CA2318, 38092261416544664, 225629842, 225629851, 9, 1440x900 
0x37CA2318, 38092261417212992, 225629913, 225629921, 8, 1440x900 
0x37CA2318, 38092261417875552, 225629976, 225629984, 8, 1440x900 
0x37CA2318, 38092261418528864, 225630042, 225630050, 8, 1440x900 
0x37CA2318, 38092261419195360, 225630109, 225630120, 11, 1440x900 
0x37CA2318, 38092261419846680, 225630171, 225630179, 8, 1440x900 
0x37CA2318, 38092261420507080, 225630237, 225630245, 8, 1440x900 
0x37CA2318, 38092261421177824, 225630307, 225630315, 8, 1440x900 
0x37CA2318, 38092261421819936, 225630373, 225630381, 8, 1440x900 
0x37CA2318, 38092261422497736, 225630435, 225630444, 9, 1440x900 
0x37CA2318, 38092261423158800, 225630502, 225630509, 7, 1440x900 
0x37CA2318, 38092261423809088, 225630566, 225630574, 8, 1440x900 
0x37CA2318, 38092261424480120, 225630637, 225630645, 8, 1440x900 
0x37CA2318, 38092261425134504, 225630702, 225630711, 9, 1440x900 
0x37CA2318, 38092261425808872, 225630768, 225630777, 9, 1440x900 
0x37CA2318, 38092261426460064, 225630834, 225630842, 8, 1440x900 
0x37CA2318, 38092261427129976, 225630903, 225630911, 8, 1440x900 
0x37CA2318, 38092261427782104, 225630968, 225630976, 8, 1440x900 
0x37CA2318, 38092261428451904, 225631033, 225631042, 9, 1440x900 
0x37CA2318, 38092261429104688, 225631098, 225631107, 9, 1440x900 
0x37CA2318, 38092261429765936, 225631167, 225631175, 8, 1440x900 
0x37CA2318, 38092261430435024, 225631234, 225631242, 8, 1440x900 
0x37CA2318, 38092261431749208, 225631363, 225631372, 9, 1440x900 
0x37CA2318, 38092261432419024, 225631429, 225631438, 9, 1440x900 
0x37CA2318, 38092261433070088, 225631493, 225631502, 9, 1440x900 
0x37CA2318, 38092261433732544, 225631563, 225631571, 8, 1440x900 
0x37CA2318, 38092261434384904, 225631629, 225631637, 8, 1440x900 
0x37CA2318, 38092261435053064, 225631698, 225631706, 8, 1440x900 
0x37CA2318, 38092261435712480, 225631758, 225631767, 9, 1440x900 
0x37CA2318, 38092261436372776, 225631823, 225631832, 9, 1440x900 
0x37CA2318, 38092261437033360, 225631892, 225631900, 8, 1440x900 
0x37CA2318, 38092261437695872, 225631962, 225631970, 8, 1440x900 
0x37CA2318, 38092261438356856, 225632027, 225632035, 8, 1440x900 
0x37CA2318, 38092261439018424, 225632093, 225632101, 8, 1440x900 
0x37CA2318, 38092261439677528, 225632153, 225632161, 8, 1440x900 
0x37CA2318, 38092261440337512, 225632222, 225632230, 8, 1440x900 
0x37CA2318, 38092261440999160, 225632287, 225632295, 8, 1440x900 
0x37CA2318, 38092261441659320, 225632353, 225632362, 9, 1440x900 
0x37CA2318, 38092261442322960, 225632423, 225632431, 8, 1440x900 
0x37CA2318, 38092261442982768, 225632488, 225632497, 9, 1440x900 
0x37CA2318, 38092261443636368, 225632554, 225632562, 8, 1440x900 
0x37CA2318, 38092261444315984, 225632618, 225632628, 10, 1440x900 
0x37CA2318, 38092261444967936, 225632687, 225632695, 8, 1440x900 
0x37CA2318, 38092261445633240, 225632753, 225632761, 8, 1440x900 
0x37CA2318, 38092261446294952, 225632821, 225632829, 8, 1440x900 
0x37CA2318, 38092261446964840, 225632889, 225632897, 8, 1440x900 
0x37CA2318, 38092261447616008, 225632948, 225632957, 9, 1440x900 
0x37CA2318, 38092261448277248, 225633017, 225633026, 9, 1440x900 
0x37CA2318, 38092261448939184, 225633087, 225633095, 8, 1440x900 
0x37CA2318, 38092261449598680, 225633147, 225633156, 9, 1440x900 
0x37CA2318, 38092261450260920, 225633212, 225633220, 8, 1440x900 
0x37CA2318, 38092261450929264, 225633277, 225633285, 8, 1440x900 
0x37CA2318, 38092261451580400, 225633342, 225633350, 8, 1440x900 
0x37CA2318, 38092261452232352, 225633408, 225633415, 7, 1440x900 
0x37CA2318, 38092261452903776, 225633477, 225633485, 8, 1440x900 
0x37CA2318, 38092261453556168, 225633542, 225633549, 7, 1440x900 
0x37CA2318, 38092261454223424, 225633608, 225633617, 9, 1440x900 
0x37CA2318, 38092261454893416, 225633690, 225633703, 13, 1440x900 
0x37CA2318, 38092261455435864, 225633732, 225633740, 8, 1440x900 
0x37CA2318, 38092261456009264, 225633787, 225633794, 7, 1440x900 
0x37CA2318, 38092261456857816, 225633872, 225633879, 7, 1440x900 
0x37CA2318, 38092261457527440, 225633938, 225633946, 8, 1440x900 
0x37CA2318, 38092261458187936, 225634007, 225634014, 7, 1440x900 
0x37CA2318, 38092261458848992, 225634072, 225634080, 8, 1440x900 
0x37CA2318, 38092261459510984, 225634137, 225634145, 8, 1440x900 
0x37CA2318, 38092261460173584, 225634202, 225634210, 8, 1440x900 
0x37CA2318, 38092261460833096, 225634272, 225634280, 8, 1440x900 
0x37CA2318, 38092261461485248, 225634337, 225634346, 9, 1440x900 
0x37CA2318, 38092261462148576, 225634402, 225634411, 9, 1440x900 
0x37CA2318, 38092261462810960, 225634473, 225634481, 8, 1440x900 
0x37CA2318, 38092261463470424, 225634537, 225634545, 8, 1440x900 
0x37CA2318, 38092261464131592, 225634602, 225634611, 9, 1440x900 
0x37CA2318, 38092261464793120, 225634668, 225634677, 9, 1440x900 
0x37CA2318, 38092261465454680, 225634733, 225634742, 9, 1440x900 
0x37CA2318, 38092261466123944, 225634802, 225634810, 8, 1440x900 
0x37CA2318, 38092261466784112, 225634869, 225634878, 9, 1440x900 
0x37CA2318, 38092261467439200, 225634933, 225634941, 8, 1440x900 
0x37CA2318, 38092261468105328, 225635002, 225635010, 8, 1440x900 
0x37CA2318, 38092261468765656, 225635068, 225635076, 8, 1440x900 
0x37CA2318, 38092261469426840, 225635132, 225635140, 8, 1440x900 
0x37CA2318, 38092261470087888, 225635198, 225635207, 9, 1440x900 
0x37CA2318, 38092261470751208, 225635263, 225635271, 8, 1440x900 
0x37CA2318, 38092261471417272, 225635333, 225635341, 8, 1440x900 
0x37CA2318, 38092261472060576, 225635398, 225635406, 8, 1440x900 
0x37CA2318, 38092261472769936, 225635467, 225635475, 8, 1440x900 
0x37CA2318, 38092261473431672, 225635532, 225635541, 9, 1440x900 
0x37CA2318, 38092261474100280, 225635602, 225635610, 8, 1440x900 
0x37CA2318, 38092261474752376, 225635663, 225635672, 9, 1440x900 
0x37CA2318, 38092261475412624, 225635728, 225635737, 9, 1440x900 
0x37CA2318, 38092261476074104, 225635798, 225635806, 8, 1440x900 
0x37CA2318, 38092261476744424, 225635863, 225635872, 9, 1440x900 
0x37CA2318, 38092261477396360, 225635932, 225635940, 8, 1440x900 
0x37CA2318, 38092261478065920, 225635998, 225636006, 8, 1440x900 
0x37CA2318, 38092261478727792, 225636063, 225636071, 8, 1440x900 
0x37CA2318, 38092261479390536, 225636128, 225636136, 8, 1440x900 
0x37CA2318, 38092261480050656, 225636193, 225636202, 9, 1440x900 
0x37CA2318, 38092261480708752, 225636262, 225636270, 8, 1440x900 
0x37CA2318, 38092261481380880, 225636328, 225636336, 8, 1440x900 
0x37CA2318, 38092261482041888, 225636393, 225636401, 8, 1440x900 
0x37CA2318, 38092261482694896, 225636459, 225636466, 7, 1440x900 
0x37CA2318, 38092261483364856, 225636523, 225636531, 8, 1440x900 
0x37CA2318, 38092261484026304, 225636588, 225636597, 9, 1440x900 
0x37CA2318, 38092261484686720, 225636658, 225636666, 8, 1440x900 
0x37CA2318, 38092261485338992, 225636723, 225636732, 9, 1440x900 
0x37CA2318, 38092261486009400, 225636792, 225636800, 8, 1440x900 
0x37CA2318, 38092261486662448, 225636853, 225636862, 9, 1440x900 
0x37CA2318, 38092261487325296, 225636923, 225636931, 8, 1440x900 
0x37CA2318, 38092261487981800, 225636983, 225636991, 8, 1440x900 
0x37CA2318, 38092261488652360, 225637052, 225637060, 8, 1440x900 
0x37CA2318, 38092261489312832, 225637123, 225637131, 8, 1440x900 
0x37CA2318, 38092261489983024, 225637187, 225637195, 8, 1440x900 
0x37CA2318, 38092261490633344, 225637252, 225637261, 9, 1440x900 
0x37CA2318, 38092261491292528, 225637313, 225637321, 8, 1440x900 
0x37CA2318, 38092261491965656, 225637382, 225637390, 8, 1440x900 
0x37CA2318, 38092261492616016, 225637448, 225637455, 7, 1440x900 
0x37CA2318, 38092261493284224, 225637518, 225637525, 7, 1440x900 
0x37CA2318, 38092261493939184, 225637578, 225637586, 8, 1440x900 
0x37CA2318, 38092261494594216, 225637647, 225637654, 7, 1440x900 
0x37CA2318, 38092261495265640, 225637718, 225637726, 8, 1440x900 
0x37CA2318, 38092261495918456, 225637783, 225637791, 8, 1440x900 
0x37CA2318, 38092261496587840, 225637847, 225637855, 8, 1440x900 
0x37CA2318, 38092261497247704, 225637913, 225637922, 9, 1440x900 
0x37CA2318, 38092261497908880, 225637982, 225637990, 8, 1440x900 
0x37CA2318, 38092261498561520, 225638043, 225638053, 10, 1440x900 
0x37CA2318, 38092261499214928, 225638109, 225638119, 10, 1440x900 
0x37CA2318, 38092261499877968, 225638177, 225638185, 8, 1440x900 
0x37CA2318, 38092261500549272, 225638243, 225638252, 9, 1440x900 
0x37CA2318, 38092261501214344, 225638309, 225638318, 9, 1440x900 
0x37CA2318, 38092261501868720, 225638378, 225638386, 8, 1440x900 
0x37CA2318, 38092261502523104, 225638443, 225638451, 8, 1440x900 
0x37CA2318, 38092261503198784, 225638509, 225638518, 9, 1440x900 
0x37CA2318, 38092261503860304, 225638578, 225638587, 9, 1440x900 
0x37CA2318, 38092261504513904, 225638637, 225638645, 8, 1440x900 
0x37CA2318, 38092261505185728, 225638703, 225638712, 9, 1440x900 
0x37CA2318, 38092261505839360, 225638771, 225638779, 8, 1440x900 
0x37CA2318, 38092261506498488, 225638838, 225638847, 9, 1440x900 
0x37CA2318, 38092261507178528, 225638907, 225638919, 12, 1440x900 
0x37CA2318, 38092261507829320, 225638973, 225638981, 8, 1440x900 
0x37CA2318, 38092261508490480, 225639038, 225639046, 8, 1440x900 
0x37CA2318, 38092261509142928, 225639102, 225639111, 9, 1440x900 
0x37CA2318, 38092261509822296, 225639173, 225639181, 8, 1440x900 
0x37CA2318, 38092261510482016, 225639237, 225639245, 8, 1440x900 
0x37CA2318, 38092261511143984, 225639303, 225639311, 8, 1440x900 
0x37CA2318, 38092261511796024, 225639372, 225639380, 8, 1440x900 
0x37CA2318, 38092261512470032, 225639437, 225639445, 8, 1440x900 
0x37CA2318, 38092261513122608, 225639503, 225639511, 8, 1440x900 
0x37CA2318, 38092261513784288, 225639569, 225639577, 8, 1440x900 
0x37CA2318, 38092261514461480, 225639638, 225639646, 8, 1440x900 
0x37CA2318, 38092261515112648, 225639702, 225639710, 8, 1440x900 
0x37CA2318, 38092261515782544, 225639767, 225639775, 8, 1440x900 
0x37CA2318, 38092261516433520, 225639832, 225639840, 8, 1440x900 
0x37CA2318, 38092261517103512, 225639902, 225639912, 10, 1440x900 
0x37CA2318, 38092261518416048, 225640032, 225640040, 8, 1440x900 
0x37CA2318, 38092261519067592, 225640098, 225640106, 8, 1440x900 
0x37CA2318, 38092261519737136, 225640163, 225640171, 8, 1440x900 
0x37CA2318, 38092261520406864, 225640228, 225640237, 9, 1440x900 
0x37CA2318, 38092261521068320, 225640293, 225640302, 9, 1440x900 
0x37CA2318, 38092261521722144, 225640363, 225640371, 8, 1440x900 
0x37CA2318, 38092261522374568, 225640429, 225640436, 7, 1440x900 
0x37CA2318, 38092261523044072, 225640493, 225640502, 9, 1440x900 
0x37CA2318, 38092261523703312, 225640557, 225640566, 9, 1440x900 
0x37CA2318, 38092261524371880, 225640623, 225640632, 9, 1440x900 
0x37CA2318, 38092261525033680, 225640688, 225640696, 8, 1440x900 
0x37CA2318, 38092261525687536, 225640757, 225640765, 8, 1440x900 
0x37CA2318, 38092261526352152, 225640823, 225640832, 9, 1440x900 
0x37CA2318, 38092261527010136, 225640893, 225640901, 8, 1440x900 
0x37CA2318, 38092261527671968, 225640953, 225640962, 9, 1440x900 
0x37CA2318, 38092261528337808, 225641027, 225641035, 8, 1440x900 
0x37CA2318, 38092261528988776, 225641087, 225641096, 9, 1440x900 
0x37CA2318, 38092261529656736, 225641153, 225641162, 9, 1440x900 
0x37CA2318, 38092261530319752, 225641222, 225641230, 8, 1440x900 
0x37CA2318, 38092261530973248, 225641287, 225641296, 9, 1440x900 
0x37CA2318, 38092261531640424, 225641358, 225641366, 8, 1440x900 
0x37CA2318, 38092261532310200, 225641417, 225641426, 9, 1440x900 
0x37CA2318, 38092261532953800, 225641482, 225641491, 9, 1440x900 
0x37CA2318, 38092261533618880, 225641553, 225641562, 9, 1440x900 
0x37CA2318, 38092261534279456, 225641617, 225641625, 8, 1440x900 
0x37CA2318, 38092261534940272, 225641682, 225641691, 9, 1440x900 
0x37CA2318, 38092261535601176, 225641747, 225641755, 8, 1440x900 
0x37CA2318, 38092261536262272, 225641817, 225641825, 8, 1440x900 
0x37CA2318, 38092261536914224, 225641878, 225641886, 8, 1440x900 
0x37CA2318, 38092261537575672, 225641943, 225641951, 8, 1440x900 
0x37CA2318, 38092261538236952, 225642012, 225642020, 8, 1440x900 
0x37CA2318, 38092261538898712, 225642077, 225642085, 8, 1440x900 
0x37CA2318, 38092261539565248, 225642148, 225642156, 8, 1440x900 
0x37CA2318, 38092261540227976, 225642212, 225642220, 8, 1440x900 
0x37CA2318, 38092261540886472, 225642277, 225642286, 9, 1440x900 
0x37CA2318, 38092261541541728, 225642342, 225642350, 8, 1440x900 
0x37CA2318, 38092261542212000, 225642408, 225642416, 8, 1440x900 
0x37CA2318, 38092261542881664, 225642477, 225642485, 8, 1440x900 
0x37CA2318, 38092261543534680, 225642543, 225642551, 8, 1440x900 
0x37CA2318, 38092261544186624, 225642608, 225642617, 9, 1440x900 
0x37CA2318, 38092261544857376, 225642673, 225642682, 9, 1440x900 
0x37CA2318, 38092261545510024, 225642737, 225642745, 8, 1440x900 
0x37CA2318, 38092261546171472, 225642807, 225642815, 8, 1440x900 
0x37CA2318, 38092261546842872, 225642873, 225642881, 8, 1440x900 
0x37CA2318, 38092261547502376, 225642938, 225642947, 9, 1440x900 
0x37CA2318, 38092261548152240, 225643003, 225643011, 8, 1440x900 
0x37CA2318, 38092261548821696, 225643073, 225643081, 8, 1440x900 
0x37CA2318, 38092261549491792, 225643137, 225643146, 9, 1440x900 
0x37CA2318, 38092261550148032, 225643202, 225643211, 9, 1440x900 
0x37CA2318, 38092261550809328, 225643272, 225643280, 8, 1440x900 
0x37CA2318, 38092261551470984, 225643338, 225643346, 8, 1440x900 
0x37CA2318, 38092261552132200, 225643402, 225643411, 9, 1440x900 
0x37CA2318, 38092261552788432, 225643466, 225643474, 8, 1440x900 
0x37CA2318, 38092261553449080, 225643533, 225643541, 8, 1440x900 
0x37CA2318, 38092261554118120, 225643599, 225643608, 9, 1440x900 
0x37CA2318, 38092261554770080, 225643664, 225643672, 8, 1440x900 
0x37CA2318, 38092261555433432, 225643733, 225643741, 8, 1440x900 
0x37CA2318, 38092261556092888, 225643796, 225643804, 8, 1440x900 
0x37CA2318, 38092261556745720, 225643862, 225643870, 8, 1440x900 
0x37CA2318, 38092261557414208, 225643928, 225643936, 8, 1440x900 
0x37CA2318, 38092261558067952, 225643997, 225644005, 8, 1440x900 
0x37CA2318, 38092261558731488, 225644062, 225644070, 8, 1440x900 
0x37CA2318, 38092261559395256, 225644133, 225644141, 8, 1440x900 
0x37CA2318, 38092261560047328, 225644198, 225644207, 9, 1440x900 
0x37CA2318, 38092261560718888, 225644262, 225644270, 8, 1440x900 
0x37CA2318, 38092261561377616, 225644326, 225644333, 7, 1440x900 
0x37CA2318, 38092261562030576, 225644393, 225644401, 8, 1440x900 
0x37CA2318, 38092261562709768, 225644458, 225644467, 9, 1440x900 
0x37CA2318, 38092261563359536, 225644527, 225644535, 8, 1440x900 
0x37CA2318, 38092261564022600, 225644593, 225644602, 9, 1440x900 
0x37CA2318, 38092261564681696, 225644658, 225644667, 9, 1440x900 
0x37CA2318, 38092261565342032, 225644723, 225644731, 8, 1440x900 
0x37CA2318, 38092261566013280, 225644792, 225644800, 8, 1440x900 
0x37CA2318, 38092261566672440, 225644858, 225644866, 8, 1440x900 
0x37CA2318, 38092261567323520, 225644918, 225644926, 8, 1440x900 
0x37CA2318, 38092261567986104, 225644987, 225644995, 8, 1440x900 
0x37CA2318, 38092261568640096, 225645052, 225645060, 8, 1440x900 
0x37CA2318, 38092261569319240, 225645123, 225645132, 9, 1440x900 
0x37CA2318, 38092261569971360, 225645187, 225645195, 8, 1440x900 
0x37CA2318, 38092261570631176, 225645248, 225645257, 9, 1440x900 
0x37CA2318, 38092261571282944, 225645313, 225645321, 8, 1440x900 
0x37CA2318, 38092261571949416, 225645382, 225645391, 9, 1440x900 
0x37CA2318, 38092261572605120, 225645453, 225645461, 8, 1440x900 
0x37CA2318, 38092261573268768, 225645513, 225645521, 8, 1440x900 
0x37CA2318, 38092261573939312, 225645583, 225645591, 8, 1440x900 
0x37CA2318, 38092261574601200, 225645647, 225645656, 9, 1440x900 
0x37CA2318, 38092261575271688, 225645718, 225645726, 8, 1440x900 
0x37CA2318, 38092261575923856, 225645782, 225645790, 8, 1440x900 
0x37CA2318, 38092261576583928, 225645848, 225645856, 8, 1440x900 
0x37CA2318, 38092261577243680, 225645908, 225645917, 9, 1440x900 
0x37CA2318, 38092261577896624, 225645977, 225645986, 9, 1440x900 
0x37CA2318, 38092261578566384, 225646047, 225646055, 8, 1440x900 
0x37CA2318, 38092261579234896, 225646113, 225646122, 9, 1440x900 
0x37CA2318, 38092261579887520, 225646177, 225646185, 8, 1440x900 
0x37CA2318, 38092261580556416, 225646243, 225646251, 8, 1440x900 
0x37CA2318, 38092261581689544, 225646353, 225646362, 9, 1440x900 
0x37CA2318, 38092261582350016, 225646422, 225646430, 8, 1440x900 
0x37CA2318, 38092261583208128, 225646508, 225646516, 8, 1440x900 
0x37CA2318, 38092261583862800, 225646577, 225646585, 8, 1440x900 
0x37CA2318, 38092261584521768, 225646643, 225646652, 9, 1440x900 
0x37CA2318, 38092261585195944, 225646707, 225646716, 9, 1440x900 
0x37CA2318, 38092261585847264, 225646771, 225646779, 8, 1440x900 
0x37CA2318, 38092261586509144, 225646843, 225646852, 9, 1440x900 
0x37CA2318, 38092261587169656, 225646903, 225646912, 9, 1440x900 
0x37CA2318, 38092261587832720, 225646972, 225646980, 8, 1440x900 
0x37CA2318, 38092261588494416, 225647038, 225647047, 9, 1440x900 
0x37CA2318, 38092261589146616, 225647103, 225647111, 8, 1440x900 
0x37CA2318, 38092261589817256, 225647171, 225647180, 9, 1440x900 
0x37CA2318, 38092261590480120, 225647238, 225647246, 8, 1440x900 
0x37CA2318, 38092261591136624, 225647302, 225647311, 9, 1440x900 
0x37CA2318, 38092261591807928, 225647368, 225647377, 9, 1440x900 
0x37CA2318, 38092261592468520, 225647438, 225647447, 9, 1440x900 
0x37CA2318, 38092261593128168, 225647503, 225647512, 9, 1440x900 
0x37CA2318, 38092261593788696, 225647567, 225647576, 9, 1440x900 
0x37CA2318, 38092261594438832, 225647633, 225647641, 8, 1440x900 
0x37CA2318, 38092261595100816, 225647698, 225647706, 8, 1440x900 
0x37CA2318, 38092261595763720, 225647763, 225647772, 9, 1440x900 
0x37CA2318, 38092261596424072, 225647830, 225647838, 8, 1440x900 
0x37CA2318, 38092261597089192, 225647897, 225647905, 8, 1440x900 
0x37CA2318, 38092261597740224, 225647961, 225647969, 8, 1440x900 
0x37CA2318, 38092261598402152, 225648028, 225648036, 8, 1440x900 
0x37CA2318, 38092261599064952, 225648099, 225648107, 8, 1440x900 
0x37CA2318, 38092261599725464, 225648162, 225648170, 8, 1440x900 
0x37CA2318, 38092261600377640, 225648228, 225648236, 8, 1440x900 
0x37CA2318, 38092261601049832, 225648293, 225648301, 8, 1440x900 
0x37CA2318, 38092261601703304, 225648358, 225648366, 8, 1440x900 
0x37CA2318, 38092261602365304, 225648429, 225648436, 7, 1440x900 
0x37CA2318, 38092261603033816, 225648493, 225648502, 9, 1440x900 
0x37CA2318, 38092261603679688, 225648558, 225648566, 8, 1440x900 
0x37CA2318, 38092261604350640, 225648622, 225648631, 9, 1440x900 
0x37CA2318, 38092261605008040, 225648688, 225648698, 10, 1440x900 
0x37CA2318, 38092261605670512, 225648757, 225648765, 8, 1440x900 
0x37CA2318, 38092261606339024, 225648822, 225648830, 8, 1440x900 
0x37CA2318, 38092261606998576, 225648888, 225648896, 8, 1440x900 
0x37CA2318, 38092261607649104, 225648953, 225648962, 9, 1440x900 
0x37CA2318, 38092261608318152, 225649018, 225649027, 9, 1440x900 
0x37CA2318, 38092261608970632, 225649088, 225649096, 8, 1440x900 
0x37CA2318, 38092261609630320, 225649148, 225649156, 8, 1440x900 
0x37CA2318, 38092261610290560, 225649217, 225649227, 10, 1440x900 
0x37CA2318, 38092261610951160, 225649283, 225649291, 8, 1440x900 
0x37CA2318, 38092261611612016, 225649348, 225649356, 8, 1440x900 
0x37CA2318, 38092261612274048, 225649414, 225649422, 8, 1440x900 
0x37CA2318, 38092261612927848, 225649482, 225649490, 8, 1440x900 
0x37CA2318, 38092261613608480, 225649552, 225649560, 8, 1440x900 
0x37CA2318, 38092261614267472, 225649613, 225649621, 8, 1440x900 
0x37CA2318, 38092261614922392, 225649678, 225649685, 7, 1440x900 
0x37CA2318, 38092261615578216, 225649747, 225649755, 8, 1440x900 
0x37CA2318, 38092261616240280, 225649812, 225649821, 9, 1440x900 
0x37CA2318, 38092261616897352, 225649879, 225649887, 8, 1440x900 
0x37CA2318, 38092261617571408, 225649948, 225649956, 8, 1440x900 
0x37CA2318, 38092261618228448, 225650012, 225650020, 8, 1440x900 
0x37CA2318, 38092261618889224, 225650078, 225650086, 8, 1440x900 
0x37CA2318, 38092261619548856, 225650143, 225650151, 8, 1440x900 
0x37CA2318, 38092261620208952, 225650207, 225650216, 9, 1440x900 
0x37CA2318, 38092261620872936, 225650277, 225650285, 8, 1440x900 
0x37CA2318, 38092261621532720, 225650343, 225650351, 8, 1440x900 
0x37CA2318, 38092261622184072, 225650408, 225650417, 9, 1440x900 
0x37CA2318, 38092261622856072, 225650478, 225650486, 8, 1440x900 
0x37CA2318, 38092261623525728, 225650543, 225650551, 8, 1440x900 
0x37CA2318, 38092261624176736, 225650608, 225650616, 8, 1440x900 
0x37CA2318, 38092261624831344, 225650673, 225650681, 8, 1440x900 
0x37CA2318, 38092261625498864, 225650742, 225650750, 8, 1440x900 
0x37CA2318, 38092261626158888, 225650802, 225650809, 7, 1440x900 
0x37CA2318, 38092261626819856, 225650868, 225650876, 8, 1440x900 
0x37CA2318, 38092261627489264, 225650937, 225650945, 8, 1440x900 
0x37CA2318, 38092261628141376, 225651001, 225651009, 8, 1440x900 
0x37CA2318, 38092261628809528, 225651067, 225651074, 7, 1440x900 
0x37CA2318, 38092261629460464, 225651137, 225651145, 8, 1440x900 
0x37CA2318, 38092261630131416, 225651203, 225651211, 8, 1440x900 
0x37CA2318, 38092261630782192, 225651268, 225651276, 8, 1440x900 
0x37CA2318, 38092261631443072, 225651332, 225651340, 8, 1440x900 
0x37CA2318, 38092261632104048, 225651397, 225651406, 9, 1440x900 
0x37CA2318, 38092261632773088, 225651466, 225651474, 8, 1440x900 
0x37CA2318, 38092261633424176, 225651534, 225651542, 8, 1440x900 
0x37CA2318, 38092261634086760, 225651598, 225651607, 9, 1440x900 
0x37CA2318, 38092261634737584, 225651658, 225651666, 8, 1440x900 
0x37CA2318, 38092261635401320, 225651728, 225651735, 7, 1440x900 
0x37CA2318, 38092261636063888, 225651792, 225651800, 8, 1440x900 
0x37CA2318, 38092261636726000, 225651858, 225651866, 8, 1440x900 
0x37CA2318, 38092261637395512, 225651932, 225651940, 8, 1440x900 
0x37CA2318, 38092261638054912, 225651994, 225652002, 8, 1440x900 
0x37CA2318, 38092261638706912, 225652058, 225652067, 9, 1440x900 
0x37CA2318, 38092261639372616, 225652127, 225652137, 10, 1440x900 
0x37CA2318, 38092261640023144, 225652192, 225652200, 8, 1440x900 
0x37CA2318, 38092261640692752, 225652253, 225652261, 8, 1440x900 
0x37CA2318, 38092261641353672, 225652323, 225652332, 9, 1440x900 
0x37CA2318, 38092261642014736, 225652389, 225652398, 9, 1440x900 
0x37CA2318, 38092261642676152, 225652457, 225652466, 9, 1440x900 
0x37CA2318, 38092261643328952, 225652522, 225652530, 8, 1440x900 
0x37CA2318, 38092261643999800, 225652593, 225652602, 9, 1440x900 
0x37CA2318, 38092261644658904, 225652652, 225652660, 8, 1440x900 
0x37CA2318, 38092261645319552, 225652722, 225652732, 10, 1440x900 
0x37CA2318, 38092261645981440, 225652788, 225652796, 8, 1440x900 
0x37CA2318, 38092261646639600, 225652853, 225652861, 8, 1440x900 
0x37CA2318, 38092261647302800, 225652917, 225652926, 9, 1440x900 
0x37CA2318, 38092261647955360, 225652987, 225652995, 8, 1440x900 
0x37CA2318, 38092261648634224, 225653052, 225653060, 8, 1440x900 
0x37CA2318, 38092261649293760, 225653117, 225653125, 8, 1440x900 
0x37CA2318, 38092261649954832, 225653182, 225653189, 7, 1440x900 
0x37CA2318, 38092261650612344, 225653253, 225653261, 8, 1440x900 
0x37CA2318, 38092261651266240, 225653318, 225653326, 8, 1440x900 
0x37CA2318, 38092261651927760, 225653383, 225653391, 8, 1440x900 
0x37CA2318, 38092261652581216, 225653448, 225653456, 8, 1440x900 
0x37CA2318, 38092261653243440, 225653512, 225653520, 8, 1440x900 
0x37CA2318, 38092261653906288, 225653582, 225653590, 8, 1440x900 
0x37CA2318, 38092261654576416, 225653647, 225653655, 8, 1440x900 
0x37CA2318, 38092261655236632, 225653708, 225653717, 9, 1440x900 
0x37CA2318, 38092261655886128, 225653778, 225653786, 8, 1440x900 
0x37CA2318, 38092261656548016, 225653847, 225653855, 8, 1440x900 
0x37CA2318, 38092261657208576, 225653913, 225653921, 8, 1440x900 
0x37CA2318, 38092261657877192, 225653973, 225653981, 8, 1440x900 
0x37CA2318, 38092261659189680, 225654107, 225654115, 8, 1440x900 
0x37CA2318, 38092261659859192, 225654177, 225654185, 8, 1440x900 
0x37CA2318, 38092261660515856, 225654243, 225654251, 8, 1440x900 
0x37CA2318, 38092261661173072, 225654303, 225654312, 9, 1440x900 
0x37CA2318, 38092261661823264, 225654368, 225654375, 7, 1440x900 
0x37CA2318, 38092261662489336, 225654437, 225654445, 8, 1440x900 
0x37CA2318, 38092261663160576, 225654507, 225654515, 8, 1440x900 
0x37CA2318, 38092261663812736, 225654568, 225654577, 9, 1440x900 
0x37CA2318, 38092261664473920, 225654637, 225654646, 9, 1440x900 
0x37CA2318, 38092261665135552, 225654703, 225654711, 8, 1440x900 
0x37CA2318, 38092261665796696, 225654772, 225654780, 8, 1440x900 
0x37CA2318, 38092261666453200, 225654833, 225654841, 8, 1440x900 
0x37CA2318, 38092261667114144, 225654902, 225654911, 9, 1440x900 
0x37CA2318, 38092261667783520, 225654967, 225654975, 8, 1440x900 
0x37CA2318, 38092261668437216, 225655033, 225655042, 9, 1440x900 
0x37CA2318, 38092261669104920, 225655098, 225655107, 9, 1440x900 
0x37CA2318, 38092261669754120, 225655164, 225655173, 9, 1440x900 
0x37CA2318, 38092261670418096, 225655229, 225655238, 9, 1440x900 
0x37CA2318, 38092261671086368, 225655297, 225655305, 8, 1440x900 
0x37CA2318, 38092261671736608, 225655363, 225655373, 10, 1440x900 
0x37CA2318, 38092261672406192, 225655432, 225655440, 8, 1440x900 
0x37CA2318, 38092261673059664, 225655493, 225655502, 9, 1440x900 
0x37CA2318, 38092261673716968, 225655563, 225655571, 8, 1440x900 
0x37CA2318, 38092261674378320, 225655628, 225655636, 8, 1440x900 
0x37CA2318, 38092261675048752, 225655693, 225655702, 9, 1440x900 
0x37CA2318, 38092261675702160, 225655763, 225655771, 8, 1440x900 
0x37CA2318, 38092261676362656, 225655823, 225655832, 9, 1440x900 
0x37CA2318, 38092261677033120, 225655893, 225655901, 8, 1440x900 
0x37CA2318, 38092261677685472, 225655958, 225655966, 8, 1440x900 
0x37CA2318, 38092261678345440, 225656022, 225656031, 9, 1440x900 
0x37CA2318, 38092261679010944, 225656088, 225656097, 9, 1440x900 
0x37CA2318, 38092261679661744, 225656152, 225656161, 9, 1440x900 
0x37CA2318, 38092261680325696, 225656219, 225656227, 8, 1440x900 
0x37CA2318, 38092261680997112, 225656287, 225656294, 7, 1440x900 
0x37CA2318, 38092261681657864, 225656352, 225656360, 8, 1440x900 
0x37CA2318, 38092261682321376, 225656423, 225656431, 8, 1440x900 
0x37CA2318, 38092261682973480, 225656488, 225656496, 8, 1440x900 
0x37CA2318, 38092261683634064, 225656549, 225656557, 8, 1440x900 
0x37CA2318, 38092261684298128, 225656616, 225656624, 8, 1440x900 
0x37CA2318, 38092261684966328, 225656687, 225656695, 8, 1440x900 
0x37CA2318, 38092261685615360, 225656753, 225656761, 8, 1440x900 
0x37CA2318, 38092261686278336, 225656817, 225656825, 8, 1440x900 
0x37CA2318, 38092261686934888, 225656883, 225656891, 8, 1440x900 
0x37CA2318, 38092261687596504, 225656948, 225656956, 8, 1440x900 
0x37CA2318, 38092261688268672, 225657017, 225657025, 8, 1440x900 
0x37CA2318, 38092261688930760, 225657083, 225657091, 8, 1440x900 
0x37CA2318, 38092261689600216, 225657152, 225657160, 8, 1440x900 
0x37CA2318, 38092261690255352, 225657213, 225657222, 9, 1440x900 
0x37CA2318, 38092261690908888, 225657278, 225657287, 9, 1440x900 
0x37CA2318, 38092261691571272, 225657348, 225657356, 8, 1440x900 
0x37CA2318, 38092261692230184, 225657413, 225657421, 8, 1440x900 
0x37CA2318, 38092261692892200, 225657478, 225657486, 8, 1440x900 
0x37CA2318, 38092261693553904, 225657548, 225657557, 9, 1440x900 
0x37CA2318, 38092261694214400, 225657608, 225657616, 8, 1440x900 
0x37CA2318, 38092261694884080, 225657678, 225657687, 9, 1440x900 
0x37CA2318, 38092261695536008, 225657743, 225657752, 9, 1440x900 
0x37CA2318, 38092261696201744, 225657807, 225657814, 7, 1440x900 
0x37CA2318, 38092261696667888, 225657852, 225657860, 8, 1440x900 
0x37CA2318, 38092261697530088, 225657937, 225657945, 8, 1440x900 
0x37CA2318, 38092261698199864, 225658007, 225658014, 7, 1440x900 
0x37CA2318, 38092261698850928, 225658072, 225658080, 8, 1440x900 
0x37CA2318, 38092261699516424, 225658143, 225658151, 8, 1440x900 
0x37CA2318, 38092261700173896, 225658203, 225658211, 8, 1440x900 
0x37CA2318, 38092261700836704, 225658271, 225658279, 8, 1440x900 
0x37CA2318, 38092261701497480, 225658338, 225658346, 8, 1440x900 
0x37CA2318, 38092261702150432, 225658402, 225658411, 9, 1440x900 
0x37CA2318, 38092261702814320, 225658468, 225658477, 9, 1440x900 
0x37CA2318, 38092261703474720, 225658538, 225658546, 8, 1440x900 
0x37CA2318, 38092261704134704, 225658604, 225658612, 8, 1440x900 
0x37CA2318, 38092261704805304, 225658667, 225658674, 7, 1440x900 
0x37CA2318, 38092261705456000, 225658733, 225658742, 9, 1440x900 
0x37CA2318, 38092261706116512, 225658803, 225658811, 8, 1440x900 
0x37CA2318, 38092261706777336, 225658868, 225658876, 8, 1440x900 
0x37CA2318, 38092261707447040, 225658937, 225658945, 8, 1440x900 
0x37CA2318, 38092261708095656, 225658997, 225659005, 8, 1440x900 
0x37CA2318, 38092261708571536, 225659042, 225659051, 9, 1440x900 
0x37CA2318, 38092261709433976, 225659129, 225659139, 10, 1440x900 
0x37CA2318, 38092261710101824, 225659193, 225659201, 8, 1440x900 
0x37CA2318, 38092261710755744, 225659262, 225659269, 7, 1440x900 
0x37CA2318, 38092261711408160, 225659327, 225659335, 8, 1440x900 
0x37CA2318, 38092261712076176, 225659398, 225659406, 8, 1440x900 
0x37CA2318, 38092261712729768, 225659462, 225659470, 8, 1440x900 
0x37CA2318, 38092261713409400, 225659527, 225659536, 9, 1440x900 
0x37CA2318, 38092261714061624, 225659597, 225659605, 8, 1440x900 
0x37CA2318, 38092261714721176, 225659659, 225659667, 8, 1440x900 
0x37CA2318, 38092261715389048, 225659726, 225659734, 8, 1440x900 
0x37CA2318, 38092261716047224, 225659793, 225659801, 8, 1440x900 
0x37CA2318, 38092261716710448, 225659857, 225659865, 8, 1440x900 
0x37CA2318, 38092261717368296, 225659923, 225659931, 8, 1440x900 
0x37CA2318, 38092261718037728, 225659991, 225659999, 8, 1440x900 
0x37CA2318, 38092261718699168, 225660057, 225660065, 8, 1440x900 
0x37CA2318, 38092261719349872, 225660122, 225660130, 8, 1440x900 
0x37CA2318, 38092261720002424, 225660187, 225660195, 8, 1440x900 
0x37CA2318, 38092261720674688, 225660257, 225660265, 8, 1440x900 
0x37CA2318, 38092261721331728, 225660323, 225660331, 8, 1440x900 
0x37CA2318, 38092261721992072, 225660388, 225660396, 8, 1440x900 
0x37CA2318, 38092261722653688, 225660453, 225660461, 8, 1440x900 
0x37CA2318, 38092261723322616, 225660522, 225660530, 8, 1440x900 
0x37CA2318, 38092261723983056, 225660587, 225660596, 9, 1440x900 
0x37CA2318, 38092261724641120, 225660653, 225660661, 8, 1440x900 
0x37CA2318, 38092261725301336, 225660718, 225660727, 9, 1440x900 
0x37CA2318, 38092261725955256, 225660782, 225660790, 8, 1440x900 
0x37CA2318, 38092261726609072, 225660848, 225660857, 9, 1440x900 
0x37CA2318, 38092261727270728, 225660912, 225660920, 8, 1440x900 
0x37CA2318, 38092261727938872, 225660981, 225660989, 8, 1440x900 
0x37CA2318, 38092261728591144, 225661048, 225661056, 8, 1440x900 
0x37CA2318, 38092261729252064, 225661113, 225661122, 9, 1440x900 
0x37CA2318, 38092261729912968, 225661182, 225661190, 8, 1440x900 
0x37CA2318, 38092261730587760, 225661248, 225661256, 8, 1440x900 
0x37CA2318, 38092261731238304, 225661312, 225661321, 9, 1440x900 
0x37CA2318, 38092261731899880, 225661377, 225661386, 9, 1440x900 
0x37CA2318, 38092261732562352, 225661443, 225661452, 9, 1440x900 
0x37CA2318, 38092261733223296, 225661512, 225661520, 8, 1440x900 
0x37CA2318, 38092261733883624, 225661577, 225661585, 8, 1440x900 
0x37CA2318, 38092261734551504, 225661647, 225661655, 8, 1440x900 
0x37CA2318, 38092261735865312, 225661773, 225661780, 7, 1440x900 
0x37CA2318, 38092261736525256, 225661840, 225661848, 8, 1440x900 
0x37CA2318, 38092261737185192, 225661903, 225661911, 8, 1440x900 
0x37CA2318, 38092261737850464, 225661972, 225661979, 7, 1440x900 
0x37CA2318, 38092261738503936, 225662038, 225662047, 9, 1440x900 
0x37CA2318, 38092261739169680, 225662104, 225662113, 9, 1440x900 
0x37CA2318, 38092261739831216, 225662173, 225662181, 8, 1440x900 
0x37CA2318, 38092261740500768, 225662239, 225662247, 8, 1440x900 
0x37CA2318, 38092261741154296, 225662303, 225662311, 8, 1440x900 
0x37CA2318, 38092261741806888, 225662369, 225662377, 8, 1440x900 
0x37CA2318, 38092261742446856, 225662432, 225662441, 9, 1440x900 
0x37CA2318, 38092261743133664, 225662503, 225662512, 9, 1440x900 
0x37CA2318, 38092261743802072, 225662568, 225662576, 8, 1440x900 
0x37CA2318, 38092261744453960, 225662633, 225662641, 8, 1440x900 
0x37CA2318, 38092261745115640, 225662698, 225662707, 9, 1440x900 
0x37CA2318, 38092261745784816, 225662768, 225662777, 9, 1440x900 
0x37CA2318, 38092261746435520, 225662834, 225662843, 9, 1440x900 
0x37CA2318, 38092261747094488, 225662897, 225662904, 7, 1440x900 
0x37CA2318, 38092261747754616, 225662962, 225662969, 7, 1440x900 
0x37CA2318, 38092261748421976, 225663028, 225663035, 7, 1440x900 
0x37CA2318, 38092261749083144, 225663093, 225663101, 8, 1440x900 
0x37CA2318, 38092261749737088, 225663161, 225663169, 8, 1440x900 
0x37CA2318, 38092261750400256, 225663227, 225663235, 8, 1440x900 
0x37CA2318, 38092261751076840, 225663296, 225663304, 8, 1440x900 
0x37CA2318, 38092261751731080, 225663361, 225663369, 8, 1440x900 
0x37CA2318, 38092261752393024, 225663428, 225663436, 8, 1440x900 
0x37CA2318, 38092261753066120, 225663493, 225663502, 9, 1440x900 
0x37CA2318, 38092261753715440, 225663563, 225663571, 8, 1440x900 
0x37CA2318, 38092261754376688, 225663628, 225663636, 8, 1440x900 
0x37CA2318, 38092261755074080, 225663712, 225663720, 8, 1440x900 
0x37CA2318, 38092261755502952, 225663737, 225663746, 9, 1440x900 
0x37CA2318, 38092261756166920, 225663802, 225663810, 8, 1440x900 
0x37CA2318, 38092261757015792, 225663888, 225663896, 8, 1440x900 
0x37CA2318, 38092261757686056, 225663957, 225663965, 8, 1440x900 
0x37CA2318, 38092261758333160, 225664021, 225664029, 8, 1440x900 
0x37CA2318, 38092261758996080, 225664086, 225664094, 8, 1440x900 
0x37CA2318, 38092261759666224, 225664153, 225664160, 7, 1440x900 
0x37CA2318, 38092261760318880, 225664223, 225664231, 8, 1440x900 
0x37CA2318, 38092261760978872, 225664287, 225664295, 8, 1440x900 
0x37CA2318, 38092261761648328, 225664353, 225664361, 8, 1440x900 
0x37CA2318, 38092261762299096, 225664417, 225664426, 9, 1440x900 
0x37CA2318, 38092261762958736, 225664483, 225664492, 9, 1440x900 
0x37CA2318, 38092261763628248, 225664552, 225664560, 8, 1440x900 
0x37CA2318, 38092261764286312, 225664618, 225664626, 8, 1440x900 
0x37CA2318, 38092261764945944, 225664682, 225664691, 9, 1440x900 
0x37CA2318, 38092261765605528, 225664752, 225664760, 8, 1440x900 
0x37CA2318, 38092261766270568, 225664817, 225664825, 8, 1440x900 
0x37CA2318, 38092261766928840, 225664883, 225664892, 9, 1440x900 
0x37CA2318, 38092261767592248, 225664943, 225664951, 8, 1440x900 
0x37CA2318, 38092261768253536, 225665011, 225665019, 8, 1440x900 
0x37CA2318, 38092261768914704, 225665077, 225665085, 8, 1440x900 
0x37CA2318, 38092261769575216, 225665148, 225665156, 8, 1440x900 
0x37CA2318, 38092261770238224, 225665212, 225665220, 8, 1440x900 
0x37CA2318, 38092261770898040, 225665278, 225665286, 8, 1440x900 
0x37CA2318, 38092261771548688, 225665347, 225665355, 8, 1440x900 
0x37CA2318, 38092261772211456, 225665408, 225665417, 9, 1440x900 
0x37CA2318, 38092261772872400, 225665478, 225665486, 8, 1440x900 
0x37CA2318, 38092261773524648, 225665544, 225665552, 8, 1440x900 
0x37CA2318, 38092261774185616, 225665608, 225665616, 8, 1440x900 
0x37CA2318, 38092261774856584, 225665677, 225665685, 8, 1440x900 
0x37CA2318, 38092261775526736, 225665743, 225665751, 8, 1440x900 
0x37CA2318, 38092261776186592, 225665808, 225665816, 8, 1440x900 
0x37CA2318, 38092261776841288, 225665877, 225665885, 8, 1440x900 
0x37CA2318, 38092261777502256, 225665937, 225665945, 8, 1440x900 
0x37CA2318, 38092261778171352, 225666008, 225666016, 8, 1440x900 
0x37CA2318, 38092261778824048, 225666073, 225666081, 8, 1440x900 
0x37CA2318, 38092261779486592, 225666138, 225666147, 9, 1440x900 
0x37CA2318, 38092261780143144, 225666201, 225666209, 8, 1440x900 
0x37CA2318, 38092261780805208, 225666268, 225666277, 9, 1440x900 
0x37CA2318, 38092261781466536, 225666337, 225666345, 8, 1440x900 
0x37CA2318, 38092261782128224, 225666402, 225666410, 8, 1440x900 
0x37CA2318, 38092261782789088, 225666467, 225666475, 8, 1440x900 
0x37CA2318, 38092261783439872, 225666533, 225666541, 8, 1440x900 
0x37CA2318, 38092261784115072, 225666598, 225666607, 9, 1440x900 
0x37CA2318, 38092261784768368, 225666667, 225666675, 8, 1440x900 
0x37CA2318, 38092261785430552, 225666733, 225666741, 8, 1440x900 
0x37CA2318, 38092261786083296, 225666797, 225666805, 8, 1440x900 
0x37CA2318, 38092261786753136, 225666867, 225666876, 9, 1440x900 
0x37CA2318, 38092261787413256, 225666928, 225666935, 7, 1440x900 
0x37CA2318, 38092261788076128, 225666993, 225667001, 8, 1440x900 
0x37CA2318, 38092261788726776, 225667058, 225667066, 8, 1440x900 
0x37CA2318, 38092261789396600, 225667127, 225667134, 7, 1440x900 
0x37CA2318, 38092261790050616, 225667192, 225667200, 8, 1440x900 
0x37CA2318, 38092261790717464, 225667258, 225667265, 7, 1440x900 
0x37CA2318, 38092261791371032, 225667323, 225667330, 7, 1440x900 
0x37CA2318, 38092261792033256, 225667393, 225667401, 8, 1440x900 
0x37CA2318, 38092261792704512, 225667458, 225667466, 8, 1440x900 
0x37CA2318, 38092261793357056, 225667523, 225667531, 8, 1440x900 
0x37CA2318, 38092261794017008, 225667588, 225667597, 9, 1440x900 
0x37CA2318, 38092261794678848, 225667659, 225667667, 8, 1440x900 
0x37CA2318, 38092261795338264, 225667722, 225667730, 8, 1440x900 
0x37CA2318, 38092261796000072, 225667788, 225667796, 8, 1440x900 
0x37CA2318, 38092261796652224, 225667857, 225667866, 9, 1440x900 
0x37CA2318, 38092261797331624, 225667923, 225667932, 9, 1440x900 
0x37CA2318, 38092261797981464, 225667986, 225667994, 8, 1440x900 
0x37CA2318, 38092261798662296, 225668052, 225668060, 8, 1440x900 
0x37CA2318, 38092261799313264, 225668122, 225668130, 8, 1440x900 
0x37CA2318, 38092261799973248, 225668188, 225668196, 8, 1440x900 
0x37CA2318, 38092261800633296, 225668252, 225668260, 8, 1440x900 
0x37CA2318, 38092261801291056, 225668316, 225668324, 8, 1440x900 
0x37CA2318, 38092261801961992, 225668387, 225668395, 8, 1440x900 
0x37CA2318, 38092261802616512, 225668452, 225668460, 8, 1440x900 
0x37CA2318, 38092261803267568, 225668518, 225668526, 8, 1440x900 
0x37CA2318, 38092261803947144, 225668582, 225668591, 9, 1440x900 
0x37CA2318, 38092261804598200, 225668647, 225668656, 9, 1440x900 
0x37CA2318, 38092261805261936, 225668714, 225668722, 8, 1440x900 
0x37CA2318, 38092261805921176, 225668783, 225668791, 8, 1440x900 
0x37CA2318, 38092261806589424, 225668847, 225668856, 9, 1440x900 
0x37CA2318, 38092261807238944, 225668912, 225668921, 9, 1440x900 
0x37CA2318, 38092261807917744, 225668978, 225668985, 7, 1440x900 
0x37CA2318, 38092261808587384, 225669047, 225669054, 7, 1440x900 
0x37CA2318, 38092261809247032, 225669112, 225669119, 7, 1440x900 
0x37CA2318, 38092261809906632, 225669177, 225669185, 8, 1440x900 
0x37CA2318, 38092261810576672, 225669242, 225669250, 8, 1440x900 
0x37CA2318, 38092261811226848, 225669307, 225669315, 8, 1440x900 
0x37CA2318, 38092261811896288, 225669379, 225669387, 8, 1440x900 
0x37CA2318, 38092261812558896, 225669447, 225669455, 8, 1440x900 
0x37CA2318, 38092261813212288, 225669512, 225669520, 8, 1440x900 
0x37CA2318, 38092261814545032, 225669646, 225669654, 8, 1440x900 
0x37CA2318, 38092261815202864, 225669707, 225669716, 9, 1440x900 
0x37CA2318, 38092261815862984, 225669772, 225669781, 9, 1440x900 
0x37CA2318, 38092261816527352, 225669840, 225669849, 9, 1440x900 
0x37CA2318, 38092261817186528, 225669908, 225669916, 8, 1440x900 
0x37CA2318, 38092261817847992, 225669973, 225669982, 9, 1440x900 
0x37CA2318, 38092261818507896, 225670039, 225670047, 8, 1440x900 
0x37CA2318, 38092261819168336, 225670108, 225670116, 8, 1440x900 
0x37CA2318, 38092261819830048, 225670173, 225670181, 8, 1440x900 
0x37CA2318, 38092261820481968, 225670238, 225670246, 8, 1440x900 
0x37CA2318, 38092261821152208, 225670303, 225670310, 7, 1440x900 
0x37CA2318, 38092261821810392, 225670367, 225670375, 8, 1440x900 
0x37CA2318, 38092261822470296, 225670433, 225670440, 7, 1440x900 
0x37CA2318, 38092261823141584, 225670501, 225670509, 8, 1440x900 
0x37CA2318, 38092261823795064, 225670569, 225670577, 8, 1440x900 
0x37CA2318, 38092261824450144, 225670634, 225670642, 8, 1440x900 
0x37CA2318, 38092261825116464, 225670702, 225670710, 8, 1440x900 
0x37CA2318, 38092261825777840, 225670768, 225670776, 8, 1440x900 
0x37CA2318, 38092261826439768, 225670833, 225670841, 8, 1440x900 
0x37CA2318, 38092261827108400, 225670902, 225670910, 8, 1440x900 
0x37CA2318, 38092261827766264, 225670968, 225670976, 8, 1440x900 
0x37CA2318, 38092261828426200, 225671028, 225671036, 8, 1440x900 
0x37CA2318, 38092261829078792, 225671096, 225671104, 8, 1440x900 
0x37CA2318, 38092261829731160, 225671162, 225671170, 8, 1440x900 
0x37CA2318, 38092261830401400, 225671227, 225671235, 8, 1440x900 
0x37CA2318, 38092261831062000, 225671293, 225671302, 9, 1440x900 
0x37CA2318, 38092261831722288, 225671363, 225671371, 8, 1440x900 
0x37CA2318, 38092261832382712, 225671428, 225671436, 8, 1440x900 
0x37CA2318, 38092261833040136, 225671493, 225671501, 8, 1440x900 
0x37CA2318, 38092261833718936, 225671558, 225671567, 9, 1440x900 
0x37CA2318, 38092261834380112, 225671627, 225671635, 8, 1440x900 
0x37CA2318, 38092261835039768, 225671693, 225671701, 8, 1440x900 
0x37CA2318, 38092261835689432, 225671757, 225671765, 8, 1440x900 
0x37CA2318, 38092261836368704, 225671827, 225671835, 8, 1440x900 
0x37CA2318, 38092261837027080, 225671892, 225671900, 8, 1440x900 
0x37CA2318, 38092261837689392, 225671957, 225671966, 9, 1440x900 
0x37CA2318, 38092261838340016, 225672028, 225672037, 9, 1440x900 
0x37CA2318, 38092261839009368, 225672087, 225672095, 8, 1440x900 
0x37CA2318, 38092261839669688, 225672153, 225672161, 8, 1440x900 
0x37CA2318, 38092261840321984, 225672218, 225672226, 8, 1440x900 
0x37CA2318, 38092261840981976, 225672288, 225672297, 9, 1440x900 
0x37CA2318, 38092261841644568, 225672352, 225672360, 8, 1440x900 
0x37CA2318, 38092261842303008, 225672416, 225672424, 8, 1440x900 
0x37CA2318, 38092261842965736, 225672488, 225672496, 8, 1440x900 
0x37CA2318, 38092261843626832, 225672553, 225672561, 8, 1440x900 
0x37CA2318, 38092261844296240, 225672618, 225672626, 8, 1440x900 
0x37CA2318, 38092261844949208, 225672683, 225672692, 9, 1440x900 
0x37CA2318, 38092261845608336, 225672753, 225672761, 8, 1440x900 
0x37CA2318, 38092261846271128, 225672817, 225672825, 8, 1440x900 
0x37CA2318, 38092261846938976, 225672883, 225672891, 8, 1440x900 
0x37CA2318, 38092261847590176, 225672947, 225672955, 8, 1440x900 
0x37CA2318, 38092261848252888, 225673012, 225673021, 9, 1440x900 
0x37CA2318, 38092261848912400, 225673082, 225673090, 8, 1440x900 
0x37CA2318, 38092261849582720, 225673147, 225673157, 10, 1440x900 
0x37CA2318, 38092261850226568, 225673213, 225673221, 8, 1440x900 
0x37CA2318, 38092261850896072, 225673278, 225673286, 8, 1440x900 
0x37CA2318, 38092261851546776, 225673342, 225673350, 8, 1440x900 
0x37CA2318, 38092261852211024, 225673408, 225673417, 9, 1440x900 
0x37CA2318, 38092261852881864, 225673478, 225673486, 8, 1440x900 
0x37CA2318, 38092261853534976, 225673543, 225673552, 9, 1440x900 
0x37CA2318, 38092261854196384, 225673608, 225673616, 8, 1440x900 
0x37CA2318, 38092261854868480, 225673673, 225673683, 10, 1440x900 
0x37CA2318, 38092261855528664, 225673743, 225673751, 8, 1440x900 
0x37CA2318, 38092261856182072, 225673807, 225673816, 9, 1440x900 
0x37CA2318, 38092261856856264, 225673872, 225673881, 9, 1440x900 
0x37CA2318, 38092261857517304, 225673942, 225673950, 8, 1440x900 
0x37CA2318, 38092261858176936, 225674008, 225674016, 8, 1440x900 
0x37CA2318, 38092261858838160, 225674074, 225674083, 9, 1440x900 
0x37CA2318, 38092261859489648, 225674138, 225674147, 9, 1440x900 
0x37CA2318, 38092261860149696, 225674207, 225674215, 8, 1440x900 
0x37CA2318, 38092261860811456, 225674272, 225674280, 8, 1440x900 
0x37CA2318, 38092261861471224, 225674338, 225674347, 9, 1440x900 
0x37CA2318, 38092261862129472, 225674403, 225674411, 8, 1440x900 
0x37CA2318, 38092261862809072, 225674468, 225674476, 8, 1440x900 
0x37CA2318, 38092261863458976, 225674532, 225674541, 9, 1440x900 
0x37CA2318, 38092261864129536, 225674602, 225674610, 8, 1440x900 
0x37CA2318, 38092261864789536, 225674667, 225674675, 8, 1440x900 
0x37CA2318, 38092261865441472, 225674732, 225674741, 9, 1440x900 
0x37CA2318, 38092261866100896, 225674803, 225674811, 8, 1440x900 
0x37CA2318, 38092261866763376, 225674863, 225674872, 9, 1440x900 
0x37CA2318, 38092261867415528, 225674933, 225674941, 8, 1440x900 
0x37CA2318, 38092261868087448, 225674997, 225675005, 8, 1440x900 
0x37CA2318, 38092261868739640, 225675063, 225675072, 9, 1440x900 
0x37CA2318, 38092261869400872, 225675132, 225675139, 7, 1440x900 
0x37CA2318, 38092261870060632, 225675192, 225675200, 8, 1440x900 
0x37CA2318, 38092261870723880, 225675262, 225675270, 8, 1440x900 
0x37CA2318, 38092261871393808, 225675328, 225675336, 8, 1440x900 
0x37CA2318, 38092261872048608, 225675394, 225675402, 8, 1440x900 
0x37CA2318, 38092261872700608, 225675458, 225675466, 8, 1440x900 
0x37CA2318, 38092261873365072, 225675524, 225675533, 9, 1440x900 
0x37CA2318, 38092261874025888, 225675594, 225675602, 8, 1440x900 
0x37CA2318, 38092261874696152, 225675657, 225675666, 9, 1440x900 
0x37CA2318, 38092261875347760, 225675727, 225675735, 8, 1440x900 
0x37CA2318, 38092261876017968, 225675793, 225675801, 8, 1440x900 
0x37CA2318, 38092261876668368, 225675858, 225675866, 8, 1440x900 
0x37CA2318, 38092261877329488, 225675923, 225675931, 8, 1440x900 
0x37CA2318, 38092261877999248, 225675987, 225675996, 9, 1440x900 
0x37CA2318, 38092261878651432, 225676053, 225676062, 9, 1440x900 
0x37CA2318, 38092261879312240, 225676122, 225676131, 9, 1440x900 
0x37CA2318, 38092261879971944, 225676183, 225676192, 9, 1440x900 
0x37CA2318, 38092261880632880, 225676253, 225676261, 8, 1440x900 
0x37CA2318, 38092261881286504, 225676318, 225676327, 9, 1440x900 
0x37CA2318, 38092261881963792, 225676387, 225676395, 8, 1440x900 
0x37CA2318, 38092261882616960, 225676452, 225676460, 8, 1440x900 
0x37CA2318, 38092261883279336, 225676517, 225676525, 8, 1440x900 
0x37CA2318, 38092261883940112, 225676578, 225676587, 9, 1440x900 
0x37CA2318, 38092261884610016, 225676648, 225676657, 9, 1440x900 
0x37CA2318, 38092261885260984, 225676713, 225676722, 9, 1440x900 
0x37CA2318, 38092261885922064, 225676783, 225676791, 8, 1440x900 
0x37CA2318, 38092261886581464, 225676847, 225676855, 8, 1440x900 
0x37CA2318, 38092261887243920, 225676912, 225676920, 8, 1440x900 
0x37CA2318, 38092261887913848, 225676982, 225676990, 8, 1440x900 
0x37CA2318, 38092261888566984, 225677043, 225677052, 9, 1440x900 
0x37CA2318, 38092261889222160, 225677108, 225677117, 9, 1440x900 
0x37CA2318, 38092261889884248, 225677178, 225677186, 8, 1440x900 
0x37CA2318, 38092261890545568, 225677243, 225677251, 8, 1440x900 
0x37CA2318, 38092261891868216, 225677378, 225677387, 9, 1440x900 
0x37CA2318, 38092261892529888, 225677442, 225677450, 8, 1440x900 
0x37CA2318, 38092261893188832, 225677509, 225677517, 8, 1440x900 
0x37CA2318, 38092261893848088, 225677573, 225677583, 10, 1440x900 
0x37CA2318, 38092261894528080, 225677638, 225677646, 8, 1440x900 
0x37CA2318, 38092261895174144, 225677703, 225677711, 8, 1440x900 
0x37CA2318, 38092261895846888, 225677773, 225677781, 8, 1440x900 
0x37CA2318, 38092261896507624, 225677843, 225677851, 8, 1440x900 
0x37CA2318, 38092261897167336, 225677907, 225677915, 8, 1440x900 
0x37CA2318, 38092261897832848, 225677973, 225677981, 8, 1440x900 
0x37CA2318, 38092261898493136, 225678037, 225678046, 9, 1440x900 
0x37CA2318, 38092261899145568, 225678103, 225678112, 9, 1440x900 
0x37CA2318, 38092261899815792, 225678172, 225678180, 8, 1440x900 
0x37CA2318, 38092261900480640, 225678238, 225678246, 8, 1440x900 
0x37CA2318, 38092261901136352, 225678302, 225678310, 8, 1440x900 
0x37CA2318, 38092261901797888, 225678367, 225678376, 9, 1440x900 
0x37CA2318, 38092261902448976, 225678437, 225678445, 8, 1440x900 
0x37CA2318, 38092261903126752, 225678502, 225678510, 8, 1440x900 
0x37CA2318, 38092261903788224, 225678567, 225678575, 8, 1440x900 
0x37CA2318, 38092261904440384, 225678638, 225678646, 8, 1440x900 
0x37CA2318, 38092261905092080, 225678698, 225678706, 8, 1440x900 
0x37CA2318, 38092261905762696, 225678764, 225678772, 8, 1440x900 
0x37CA2318, 38092261906423568, 225678828, 225678838, 10, 1440x900 
0x37CA2318, 38092261907083272, 225678898, 225678908, 10, 1440x900 
0x37CA2318, 38092261907745088, 225678963, 225678972, 9, 1440x900 
0x37CA2318, 38092261908406048, 225679032, 225679040, 8, 1440x900 
0x37CA2318, 38092261909074856, 225679099, 225679107, 8, 1440x900 
0x37CA2318, 38092261909737616, 225679163, 225679171, 8, 1440x900 
0x37CA2318, 38092261910395384, 225679228, 225679236, 8, 1440x900 
0x37CA2318, 38092261911057568, 225679293, 225679302, 9, 1440x900 
0x37CA2318, 38092261911708960, 225679363, 225679371, 8, 1440x900 
0x37CA2318, 38092261912388608, 225679428, 225679436, 8, 1440x900 
0x37CA2318, 38092261913047824, 225679493, 225679501, 8, 1440x900 
0x37CA2318, 38092261913718368, 225679560, 225679569, 9, 1440x900 
0x37CA2318, 38092261914371680, 225679627, 225679635, 8, 1440x900 
0x37CA2318, 38092261915030864, 225679692, 225679700, 8, 1440x900 
0x37CA2318, 38092261915691320, 225679758, 225679766, 8, 1440x900 
0x37CA2318, 38092261916341552, 225679823, 225679831, 8, 1440x900 
0x37CA2318, 38092261917013536, 225679893, 225679901, 8, 1440x900 
0x37CA2318, 38092261917682536, 225679957, 225679966, 9, 1440x900 
0x37CA2318, 38092261918353200, 225680027, 225680035, 8, 1440x900 
0x37CA2318, 38092261919003144, 225680088, 225680097, 9, 1440x900 
0x37CA2318, 38092261919665064, 225680155, 225680165, 10, 1440x900 
0x37CA2318, 38092261920326360, 225680218, 225680227, 9, 1440x900 
0x37CA2318, 38092261920986816, 225680287, 225680294, 7, 1440x900 
0x37CA2318, 38092261921653112, 225680353, 225680362, 9, 1440x900 
0x37CA2318, 38092261922314920, 225680419, 225680428, 9, 1440x900 
0x37CA2318, 38092261922966688, 225680484, 225680492, 8, 1440x900 
0x37CA2318, 38092261923646968, 225680557, 225680566, 9, 1440x900 
0x37CA2318, 38092261924305880, 225680618, 225680627, 9, 1440x900 
0x37CA2318, 38092261924976024, 225680687, 225680695, 8, 1440x900 
0x37CA2318, 38092261925628544, 225680753, 225680762, 9, 1440x900 
0x37CA2318, 38092261926286296, 225680813, 225680821, 8, 1440x900 
0x37CA2318, 38092261926948032, 225680887, 225680896, 9, 1440x900 
0x37CA2318, 38092261927609112, 225680947, 225680956, 9, 1440x900 
0x37CA2318, 38092261928269112, 225681018, 225681026, 8, 1440x900 
0x37CA2318, 38092261928929952, 225681083, 225681092, 9, 1440x900 
0x37CA2318, 38092261929581304, 225681148, 225681157, 9, 1440x900 
0x37CA2318, 38092261930251960, 225681217, 225681225, 8, 1440x900 
0x37CA2318, 38092261930906520, 225681277, 225681285, 8, 1440x900 
0x37CA2318, 38092261931576152, 225681347, 225681355, 8, 1440x900 
0x37CA2318, 38092261932234032, 225681413, 225681421, 8, 1440x900 
0x37CA2318, 38092261932895296, 225681478, 225681487, 9, 1440x900 
0x37CA2318, 38092261933555616, 225681543, 225681552, 9, 1440x900 
0x37CA2318, 38092261934216624, 225681613, 225681621, 8, 1440x900 
0x37CA2318, 38092261934882608, 225681678, 225681686, 8, 1440x900 
0x37CA2318, 38092261935543736, 225681743, 225681751, 8, 1440x900 
0x37CA2318, 38092261936204096, 225681809, 225681817, 8, 1440x900 
0x37CA2318, 38092261936854192, 225681873, 225681880, 7, 1440x900 
0x37CA2318, 38092261937525616, 225681943, 225681951, 8, 1440x900 
0x37CA2318, 38092261938178032, 225682008, 225682016, 8, 1440x900 
0x37CA2318, 38092261938846736, 225682073, 225682082, 9, 1440x900 
0x37CA2318, 38092261939518312, 225682143, 225682151, 8, 1440x900 
0x37CA2318, 38092261940167776, 225682203, 225682212, 9, 1440x900 
0x37CA2318, 38092261940828288, 225682272, 225682280, 8, 1440x900 
0x37CA2318, 38092261941489528, 225682338, 225682346, 8, 1440x900 
0x37CA2318, 38092261942142592, 225682403, 225682411, 8, 1440x900 
0x37CA2318, 38092261942811256, 225682468, 225682477, 9, 1440x900 
0x37CA2318, 38092261943472184, 225682538, 225682546, 8, 1440x900 
0x37CA2318, 38092261944130960, 225682602, 225682611, 9, 1440x900 
0x37CA2318, 38092261944800440, 225682667, 225682676, 9, 1440x900 
0x37CA2318, 38092261945461912, 225682732, 225682741, 9, 1440x900 
0x37CA2318, 38092261946112232, 225682803, 225682811, 8, 1440x900 
0x37CA2318, 38092261946773448, 225682868, 225682876, 8, 1440x900 
0x37CA2318, 38092261947425968, 225682932, 225682940, 8, 1440x900 
0x37CA2318, 38092261948097296, 225682997, 225683006, 9, 1440x900 
0x37CA2318, 38092261948748880, 225683062, 225683071, 9, 1440x900 
0x37CA2318, 38092261949411472, 225683128, 225683137, 9, 1440x900 
0x37CA2318, 38092261950072472, 225683197, 225683205, 8, 1440x900 
0x37CA2318, 38092261950735048, 225683264, 225683272, 8, 1440x900 
0x37CA2318, 38092261951404552, 225683327, 225683335, 8, 1440x900 
0x37CA2318, 38092261952055952, 225683398, 225683406, 8, 1440x900 
0x37CA2318, 38092261952708240, 225683462, 225683470, 8, 1440x900 
0x37CA2318, 38092261953379360, 225683528, 225683536, 8, 1440x900 
0x37CA2318, 38092261954040376, 225683592, 225683600, 8, 1440x900 
0x37CA2318, 38092261954701240, 225683657, 225683666, 9, 1440x900 
0x37CA2318, 38092261955364272, 225683728, 225683736, 8, 1440x900 
0x37CA2318, 38092261956024168, 225683792, 225683800, 8, 1440x900 
0x37CA2318, 38092261956685008, 225683858, 225683866, 8, 1440x900 
0x37CA2318, 38092261957346360, 225683923, 225683932, 9, 1440x900 
0x37CA2318, 38092261958006040, 225683988, 225683995, 7, 1440x900 
0x37CA2318, 38092261958668064, 225684058, 225684066, 8, 1440x900 
0x37CA2318, 38092261959326904, 225684123, 225684131, 8, 1440x900 
0x37CA2318, 38092261959985728, 225684188, 225684196, 8, 1440x900 
0x37CA2318, 38092261960659072, 225684257, 225684265, 8, 1440x900 
0x37CA2318, 38092261961311008, 225684317, 225684325, 8, 1440x900 
0x37CA2318, 38092261961973680, 225684383, 225684391, 8, 1440x900 
0x37CA2318, 38092261962627464, 225684452, 225684461, 9, 1440x900 
0x37CA2318, 38092261963292104, 225684517, 225684525, 8, 1440x900 
0x37CA2318, 38092261963954440, 225684588, 225684595, 7, 1440x900 
0x37CA2318, 38092261964605224, 225684649, 225684658, 9, 1440x900 
0x37CA2318, 38092261965276048, 225684718, 225684726, 8, 1440x900 
0x37CA2318, 38092261965926248, 225684783, 225684791, 8, 1440x900 
0x37CA2318, 38092261966598648, 225684847, 225684856, 9, 1440x900 
0x37CA2318, 38092261967256136, 225684917, 225684925, 8, 1440x900 
0x37CA2318, 38092261967917056, 225684978, 225684988, 10, 1440x900 
0x37CA2318, 38092261968585448, 225685043, 225685051, 8, 1440x900 
0x37CA2318, 38092261969245544, 225685112, 225685120, 8, 1440x900 
0x37CA2318, 38092261969902896, 225685176, 225685184, 8, 1440x900 
0x37CA2318, 38092261970556000, 225685247, 225685255, 8, 1440x900 
0x37CA2318, 38092261971218208, 225685313, 225685321, 8, 1440x900 
0x37CA2318, 38092261972537728, 225685442, 225685450, 8, 1440x900 
0x37CA2318, 38092261973198456, 225685508, 225685516, 8, 1440x900 
0x37CA2318, 38092261973859368, 225685573, 225685582, 9, 1440x900 
0x37CA2318, 38092261974529056, 225685638, 225685646, 8, 1440x900 
0x37CA2318, 38092261975173104, 225685703, 225685710, 7, 1440x900 
0x37CA2318, 38092261975835968, 225685772, 225685780, 8, 1440x900 
0x37CA2318, 38092261976498504, 225685838, 225685847, 9, 1440x900 
0x37CA2318, 38092261977158448, 225685908, 225685916, 8, 1440x900 
0x37CA2318, 38092261977820760, 225685968, 225685976, 8, 1440x900 
0x37CA2318, 38092261978486104, 225686039, 225686047, 8, 1440x900 
0x37CA2318, 38092261979137488, 225686102, 225686110, 8, 1440x900 
0x37CA2318, 38092261979814472, 225686168, 225686177, 9, 1440x900 
0x37CA2318, 38092261980467168, 225686238, 225686246, 8, 1440x900 
0x37CA2318, 38092261981136896, 225686302, 225686310, 8, 1440x900 
0x37CA2318, 38092261981795560, 225686369, 225686377, 8, 1440x900 
0x37CA2318, 38092261982449208, 225686432, 225686441, 9, 1440x900 
0x37CA2318, 38092261983100792, 225686497, 225686506, 9, 1440x900 
0x37CA2318, 38092261983762736, 225686563, 225686572, 9, 1440x900 
0x37CA2318, 38092261984425712, 225686633, 225686641, 8, 1440x900 
0x37CA2318, 38092261985097848, 225686698, 225686706, 8, 1440x900 
0x37CA2318, 38092261985759520, 225686768, 225686776, 8, 1440x900 
0x37CA2318, 38092261986421688, 225686832, 225686840, 8, 1440x900 
0x37CA2318, 38092261987082368, 225686898, 225686906, 8, 1440x900 
0x37CA2318, 38092261987742392, 225686963, 225686971, 8, 1440x900 
0x37CA2318, 38092261988394144, 225687027, 225687036, 9, 1440x900 
0x37CA2318, 38092261989055488, 225687097, 225687105, 8, 1440x900 
0x37CA2318, 38092261989716664, 225687158, 225687166, 8, 1440x900 
0x37CA2318, 38092261990375544, 225687222, 225687231, 9, 1440x900 
0x37CA2318, 38092261991030912, 225687293, 225687301, 8, 1440x900 
0x37CA2318, 38092261991701280, 225687363, 225687372, 9, 1440x900 
0x37CA2318, 38092261992362360, 225687428, 225687436, 8, 1440x900 
0x37CA2318, 38092261993032048, 225687492, 225687500, 8, 1440x900 
0x37CA2318, 38092261993679912, 225687558, 225687566, 8, 1440x900 
0x37CA2318, 38092261994356344, 225687623, 225687632, 9, 1440x900 
0x37CA2318, 38092261995008584, 225687688, 225687696, 8, 1440x900 
0x37CA2318, 38092261995671440, 225687753, 225687763, 10, 1440x900 
0x37CA2318, 38092261996325600, 225687822, 225687830, 8, 1440x900 
0x37CA2318, 38092261996989040, 225687888, 225687896, 8, 1440x900 
0x37CA2318, 38092261997641232, 225687952, 225687960, 8, 1440x900 
0x37CA2318, 38092261998303528, 225688022, 225688031, 9, 1440x900 
0x37CA2318, 38092261998976272, 225688087, 225688095, 8, 1440x900 
0x37CA2318, 38092261999632624, 225688152, 225688160, 8, 1440x900 
0x37CA2318, 38092262000283392, 225688213, 225688221, 8, 1440x900 
0x37CA2318, 38092262000963160, 225688282, 225688290, 8, 1440x900 
0x37CA2318, 38092262001614768, 225688351, 225688359, 8, 1440x900 
0x37CA2318, 38092262002273680, 225688413, 225688422, 9, 1440x900 
0x37CA2318, 38092262002942472, 225688487, 225688495, 8, 1440x900 
0x37CA2318, 38092262003603608, 225688547, 225688557, 10, 1440x900 
0x37CA2318, 38092262004255064, 225688612, 225688621, 9, 1440x900 
0x37CA2318, 38092262004916760, 225688683, 225688691, 8, 1440x900 
0x37CA2318, 38092262005577272, 225688748, 225688756, 8, 1440x900 
0x37CA2318, 38092262006239824, 225688813, 225688821, 8, 1440x900 
0x37CA2318, 38092262006892640, 225688878, 225688887, 9, 1440x900 
0x37CA2318, 38092262007553832, 225688948, 225688956, 8, 1440x900 
0x37CA2318, 38092262008216832, 225689009, 225689017, 8, 1440x900 
0x37CA2318, 38092262008886488, 225689077, 225689086, 9, 1440x900 
0x37CA2318, 38092262009537528, 225689143, 225689151, 8, 1440x900 
0x37CA2318, 38092262010197952, 225689207, 225689215, 8, 1440x900 
0x37CA2318, 38092262010869160, 225689273, 225689281, 8, 1440x900 
0x37CA2318, 38092262011514008, 225689337, 225689345, 8, 1440x900 
0x37CA2318, 38092262012187928, 225689408, 225689416, 8, 1440x900 
0x37CA2318, 38092262012837960, 225689472, 225689480, 8, 1440x900 
0x37CA2318, 38092262013504224, 225689537, 225689547, 10, 1440x900 
0x37CA2318, 38092262014155992, 225689607, 225689615, 8, 1440x900 
0x37CA2318, 38092262014824800, 225689674, 225689682, 8, 1440x900 
0x37CA2318, 38092262015485664, 225689737, 225689745, 8, 1440x900 
0x37CA2318, 38092262016148048, 225689803, 225689811, 8, 1440x900 
0x37CA2318, 38092262016799144, 225689868, 225689876, 8, 1440x900 
0x37CA2318, 38092262017465968, 225689938, 225689946, 8, 1440x900 
0x37CA2318, 38092262018121272, 225690003, 225690011, 8, 1440x900 
0x37CA2318, 38092262018785728, 225690067, 225690075, 8, 1440x900 
0x37CA2318, 38092262019449280, 225690133, 225690141, 8, 1440x900 
0x37CA2318, 38092262020111160, 225690198, 225690208, 10, 1440x900 
0x37CA2318, 38092262020762064, 225690268, 225690277, 9, 1440x900 
0x37CA2318, 38092262021432768, 225690331, 225690339, 8, 1440x900 
0x37CA2318, 38092262022085120, 225690397, 225690405, 8, 1440x900 
0x37CA2318, 38092262022757784, 225690463, 225690471, 8, 1440x900 
0x37CA2318, 38092262023410864, 225690527, 225690534, 7, 1440x900 
0x37CA2318, 38092262024071200, 225690593, 225690600, 7, 1440x900 
0x37CA2318, 38092262024727832, 225690658, 225690666, 8, 1440x900 
0x37CA2318, 38092262025401936, 225690728, 225690736, 8, 1440x900 
0x37CA2318, 38092262026054608, 225690793, 225690801, 8, 1440x900 
0x37CA2318, 38092262026714264, 225690858, 225690867, 9, 1440x900 
0x37CA2318, 38092262027375632, 225690928, 225690936, 8, 1440x900 
0x37CA2318, 38092262028029216, 225690993, 225691001, 8, 1440x900 
0x37CA2318, 38092262028700144, 225691058, 225691067, 9, 1440x900 
0x37CA2318, 38092262029353552, 225691122, 225691131, 9, 1440x900 
0x37CA2318, 38092262030016072, 225691192, 225691200, 8, 1440x900 
0x37CA2318, 38092262030685640, 225691257, 225691266, 9, 1440x900 
0x37CA2318, 38092262031347608, 225691324, 225691332, 8, 1440x900 
0x37CA2318, 38092262032016824, 225691388, 225691395, 7, 1440x900 
0x37CA2318, 38092262032669584, 225691457, 225691466, 9, 1440x900 
0x37CA2318, 38092262033330288, 225691518, 225691527, 9, 1440x900 
0x37CA2318, 38092262033981848, 225691583, 225691591, 8, 1440x900 
0x37CA2318, 38092262034642816, 225691652, 225691660, 8, 1440x900 
0x37CA2318, 38092262035314344, 225691722, 225691731, 9, 1440x900 
0x37CA2318, 38092262035975536, 225691788, 225691795, 7, 1440x900 
0x37CA2318, 38092262036644432, 225691853, 225691862, 9, 1440x900 
0x37CA2318, 38092262037293544, 225691917, 225691925, 8, 1440x900 
0x37CA2318, 38092262037954448, 225691983, 225691992, 9, 1440x900 
0x37CA2318, 38092262038615840, 225692053, 225692061, 8, 1440x900 
0x37CA2318, 38092262039277976, 225692117, 225692125, 8, 1440x900 
0x37CA2318, 38092262039930024, 225692183, 225692191, 8, 1440x900 
0x37CA2318, 38092262040599192, 225692248, 225692256, 8, 1440x900 
0x37CA2318, 38092262041270152, 225692318, 225692326, 8, 1440x900 
0x37CA2318, 38092262041938912, 225692378, 225692386, 8, 1440x900 
0x37CA2318, 38092262043278024, 225692512, 225692520, 8, 1440x900 
0x37CA2318, 38092262043937840, 225692578, 225692586, 8, 1440x900 
0x37CA2318, 38092262044590552, 225692646, 225692654, 8, 1440x900 
0x37CA2318, 38092262045259384, 225692712, 225692721, 9, 1440x900 
0x37CA2318, 38092262045927736, 225692783, 225692791, 8, 1440x900 
0x37CA2318, 38092262046586056, 225692848, 225692856, 8, 1440x900 
0x37CA2318, 38092262047246384, 225692914, 225692922, 8, 1440x900 
0x37CA2318, 38092262047917024, 225692982, 225692990, 8, 1440x900 
0x37CA2318, 38092262048586368, 225693047, 225693055, 8, 1440x900 
0x37CA2318, 38092262049246328, 225693112, 225693120, 8, 1440x900 
0x37CA2318, 38092262049898720, 225693182, 225693190, 8, 1440x900 
0x37CA2318, 38092262050559776, 225693248, 225693256, 8, 1440x900 
0x37CA2318, 38092262051218680, 225693312, 225693320, 8, 1440x900 
0x37CA2318, 38092262051879320, 225693378, 225693386, 8, 1440x900 
0x37CA2318, 38092262052542088, 225693443, 225693452, 9, 1440x900 
0x37CA2318, 38092262053211776, 225693508, 225693517, 9, 1440x900 
0x37CA2318, 38092262053863504, 225693577, 225693585, 8, 1440x900 
0x37CA2318, 38092262054530272, 225693643, 225693652, 9, 1440x900 
0x37CA2318, 38092262055240088, 225693710, 225693718, 8, 1440x900 
0x37CA2318, 38092262055706280, 225693757, 225693764, 7, 1440x900 
0x37CA2318, 38092262056552896, 225693842, 225693850, 8, 1440x900 
0x37CA2318, 38092262057230232, 225693912, 225693920, 8, 1440x900 
0x37CA2318, 38092262057882728, 225693977, 225693985, 8, 1440x900 
0x37CA2318, 38092262058535320, 225694042, 225694050, 8, 1440x900 
0x37CA2318, 38092262059200088, 225694108, 225694117, 9, 1440x900 
0x37CA2318, 38092262059881312, 225694178, 225694186, 8, 1440x900 
0x37CA2318, 38092262060536720, 225694241, 225694249, 8, 1440x900 
0x37CA2318, 38092262061197784, 225694312, 225694320, 8, 1440x900 
0x37CA2318, 38092262061856152, 225694377, 225694385, 8, 1440x900 
0x37CA2318, 38092262062516888, 225694438, 225694447, 9, 1440x900 
0x37CA2318, 38092262063186768, 225694508, 225694516, 8, 1440x900 
0x37CA2318, 38092262063828592, 225694573, 225694582, 9, 1440x900 
0x37CA2318, 38092262064491328, 225694637, 225694646, 9, 1440x900 
0x37CA2318, 38092262065157360, 225694707, 225694715, 8, 1440x900 
0x37CA2318, 38092262065818416, 225694772, 225694780, 8, 1440x900 
0x37CA2318, 38092262066481296, 225694838, 225694847, 9, 1440x900 
0x37CA2318, 38092262067151064, 225694903, 225694912, 9, 1440x900 
0x37CA2318, 38092262067802104, 225694972, 225694980, 8, 1440x900 
0x37CA2318, 38092262068464736, 225695037, 225695045, 8, 1440x900 
0x37CA2318, 38092262069115144, 225695098, 225695106, 8, 1440x900 
0x37CA2318, 38092262069785072, 225695168, 225695178, 10, 1440x900 
0x37CA2318, 38092262070445544, 225695237, 225695245, 8, 1440x900 
0x37CA2318, 38092262071114936, 225695298, 225695307, 9, 1440x900 
0x37CA2318, 38092262071768176, 225695363, 225695372, 9, 1440x900 
0x37CA2318, 38092262072436888, 225695433, 225695441, 8, 1440x900 
0x37CA2318, 38092262073097240, 225695497, 225695506, 9, 1440x900 
0x37CA2318, 38092262073744824, 225695562, 225695570, 8, 1440x900 
0x37CA2318, 38092262074406208, 225695632, 225695640, 8, 1440x900 
0x37CA2318, 38092262075076664, 225695698, 225695706, 8, 1440x900 
0x37CA2318, 38092262075731648, 225695763, 225695771, 8, 1440x900 
0x37CA2318, 38092262076399992, 225695827, 225695836, 9, 1440x900 
0x37CA2318, 38092262077049968, 225695894, 225695903, 9, 1440x900 
0x37CA2318, 38092262077711872, 225695958, 225695967, 9, 1440x900 
0x37CA2318, 38092262078380320, 225696027, 225696035, 8, 1440x900 
0x37CA2318, 38092262079043464, 225696093, 225696101, 8, 1440x900 
0x37CA2318, 38092262079695960, 225696157, 225696166, 9, 1440x900 
0x37CA2318, 38092262080357568, 225696228, 225696236, 8, 1440x900 
0x37CA2318, 38092262081018808, 225696288, 225696297, 9, 1440x900 
0x37CA2318, 38092262081675224, 225696358, 225696366, 8, 1440x900 
0x37CA2318, 38092262082338520, 225696422, 225696431, 9, 1440x900 
0x37CA2318, 38092262082999984, 225696487, 225696496, 9, 1440x900 
0x37CA2318, 38092262083661648, 225696558, 225696567, 9, 1440x900 
0x37CA2318, 38092262084321680, 225696618, 225696625, 7, 1440x900 
0x37CA2318, 38092262084982808, 225696687, 225696695, 8, 1440x900 
0x37CA2318, 38092262085634984, 225696753, 225696761, 8, 1440x900 
0x37CA2318, 38092262086305408, 225696819, 225696827, 8, 1440x900 
0x37CA2318, 38092262086966816, 225696887, 225696895, 8, 1440x900 
0x37CA2318, 38092262087636232, 225696953, 225696961, 8, 1440x900 
0x37CA2318, 38092262088286104, 225697018, 225697026, 8, 1440x900 
0x37CA2318, 38092262088957304, 225697087, 225697095, 8, 1440x900 
0x37CA2318, 38092262089617824, 225697152, 225697160, 8, 1440x900 
0x37CA2318, 38092262090277376, 225697218, 225697226, 8, 1440x900 
0x37CA2318, 38092262090928640, 225697282, 225697290, 8, 1440x900 
0x37CA2318, 38092262091589448, 225697347, 225697355, 8, 1440x900 
0x37CA2318, 38092262092249640, 225697413, 225697421, 8, 1440x900 
0x37CA2318, 38092262092910488, 225697482, 225697490, 8, 1440x900 
0x37CA2318, 38092262093573488, 225697548, 225697556, 8, 1440x900 
0x37CA2318, 38092262094234320, 225697613, 225697622, 9, 1440x900 
0x37CA2318, 38092262094898152, 225697678, 225697685, 7, 1440x900 
0x37CA2318, 38092262095567784, 225697742, 225697751, 9, 1440x900 
0x37CA2318, 38092262096227192, 225697807, 225697816, 9, 1440x900 
0x37CA2318, 38092262096896720, 225697877, 225697884, 7, 1440x900 
0x37CA2318, 38092262097547792, 225697942, 225697950, 8, 1440x900 
0x37CA2318, 38092262098199072, 225698007, 225698015, 8, 1440x900 
0x37CA2318, 38092262098870592, 225698073, 225698080, 7, 1440x900 
0x37CA2318, 38092262099533944, 225698142, 225698151, 9, 1440x900 
0x37CA2318, 38092262100185152, 225698209, 225698217, 8, 1440x900 
0x37CA2318, 38092262100853560, 225698273, 225698281, 8, 1440x900 
0x37CA2318, 38092262101512280, 225698342, 225698350, 8, 1440x900 
0x37CA2318, 38092262102173848, 225698407, 225698415, 8, 1440x900 
0x37CA2318, 38092262102835440, 225698473, 225698481, 8, 1440x900 
0x37CA2318, 38092262103501544, 225698538, 225698546, 8, 1440x900 
0x37CA2318, 38092262104162760, 225698603, 225698612, 9, 1440x900 
0x37CA2318, 38092262104822944, 225698668, 225698675, 7, 1440x900 
0x37CA2318, 38092262105484048, 225698738, 225698746, 8, 1440x900 
0x37CA2318, 38092262106153504, 225698803, 225698810, 7, 1440x900 
0x37CA2318, 38092262106801952, 225698867, 225698876, 9, 1440x900 
0x37CA2318, 38092262107473264, 225698933, 225698942, 9, 1440x900 
0x37CA2318, 38092262108127128, 225699003, 225699011, 8, 1440x900 
0x37CA2318, 38092262108786584, 225699069, 225699077, 8, 1440x900 
0x37CA2318, 38092262109447928, 225699132, 225699141, 9, 1440x900 
0x37CA2318, 38092262110108536, 225699202, 225699210, 8, 1440x900 
0x37CA2318, 38092262110769192, 225699268, 225699276, 8, 1440x900 
0x37CA2318, 38092262111430016, 225699333, 225699341, 8, 1440x900 
0x37CA2318, 38092262112094712, 225699397, 225699407, 10, 1440x900 
0x37CA2318, 38092262112761808, 225699463, 225699472, 9, 1440x900 
0x37CA2318, 38092262113413792, 225699528, 225699537, 9, 1440x900 
0x37CA2318, 38092262114074264, 225699593, 225699602, 9, 1440x900 
0x37CA2318, 38092262114735080, 225699663, 225699671, 8, 1440x900 
0x37CA2318, 38092262115396096, 225699727, 225699736, 9, 1440x900 
0x37CA2318, 38092262116056904, 225699793, 225699802, 9, 1440x900 
0x37CA2318, 38092262116717624, 225699858, 225699867, 9, 1440x900 
0x37CA2318, 38092262117377568, 225699928, 225699936, 8, 1440x900 
0x37CA2318, 38092262118031104, 225699993, 225700001, 8, 1440x900 
0x37CA2318, 38092262118699160, 225700058, 225700067, 9, 1440x900 
0x37CA2318, 38092262119363904, 225700127, 225700135, 8, 1440x900 
0x37CA2318, 38092262120021976, 225700193, 225700201, 8, 1440x900 
0x37CA2318, 38092262120682888, 225700253, 225700261, 8, 1440x900 
0x37CA2318, 38092262121335440, 225700322, 225700330, 8, 1440x900 
0x37CA2318, 38092262122004848, 225700387, 225700394, 7, 1440x900 
0x37CA2318, 38092262122665664, 225700453, 225700463, 10, 1440x900 
0x37CA2318, 38092262123327696, 225700523, 225700531, 8, 1440x900 
0x37CA2318, 38092262123988912, 225700587, 225700595, 8, 1440x900 
0x37CA2318, 38092262124658144, 225700657, 225700665, 8, 1440x900 
0x37CA2318, 38092262125308544, 225700717, 225700724, 7, 1440x900 
0x37CA2318, 38092262125968280, 225700783, 225700791, 8, 1440x900 
0x37CA2318, 38092262126647600, 225700851, 225700859, 8, 1440x900 
0x37CA2318, 38092262127308304, 225700917, 225700925, 8, 1440x900 
0x37CA2318, 38092262127969120, 225700988, 225700996, 8, 1440x900 
0x37CA2318, 38092262128619880, 225701053, 225701061, 8, 1440x900 
0x37CA2318, 38092262129279808, 225701118, 225701127, 9, 1440x900 
0x37CA2318, 38092262129950656, 225701183, 225701191, 8, 1440x900 
0x37CA2318, 38092262131263952, 225701313, 225701322, 9, 1440x900 
0x37CA2318, 38092262131922648, 225701382, 225701390, 8, 1440x900 
0x37CA2318, 38092262132583520, 225701448, 225701456, 8, 1440x900 
0x37CA2318, 38092262133241304, 225701512, 225701520, 8, 1440x900 
0x37CA2318, 38092262133908560, 225701582, 225701590, 8, 1440x900 
0x37CA2318, 38092262134569056, 225701648, 225701656, 8, 1440x900 
0x37CA2318, 38092262135237624, 225701711, 225701719, 8, 1440x900 
0x37CA2318, 38092262135889592, 225701776, 225701784, 8, 1440x900 
0x37CA2318, 38092262136541144, 225701843, 225701852, 9, 1440x900 
0x37CA2318, 38092262137200920, 225701907, 225701915, 8, 1440x900 
0x37CA2318, 38092262137862744, 225701973, 225701982, 9, 1440x900 
0x37CA2318, 38092262138535160, 225702043, 225702051, 8, 1440x900 
0x37CA2318, 38092262139195776, 225702108, 225702116, 8, 1440x900 
0x37CA2318, 38092262139865784, 225702179, 225702188, 9, 1440x900 
0x37CA2318, 38092262140516224, 225702238, 225702248, 10, 1440x900 
0x37CA2318, 38092262141182824, 225702307, 225702315, 8, 1440x900 
0x37CA2318, 38092262141842776, 225702377, 225702385, 8, 1440x900 
0x37CA2318, 38092262142505024, 225702442, 225702449, 7, 1440x900 
0x37CA2318, 38092262143166136, 225702508, 225702516, 8, 1440x900 
0x37CA2318, 38092262143826304, 225702573, 225702581, 8, 1440x900 
0x37CA2318, 38092262144486968, 225702638, 225702646, 8, 1440x900 
0x37CA2318, 38092262145157000, 225702703, 225702711, 8, 1440x900 
0x37CA2318, 38092262145807576, 225702772, 225702780, 8, 1440x900 
0x37CA2318, 38092262146468704, 225702838, 225702847, 9, 1440x900 
0x37CA2318, 38092262147132416, 225702902, 225702910, 8, 1440x900 
0x37CA2318, 38092262147792472, 225702966, 225702974, 8, 1440x900 
0x37CA2318, 38092262148455536, 225703034, 225703042, 8, 1440x900 
0x37CA2318, 38092262149115336, 225703103, 225703112, 9, 1440x900 
0x37CA2318, 38092262149784112, 225703169, 225703178, 9, 1440x900 
0x37CA2318, 38092262150436192, 225703231, 225703239, 8, 1440x900 
0x37CA2318, 38092262151094680, 225703297, 225703307, 10, 1440x900 
0x37CA2318, 38092262151757472, 225703368, 225703376, 8, 1440x900 
0x37CA2318, 38092262152414632, 225703432, 225703442, 10, 1440x900 
0x37CA2318, 38092262153078400, 225703498, 225703506, 8, 1440x900 
0x37CA2318, 38092262153747456, 225703563, 225703572, 9, 1440x900 
0x37CA2318, 38092262154392136, 225703627, 225703635, 8, 1440x900 
0x37CA2318, 38092262155071304, 225703693, 225703702, 9, 1440x900 
0x37CA2318, 38092262155721520, 225703758, 225703766, 8, 1440x900 
0x37CA2318, 38092262156393128, 225703827, 225703835, 8, 1440x900 
0x37CA2318, 38092262157053784, 225703892, 225703901, 9, 1440x900 
0x37CA2318, 38092262157719544, 225703963, 225703971, 8, 1440x900 
0x37CA2318, 38092262158379280, 225704026, 225704034, 8, 1440x900 
0x37CA2318, 38092262159036408, 225704093, 225704101, 8, 1440x900 
0x37CA2318, 38092262159697616, 225704162, 225704172, 10, 1440x900 
0x37CA2318, 38092262160349320, 225704223, 225704231, 8, 1440x900 
0x37CA2318, 38092262161028640, 225704293, 225704301, 8, 1440x900 
0x37CA2318, 38092262161678208, 225704358, 225704366, 8, 1440x900 
0x37CA2318, 38092262162357728, 225704422, 225704432, 10, 1440x900 
0x37CA2318, 38092262163011128, 225704492, 225704500, 8, 1440x900 
0x37CA2318, 38092262163669432, 225704553, 225704562, 9, 1440x900 
0x37CA2318, 38092262164325832, 225704622, 225704630, 8, 1440x900 
0x37CA2318, 38092262164997400, 225704687, 225704696, 9, 1440x900 
0x37CA2318, 38092262165652064, 225704752, 225704761, 9, 1440x900 
0x37CA2318, 38092262166316160, 225704823, 225704831, 8, 1440x900 
0x37CA2318, 38092262166982424, 225704887, 225704896, 9, 1440x900 
0x37CA2318, 38092262167643744, 225704953, 225704962, 9, 1440x900 
0x37CA2318, 38092262168300640, 225705018, 225705026, 8, 1440x900 
0x37CA2318, 38092262168959240, 225705087, 225705095, 8, 1440x900 
0x37CA2318, 38092262169620312, 225705153, 225705163, 10, 1440x900 
0x37CA2318, 38092262170281272, 225705217, 225705225, 8, 1440x900 
0x37CA2318, 38092262170943880, 225705283, 225705291, 8, 1440x900 
0x37CA2318, 38092262171606432, 225705353, 225705361, 8, 1440x900 
0x37CA2318, 38092262172256680, 225705413, 225705422, 9, 1440x900 
0x37CA2318, 38092262172927096, 225705482, 225705490, 8, 1440x900 
0x37CA2318, 38092262173590288, 225705548, 225705557, 9, 1440x900 
0x37CA2318, 38092262174246680, 225705612, 225705620, 8, 1440x900 
0x37CA2318, 38092262174907112, 225705677, 225705686, 9, 1440x900 
0x37CA2318, 38092262175576352, 225705748, 225705757, 9, 1440x900 
0x37CA2318, 38092262176227032, 225705807, 225705815, 8, 1440x900 
0x37CA2318, 38092262176888184, 225705878, 225705887, 9, 1440x900 
0x37CA2318, 38092262177557896, 225705947, 225705955, 8, 1440x900 
0x37CA2318, 38092262178213872, 225706012, 225706020, 8, 1440x900 
0x37CA2318, 38092262178872424, 225706074, 225706083, 9, 1440x900 
0x37CA2318, 38092262179528112, 225706138, 225706146, 8, 1440x900 
0x37CA2318, 38092262180183344, 225706203, 225706211, 8, 1440x900 
0x37CA2318, 38092262180846672, 225706272, 225706280, 8, 1440x900 
0x37CA2318, 38092262181524416, 225706341, 225706349, 8, 1440x900 
0x37CA2318, 38092262181978400, 225706383, 225706392, 9, 1440x900 
0x37CA2318, 38092262182652640, 225706452, 225706460, 8, 1440x900 
0x37CA2318, 38092262183305120, 225706518, 225706526, 8, 1440x900 
0x37CA2318, 38092262183969632, 225706588, 225706596, 8, 1440x900 
0x37CA2318, 38092262184634168, 225706657, 225706665, 8, 1440x900 
0x37CA2318, 38092262185281352, 225706719, 225706727, 8, 1440x900 
0x37CA2318, 38092262185953104, 225706783, 225706791, 8, 1440x900 
0x37CA2318, 38092262186611776, 225706848, 225706856, 8, 1440x900 
0x37CA2318, 38092262187928552, 225706978, 225706986, 8, 1440x900 
0x37CA2318, 38092262188586536, 225707047, 225707055, 8, 1440x900 
0x37CA2318, 38092262189247688, 225707112, 225707120, 8, 1440x900 
0x37CA2318, 38092262189911464, 225707178, 225707187, 9, 1440x900 
0x37CA2318, 38092262190572696, 225707247, 225707256, 9, 1440x900 
0x37CA2318, 38092262191237624, 225707313, 225707321, 8, 1440x900 
0x37CA2318, 38092262191895832, 225707378, 225707387, 9, 1440x900 
0x37CA2318, 38092262192556768, 225707443, 225707450, 7, 1440x900 
0x37CA2318, 38092262193242472, 225707512, 225707520, 8, 1440x900 
0x37CA2318, 38092262193867256, 225707573, 225707580, 7, 1440x900 
0x37CA2318, 38092262194528128, 225707638, 225707646, 8, 1440x900 
0x37CA2318, 38092262195374760, 225707729, 225707738, 9, 1440x900 
0x37CA2318, 38092262195850200, 225707773, 225707783, 10, 1440x900 
0x37CA2318, 38092262196510120, 225707837, 225707846, 9, 1440x900 
0x37CA2318, 38092262197180096, 225707905, 225707914, 9, 1440x900 
0x37CA2318, 38092262197849064, 225707973, 225707982, 9, 1440x900 
0x37CA2318, 38092262198531048, 225708044, 225708051, 7, 1440x900 
0x37CA2318, 38092262199157600, 225708103, 225708111, 8, 1440x900 
0x37CA2318, 38092262199826576, 225708169, 225708178, 9, 1440x900 
0x37CA2318, 38092262200503624, 225708236, 225708251, 15, 1440x900 
0x37CA2318, 38092262201292104, 225708313, 225708322, 9, 1440x900 
0x37CA2318, 38092262201819904, 225708367, 225708376, 9, 1440x900 
0x37CA2318, 38092262202473664, 225708432, 225708451, 19, 1440x900 
0x37CA2318, 38092262203170864, 225708503, 225708511, 8, 1440x900 
0x37CA2318, 38092262203793944, 225708567, 225708575, 8, 1440x900 
0x37CA2318, 38092262204649776, 225708652, 225708660, 8, 1440x900 
0x37CA2318, 38092262205320336, 225708718, 225708726, 8, 1440x900 
0x37CA2318, 38092262205978016, 225708789, 225708797, 8, 1440x900 
0x37CA2318, 38092262206629752, 225708848, 225708856, 8, 1440x900 
0x37CA2318, 38092262207206168, 225708907, 225708916, 9, 1440x900 
0x37CA2318, 38092262207765136, 225708962, 225708970, 8, 1440x900 
0x37CA2318, 38092262208421680, 225709029, 225709036, 7, 1440x900 
0x37CA2318, 38092262209084272, 225709098, 225709106, 8, 1440x900 
0x37CA2318, 38092262209743616, 225709163, 225709175, 12, 1440x900 
0x37CA2318, 38092262210400976, 225709227, 225709234, 7, 1440x900 
0x37CA2318, 38092262211065768, 225709294, 225709303, 9, 1440x900 
0x37CA2318, 38092262211730968, 225709357, 225709368, 11, 1440x900 
0x37CA2318, 38092262212388512, 225709423, 225709434, 11, 1440x900 
0x37CA2318, 38092262213242504, 225709508, 225709516, 8, 1440x900 
0x37CA2318, 38092262213912432, 225709582, 225709591, 9, 1440x900 
0x37CA2318, 38092262214572824, 225709643, 225709651, 8, 1440x900 
0x37CA2318, 38092262215236512, 225709712, 225709719, 7, 1440x900 
0x37CA2318, 38092262215892824, 225709772, 225709781, 9, 1440x900 
0x37CA2318, 38092262216372880, 225709822, 225709830, 8, 1440x900 
0x37CA2318, 38092262217211120, 225709908, 225709917, 9, 1440x900 
0x37CA2318, 38092262217878480, 225709973, 225709981, 8, 1440x900 
0x37CA2318, 38092262218539392, 225710042, 225710050, 8, 1440x900 
0x37CA2318, 38092262219198936, 225710108, 225710115, 7, 1440x900 
0x37CA2318, 38092262219859568, 225710174, 225710182, 8, 1440x900 
0x37CA2318, 38092262220520664, 225710238, 225710247, 9, 1440x900 
0x37CA2318, 38092262221178520, 225710308, 225710316, 8, 1440x900 
0x37CA2318, 38092262221849912, 225710377, 225710385, 8, 1440x900 
0x37CA2318, 38092262222503296, 225710437, 225710446, 9, 1440x900 
0x37CA2318, 38092262223165176, 225710508, 225710516, 8, 1440x900 
0x37CA2318, 38092262223826744, 225710573, 225710582, 9, 1440x900 
0x37CA2318, 38092262224506280, 225710643, 225710651, 8, 1440x900 
0x37CA2318, 38092262225165264, 225710709, 225710717, 8, 1440x900 
0x37CA2318, 38092262225818104, 225710768, 225710776, 8, 1440x900 
0x37CA2318, 38092262226483080, 225710833, 225710842, 9, 1440x900 
0x37CA2318, 38092262227134712, 225710904, 225710912, 8, 1440x900 
0x37CA2318, 38092262227804280, 225710968, 225710976, 8, 1440x900 
0x37CA2318, 38092262228753112, 225711061, 225711079, 18, 1440x900 
0x37CA2318, 38092262228949816, 225711082, 225711093, 11, 1440x900 
0x37CA2318, 38092262229588416, 225711148, 225711161, 13, 1440x900 
0x37CA2318, 38092262230253264, 225711209, 225711218, 9, 1440x900 
0x37CA2318, 38092262231108168, 225711297, 225711304, 7, 1440x900 
0x37CA2318, 38092262231767872, 225711364, 225711373, 9, 1440x900 
0x37CA2318, 38092262232435512, 225711438, 225711446, 8, 1440x900 
0x37CA2318, 38092262233096416, 225711498, 225711506, 8, 1440x900 
0x37CA2318, 38092262233767224, 225711568, 225711576, 8, 1440x900 
0x37CA2318, 38092262234426880, 225711639, 225711650, 11, 1440x900 
0x37CA2318, 38092262235085192, 225711694, 225711702, 8, 1440x900 
0x37CA2318, 38092262235746480, 225711764, 225711771, 7, 1440x900 
0x37CA2318, 38092262236415288, 225711828, 225711839, 11, 1440x900 
0x37CA2318, 38092262237074576, 225711892, 225711901, 9, 1440x900 
0x37CA2318, 38092262237744864, 225711962, 225711969, 7, 1440x900 
0x37CA2318, 38092262238385936, 225712023, 225712032, 9, 1440x900 
0x37CA2318, 38092262239058496, 225712092, 225712099, 7, 1440x900 
0x37CA2318, 38092262239854016, 225712173, 225712185, 12, 1440x900 
0x37CA2318, 38092262240202528, 225712207, 225712214, 7, 1440x900 
0x37CA2318, 38092262241151536, 225712301, 225712329, 28, 1440x900 
0x37CA2318, 38092262241740176, 225712362, 225712369, 7, 1440x900 
0x37CA2318, 38092262242402808, 225712427, 225712435, 8, 1440x900 
0x37CA2318, 38092262243059688, 225712492, 225712500, 8, 1440x900 
0x37CA2318, 38092262243718784, 225712557, 225712564, 7, 1440x900 
0x37CA2318, 38092262244388840, 225712628, 225712635, 7, 1440x900 
0x37CA2318, 38092262245193664, 225712723, 225712742, 19, 1440x900 
0x37CA2318, 38092262245800768, 225712770, 225712779, 9, 1440x900 
0x37CA2318, 38092262246364200, 225712822, 225712830, 8, 1440x900 
0x37CA2318, 38092262247025928, 225712888, 225712895, 7, 1440x900 
0x37CA2318, 38092262247883464, 225712973, 225712981, 8, 1440x900 
0x37CA2318, 38092262248544224, 225713039, 225713047, 8, 1440x900 
0x37CA2318, 38092262249203920, 225713107, 225713114, 7, 1440x900 
0x37CA2318, 38092262249857472, 225713172, 225713180, 8, 1440x900 
0x37CA2318, 38092262250529120, 225713238, 225713246, 8, 1440x900 
0x37CA2318, 38092262251184568, 225713307, 225713315, 8, 1440x900 
0x37CA2318, 38092262251846088, 225713372, 225713380, 8, 1440x900 
0x37CA2318, 38092262252514064, 225713438, 225713445, 7, 1440x900 
0x37CA2318, 38092262253164784, 225713503, 225713512, 9, 1440x900 
0x37CA2318, 38092262253828296, 225713568, 225713576, 8, 1440x900 
0x37CA2318, 38092262254488528, 225713639, 225713678, 39, 1440x900 
0x37CA2318, 38092262255062656, 225713700, 225713711, 11, 1440x900 
0x37CA2318, 38092262255613152, 225713755, 225713768, 13, 1440x900 
0x37CA2318, 38092262256280160, 225713817, 225713830, 13, 1440x900 
0x37CA2318, 38092262257586904, 225713966, 225713984, 18, 1440x900 
0x37CA2318, 38092262258081504, 225713998, 225714007, 9, 1440x900 
0x37CA2318, 38092262258774992, 225714084, 225714093, 9, 1440x900 
0x37CA2318, 38092262259430912, 225714131, 225714139, 8, 1440x900 
0x37CA2318, 38092262260286016, 225714217, 225714224, 7, 1440x900 
0x37CA2318, 38092262260944104, 225714279, 225714287, 8, 1440x900 
0x37CA2318, 38092262261607752, 225714347, 225714354, 7, 1440x900 
0x37CA2318, 38092262262270200, 225714412, 225714420, 8, 1440x900 
0x37CA2318, 38092262262930584, 225714478, 225714486, 8, 1440x900 
0x37CA2318, 38092262263590368, 225714543, 225714551, 8, 1440x900 
0x37CA2318, 38092262264243152, 225714608, 225714616, 8, 1440x900 
0x37CA2318, 38092262264713112, 225714657, 225714664, 7, 1440x900 
0x37CA2318, 38092262265374960, 225714722, 225714731, 9, 1440x900 
0x37CA2318, 38092262266037360, 225714797, 225714805, 8, 1440x900 
0x37CA2318, 38092262266706200, 225714857, 225714865, 8, 1440x900 
0x37CA2318, 38092262267364040, 225714928, 225714937, 9, 1440x900 
0x37CA2318, 38092262268015872, 225714987, 225714995, 8, 1440x900 
0x37CA2318, 38092262268679104, 225715056, 225715064, 8, 1440x900 
0x37CA2318, 38092262269338912, 225715122, 225715130, 8, 1440x900 
0x37CA2318, 38092262270000232, 225715191, 225715199, 8, 1440x900 
0x37CA2318, 38092262270660080, 225715253, 225715260, 7, 1440x900 
0x37CA2318, 38092262271319720, 225715317, 225715327, 10, 1440x900 
0x37CA2318, 38092262272022672, 225715387, 225715395, 8, 1440x900 
0x37CA2318, 38092262272648544, 225715451, 225715459, 8, 1440x900 
0x37CA2318, 38092262273312408, 225715518, 225715528, 10, 1440x900 
0x37CA2318, 38092262274007976, 225715587, 225715595, 8, 1440x900 
0x37CA2318, 38092262274976720, 225715692, 225715702, 10, 1440x900 
0x37CA2318, 38092262275311088, 225715715, 225715737, 22, 1440x900 
0x37CA2318, 38092262275999024, 225715787, 225715793, 6, 1440x900 
0x37CA2318, 38092262276624704, 225715847, 225715854, 7, 1440x900 
0x37CA2318, 38092262277281232, 225715913, 225715920, 7, 1440x900 
0x37CA2318, 38092262277941904, 225715982, 225715989, 7, 1440x900 
0x37CA2318, 38092262278602520, 225716046, 225716053, 7, 1440x900 
0x37CA2318, 38092262279265352, 225716112, 225716120, 8, 1440x900 
0x37CA2318, 38092262279925720, 225716177, 225716185, 8, 1440x900 
0x37CA2318, 38092262280648128, 225716251, 225716259, 8, 1440x900 
0x37CA2318, 38092262281246536, 225716312, 225716319, 7, 1440x900 
0x37CA2318, 38092262281911592, 225716377, 225716384, 7, 1440x900 
0x37CA2318, 38092262283127600, 225716519, 225716529, 10, 1440x900 
0x37CA2318, 38092262283424184, 225716531, 225716543, 12, 1440x900 
0x37CA2318, 38092262284018720, 225716592, 225716599, 7, 1440x900 
0x37CA2318, 38092262284668440, 225716652, 225716660, 8, 1440x900 
0x37CA2318, 38092262285328728, 225716718, 225716725, 7, 1440x900 
0x37CA2318, 38092262285988288, 225716783, 225716791, 8, 1440x900 
0x37CA2318, 38092262286645112, 225716848, 225716856, 8, 1440x900 
0x37CA2318, 38092262287316520, 225716921, 225716930, 9, 1440x900 
0x37CA2318, 38092262288101784, 225717008, 225717018, 10, 1440x900 
0x37CA2318, 38092262288722704, 225717057, 225717067, 10, 1440x900 
0x37CA2318, 38092262289503216, 225717137, 225717147, 10, 1440x900 
0x37CA2318, 38092262289962272, 225717188, 225717200, 12, 1440x900 
0x37CA2318, 38092262290662288, 225717250, 225717260, 10, 1440x900 
0x37CA2318, 38092262291297776, 225717318, 225717327, 9, 1440x900 
0x37CA2318, 38092262293933472, 225717579, 225717588, 9, 1440x900 
0x37CA2318, 38092262294600144, 225717647, 225717655, 8, 1440x900 
0x37CA2318, 38092262295273584, 225717716, 225717724, 8, 1440x900 
0x37CA2318, 38092262295920552, 225717778, 225717786, 8, 1440x900 
0x37CA2318, 38092262296586064, 225717846, 225717854, 8, 1440x900 
0x37CA2318, 38092262297251824, 225717913, 225717921, 8, 1440x900 
0x37CA2318, 38092262297912696, 225717978, 225717988, 10, 1440x900 
0x37CA2318, 38092262298571576, 225718044, 225718053, 9, 1440x900 
0x37CA2318, 38092262299245560, 225718113, 225718120, 7, 1440x900 
0x37CA2318, 38092262300061456, 225718193, 225718201, 8, 1440x900 
0x37CA2318, 38092262300869248, 225718279, 225718326, 47, 1440x900 
0x37CA2318, 38092262301503984, 225718342, 225718350, 8, 1440x900 
0x37CA2318, 38092262302103928, 225718398, 225718407, 9, 1440x900 
0x37CA2318, 38092262302762456, 225718462, 225718469, 7, 1440x900 
0x37CA2318, 38092262303418872, 225718528, 225718535, 7, 1440x900 
0x37CA2318, 38092262304078976, 225718593, 225718601, 8, 1440x900 
0x37CA2318, 38092262304743824, 225718662, 225718670, 8, 1440x900 
0x37CA2318, 38092262305400192, 225718726, 225718734, 8, 1440x900 
0x37CA2318, 38092262306069456, 225718793, 225718800, 7, 1440x900 
0x37CA2318, 38092262306759576, 225718862, 225718869, 7, 1440x900 
0x37CA2318, 38092262307506912, 225718963, 225718977, 14, 1440x900 
0x37CA2318, 38092262308124120, 225719002, 225719010, 8, 1440x900 
0x37CA2318, 38092262308790048, 225719069, 225719104, 35, 1440x900 
0x37CA2318, 38092262309415080, 225719129, 225719137, 8, 1440x900 
0x37CA2318, 38092262310069728, 225719194, 225719204, 10, 1440x900 
0x37CA2318, 38092262310735264, 225719257, 225719266, 9, 1440x900 
0x37CA2318, 38092262311391120, 225719327, 225719334, 7, 1440x900 
0x37CA2318, 38092262312046904, 225719388, 225719396, 8, 1440x900 
0x37CA2318, 38092262312708336, 225719457, 225719463, 6, 1440x900 
0x37CA2318, 38092262313373488, 225719523, 225719531, 8, 1440x900 
0x37CA2318, 38092262314035816, 225719588, 225719597, 9, 1440x900 
0x37CA2318, 38092262314702144, 225719658, 225719666, 8, 1440x900 
0x37CA2318, 38092262315372968, 225719722, 225719730, 8, 1440x900 
0x37CA2318, 38092262316023776, 225719789, 225719796, 7, 1440x900 
0x37CA2318, 38092262316685400, 225719853, 225719862, 9, 1440x900 
0x37CA2318, 38092262317342528, 225719922, 225719930, 8, 1440x900 
0x37CA2318, 38092262318004328, 225719987, 225719995, 8, 1440x900 
0x37CA2318, 38092262318671968, 225720054, 225720062, 8, 1440x900 
0x37CA2318, 38092262319339216, 225720118, 225720129, 11, 1440x900 
0x37CA2318, 38092262320002560, 225720187, 225720195, 8, 1440x900 
0x37CA2318, 38092262320662640, 225720252, 225720260, 8, 1440x900 
0x37CA2318, 38092262321520288, 225720343, 225720352, 9, 1440x900 
0x37CA2318, 38092262322180328, 225720408, 225720416, 8, 1440x900 
0x37CA2318, 38092262322805752, 225720467, 225720475, 8, 1440x900 
0x37CA2318, 38092262323295864, 225720516, 225720524, 8, 1440x900 
0x37CA2318, 38092262323959568, 225720582, 225720590, 8, 1440x900 
0x37CA2318, 38092262324615960, 225720649, 225720656, 7, 1440x900 
0x37CA2318, 38092262325275968, 225720713, 225720721, 8, 1440x900 
0x37CA2318, 38092262325936296, 225720777, 225720785, 8, 1440x900 
0x37CA2318, 38092262326595928, 225720847, 225720854, 7, 1440x900 
0x37CA2318, 38092262327261776, 225720912, 225720919, 7, 1440x900 
0x37CA2318, 38092262327916088, 225720977, 225720985, 8, 1440x900 
0x37CA2318, 38092262328579176, 225721042, 225721050, 8, 1440x900 
0x37CA2318, 38092262329236160, 225721108, 225721116, 8, 1440x900 
0x37CA2318, 38092262329903944, 225721178, 225721186, 8, 1440x900 
0x37CA2318, 38092262330764496, 225721263, 225721271, 8, 1440x900 
0x37CA2318, 38092262331431304, 225721333, 225721344, 11, 1440x900 
0x37CA2318, 38092262331940048, 225721382, 225721393, 11, 1440x900 
0x37CA2318, 38092262332648968, 225721452, 225721459, 7, 1440x900 
0x37CA2318, 38092262333352696, 225721522, 225721529, 7, 1440x900 
0x37CA2318, 38092262333893144, 225721577, 225721584, 7, 1440x900 
0x37CA2318, 38092262334550400, 225721642, 225721650, 8, 1440x900 
0x37CA2318, 38092262335206824, 225721708, 225721714, 6, 1440x900 
0x37CA2318, 38092262335867688, 225721772, 225721782, 10, 1440x900 
0x37CA2318, 38092262336538016, 225721839, 225721847, 8, 1440x900 
0x37CA2318, 38092262337210456, 225721913, 225721922, 9, 1440x900 
0x37CA2318, 38092262337872192, 225721978, 225721986, 8, 1440x900 
0x37CA2318, 38092262338521112, 225722042, 225722050, 8, 1440x900 
0x37CA2318, 38092262339181320, 225722107, 225722115, 8, 1440x900 
0x37CA2318, 38092262339839680, 225722172, 225722179, 7, 1440x900 
0x37CA2318, 38092262340501520, 225722238, 225722246, 8, 1440x900 
0x37CA2318, 38092262341167632, 225722302, 225722310, 8, 1440x900 
0x37CA2318, 38092262341828032, 225722368, 225722376, 8, 1440x900 
0x37CA2318, 38092262342492064, 225722436, 225722444, 8, 1440x900 
0x37CA2318, 38092262343151328, 225722503, 225722510, 7, 1440x900 
0x37CA2318, 38092262343815616, 225722568, 225722576, 8, 1440x900 
0x37CA2318, 38092262344476104, 225722632, 225722640, 8, 1440x900 
0x37CA2318, 38092262345137624, 225722702, 225722711, 9, 1440x900 
0x37CA2318, 38092262345800216, 225722766, 225722774, 8, 1440x900 
0x37CA2318, 38092262347119336, 225722899, 225722908, 9, 1440x900 
0x37CA2318, 38092262347775888, 225722963, 225722971, 8, 1440x900 
0x37CA2318, 38092262348436200, 225723032, 225723040, 8, 1440x900 
0x37CA2318, 38092262349107568, 225723097, 225723106, 9, 1440x900 
0x37CA2318, 38092262349759160, 225723167, 225723175, 8, 1440x900 
0x37CA2318, 38092262350607400, 225723253, 225723261, 8, 1440x900 
0x37CA2318, 38092262351269344, 225723317, 225723325, 8, 1440x900 
0x37CA2318, 38092262351737296, 225723358, 225723367, 9, 1440x900 
0x37CA2318, 38092262352436864, 225723428, 225723437, 9, 1440x900 
0x37CA2318, 38092262353254960, 225723513, 225723522, 9, 1440x900 
0x37CA2318, 38092262353855048, 225723577, 225723585, 8, 1440x900 
0x37CA2318, 38092262354380248, 225723627, 225723635, 8, 1440x900 
0x37CA2318, 38092262355042712, 225723697, 225723706, 9, 1440x900 
0x37CA2318, 38092262355890728, 225723773, 225723781, 8, 1440x900 
0x37CA2318, 38092262356357472, 225723822, 225723830, 8, 1440x900 
0x37CA2318, 38092262357017680, 225723887, 225723895, 8, 1440x900 
0x37CA2318, 38092262357677656, 225723953, 225723961, 8, 1440x900 
0x37CA2318, 38092262358348736, 225724023, 225724032, 9, 1440x900 
0x37CA2318, 38092262359009784, 225724088, 225724097, 9, 1440x900 
0x37CA2318, 38092262359674960, 225724157, 225724165, 8, 1440x900 
0x37CA2318, 38092262360327096, 225724217, 225724225, 8, 1440x900 
0x37CA2318, 38092262360986592, 225724283, 225724291, 8, 1440x900 
0x37CA2318, 38092262361845880, 225724372, 225724380, 8, 1440x900 
0x37CA2318, 38092262362306696, 225724417, 225724424, 7, 1440x900 
0x37CA2318, 38092262363160216, 225724507, 225724515, 8, 1440x900 
0x37CA2318, 38092262363840808, 225724572, 225724580, 8, 1440x900 
0x37CA2318, 38092262364499936, 225724642, 225724650, 8, 1440x900 
0x37CA2318, 38092262365150336, 225724703, 225724712, 9, 1440x900 
0x37CA2318, 38092262365776400, 225724767, 225724776, 9, 1440x900 
0x37CA2318, 38092262366284872, 225724818, 225724825, 7, 1440x900 
0x37CA2318, 38092262366947728, 225724887, 225724896, 9, 1440x900 
0x37CA2318, 38092262367607488, 225724948, 225724956, 8, 1440x900 
0x37CA2318, 38092262368457600, 225725038, 225725047, 9, 1440x900 
0x37CA2318, 38092262369117608, 225725098, 225725107, 9, 1440x900 
0x37CA2318, 38092262369781472, 225725168, 225725176, 8, 1440x900 
0x37CA2318, 38092262370454064, 225725233, 225725241, 8, 1440x900 
0x37CA2318, 38092262371105224, 225725299, 225725308, 9, 1440x900 
0x37CA2318, 38092262371770768, 225725368, 225725376, 8, 1440x900 
0x37CA2318, 38092262372435656, 225725432, 225725441, 9, 1440x900 
0x37CA2318, 38092262373095856, 225725497, 225725506, 9, 1440x900 
0x37CA2318, 38092262373748624, 225725567, 225725576, 9, 1440x900 
0x37CA2318, 38092262374410240, 225725628, 225725637, 9, 1440x900 
0x37CA2318, 38092262375081640, 225725698, 225725706, 8, 1440x900 
0x37CA2318, 38092262375744424, 225725769, 225725777, 8, 1440x900 
0x37CA2318, 38092262376220576, 225725812, 225725821, 9, 1440x900 
0x37CA2318, 38092262377060176, 225725893, 225725900, 7, 1440x900 
0x37CA2318, 38092262377713144, 225725957, 225725965, 8, 1440x900 
0x37CA2318, 38092262378382552, 225726022, 225726030, 8, 1440x900 
0x37CA2318, 38092262378851320, 225726072, 225726082, 10, 1440x900 
0x37CA2318, 38092262379511184, 225726137, 225726145, 8, 1440x900 
0x37CA2318, 38092262380169720, 225726203, 225726211, 8, 1440x900 
0x37CA2318, 38092262380832304, 225726268, 225726276, 8, 1440x900 
0x37CA2318, 38092262381686032, 225726357, 225726366, 9, 1440x900 
0x37CA2318, 38092262382196272, 225726409, 225726417, 8, 1440x900 
0x37CA2318, 38092262382808840, 225726467, 225726475, 8, 1440x900 
0x37CA2318, 38092262383474448, 225726533, 225726541, 8, 1440x900 
0x37CA2318, 38092262384132896, 225726598, 225726607, 9, 1440x900 
0x37CA2318, 38092262384793112, 225726666, 225726673, 7, 1440x900 
0x37CA2318, 38092262385454680, 225726733, 225726741, 8, 1440x900 
0x37CA2318, 38092262386121192, 225726802, 225726810, 8, 1440x900 
0x37CA2318, 38092262386780176, 225726868, 225726876, 8, 1440x900 
0x37CA2318, 38092262387638656, 225726952, 225726960, 8, 1440x900 
0x37CA2318, 38092262388091176, 225726993, 225727001, 8, 1440x900 
0x37CA2318, 38092262388951216, 225727082, 225727090, 8, 1440x900 
0x37CA2318, 38092262389417696, 225727127, 225727136, 9, 1440x900 
0x37CA2318, 38092262390074920, 225727193, 225727201, 8, 1440x900 
0x37CA2318, 38092262390733936, 225727262, 225727270, 8, 1440x900 
0x37CA2318, 38092262391397096, 225727327, 225727334, 7, 1440x900 
0x37CA2318, 38092262392063488, 225727393, 225727403, 10, 1440x900 
0x37CA2318, 38092262392724808, 225727458, 225727466, 8, 1440x900 
0x37CA2318, 38092262393384088, 225727527, 225727536, 9, 1440x900 
0x37CA2318, 38092262394044624, 225727593, 225727608, 15, 1440x900 
0x37CA2318, 38092262394699576, 225727657, 225727665, 8, 1440x900 
0x37CA2318, 38092262395361184, 225727722, 225727730, 8, 1440x900 
0x37CA2318, 38092262396026752, 225727793, 225727802, 9, 1440x900 
0x37CA2318, 38092262396676352, 225727853, 225727861, 8, 1440x900 
0x37CA2318, 38092262397336704, 225727918, 225727927, 9, 1440x900 
0x37CA2318, 38092262397995312, 225727983, 225727991, 8, 1440x900 
0x37CA2318, 38092262399004672, 225728086, 225728095, 9, 1440x900 
0x37CA2318, 38092262399409200, 225728127, 225728144, 17, 1440x900 
0x37CA2318, 38092262400014576, 225728188, 225728198, 10, 1440x900 
0x37CA2318, 38092262400644720, 225728248, 225728255, 7, 1440x900 
0x37CA2318, 38092262401386328, 225728323, 225728332, 9, 1440x900 
0x37CA2318, 38092262402035088, 225728392, 225728402, 10, 1440x900 
0x37CA2318, 38092262402690512, 225728453, 225728464, 11, 1440x900 
0x37CA2318, 38092262403350712, 225728522, 225728528, 6, 1440x900 
0x37CA2318, 38092262403976984, 225728583, 225728590, 7, 1440x900 
0x37CA2318, 38092262404636904, 225728648, 225728655, 7, 1440x900 
0x37CA2318, 38092262405307680, 225728717, 225728724, 7, 1440x900 
0x37CA2318, 38092262405964384, 225728782, 225728789, 7, 1440x900 
0x37CA2318, 38092262406624208, 225728848, 225728855, 7, 1440x900 
0x37CA2318, 38092262407288032, 225728913, 225728921, 8, 1440x900 
0x37CA2318, 38092262407948392, 225728978, 225728986, 8, 1440x900 
0x37CA2318, 38092262408811288, 225729067, 225729073, 6, 1440x900 
0x37CA2318, 38092262409937984, 225729178, 225729186, 8, 1440x900 
0x37CA2318, 38092262410598704, 225729247, 225729254, 7, 1440x900 
0x37CA2318, 38092262411255888, 225729309, 225729317, 8, 1440x900 
0x37CA2318, 38092262411915952, 225729377, 225729384, 7, 1440x900 
0x37CA2318, 38092262412585792, 225729443, 225729451, 8, 1440x900 
0x37CA2318, 38092262413249000, 225729511, 225729518, 7, 1440x900 
0x37CA2318, 38092262413904904, 225729577, 225729584, 7, 1440x900 
0x37CA2318, 38092262414566416, 225729642, 225729650, 8, 1440x900 
0x37CA2318, 38092262415229944, 225729712, 225729719, 7, 1440x900 
0x37CA2318, 38092262415884896, 225729773, 225729781, 8, 1440x900 
0x37CA2318, 38092262416545048, 225729842, 225729849, 7, 1440x900 
0x37CA2318, 38092262417212360, 225729907, 225729915, 8, 1440x900 
0x37CA2318, 38092262417882368, 225729972, 225729980, 8, 1440x900 
0x37CA2318, 38092262418532528, 225730038, 225730046, 8, 1440x900 
0x37CA2318, 38092262419195024, 225730107, 225730115, 8, 1440x900 
0x37CA2318, 38092262419864120, 225730177, 225730185, 8, 1440x900 
0x37CA2318, 38092262420649536, 225730252, 225730260, 8, 1440x900 
0x37CA2318, 38092262421363184, 225730322, 225730330, 8, 1440x900 
0x37CA2318, 38092262421835840, 225730373, 225730381, 8, 1440x900 
0x37CA2318, 38092262422502640, 225730442, 225730450, 8, 1440x900 
0x37CA2318, 38092262423157392, 225730507, 225730515, 8, 1440x900 
0x37CA2318, 38092262423819648, 225730572, 225730580, 8, 1440x900 
0x37CA2318, 38092262424481440, 225730639, 225730647, 8, 1440x900 
0x37CA2318, 38092262425150128, 225730707, 225730715, 8, 1440x900 
0x37CA2318, 38092262425819288, 225730773, 225730781, 8, 1440x900 
0x37CA2318, 38092262426469192, 225730838, 225730846, 8, 1440x900 
0x37CA2318, 38092262427318048, 225730922, 225730930, 8, 1440x900 
0x37CA2318, 38092262427796176, 225730968, 225730976, 8, 1440x900 
0x37CA2318, 38092262428445576, 225731033, 225731041, 8, 1440x900 
0x37CA2318, 38092262429106480, 225731103, 225731111, 8, 1440x900 
0x37CA2318, 38092262429770632, 225731163, 225731171, 8, 1440x900 
0x37CA2318, 38092262430436216, 225731228, 225731236, 8, 1440x900 
0x37CA2318, 38092262431092800, 225731297, 225731305, 8, 1440x900 
0x37CA2318, 38092262431752752, 225731362, 225731369, 7, 1440x900 
0x37CA2318, 38092262432417920, 225731427, 225731435, 8, 1440x900 
0x37CA2318, 38092262433072840, 225731492, 225731500, 8, 1440x900 
0x37CA2318, 38092262433735488, 225731562, 225731570, 8, 1440x900 
0x37CA2318, 38092262434396744, 225731632, 225731640, 8, 1440x900 
0x37CA2318, 38092262435062608, 225731693, 225731701, 8, 1440x900 
0x37CA2318, 38092262435921552, 225731778, 225731786, 8, 1440x900 
0x37CA2318, 38092262436376984, 225731823, 225731830, 7, 1440x900 
0x37CA2318, 38092262437038176, 225731887, 225731895, 8, 1440x900 
0x37CA2318, 38092262437700304, 225731957, 225731964, 7, 1440x900 
0x37CA2318, 38092262438358024, 225732022, 225732028, 6, 1440x900 
0x37CA2318, 38092262439216808, 225732108, 225732116, 8, 1440x900 
0x37CA2318, 38092262439679344, 225732159, 225732166, 7, 1440x900 
0x37CA2318, 38092262440345696, 225732223, 225732230, 7, 1440x900 
0x37CA2318, 38092262441050864, 225732293, 225732300, 7, 1440x900 
0x37CA2318, 38092262441661168, 225732353, 225732362, 9, 1440x900 
0x37CA2318, 38092262442327336, 225732423, 225732430, 7, 1440x900 
0x37CA2318, 38092262442986224, 225732487, 225732495, 8, 1440x900 
0x37CA2318, 38092262443646496, 225732553, 225732561, 8, 1440x900 
0x37CA2318, 38092262444509256, 225732642, 225732650, 8, 1440x900 
0x37CA2318, 38092262444982016, 225732687, 225732695, 8, 1440x900 
0x37CA2318, 38092262445635096, 225732753, 225732761, 8, 1440x900 
0x37CA2318, 38092262446296216, 225732818, 225732826, 8, 1440x900 
0x37CA2318, 38092262447163544, 225732908, 225732916, 8, 1440x900 
0x37CA2318, 38092262447626440, 225732952, 225732960, 8, 1440x900 
0x37CA2318, 38092262448286776, 225733018, 225733026, 8, 1440x900 
0x37CA2318, 38092262448954080, 225733082, 225733091, 9, 1440x900 
0x37CA2318, 38092262449606664, 225733153, 225733161, 8, 1440x900 
0x37CA2318, 38092262450273136, 225733214, 225733221, 7, 1440x900 
0x37CA2318, 38092262451128160, 225733303, 225733311, 8, 1440x900 
0x37CA2318, 38092262451794960, 225733368, 225733376, 8, 1440x900 
0x37CA2318, 38092262452391272, 225733428, 225733437, 9, 1440x900 
0x37CA2318, 38092262453105128, 225733502, 225733510, 8, 1440x900 
0x37CA2318, 38092262453766128, 225733563, 225733572, 9, 1440x900 
0x37CA2318, 38092262454428448, 225733632, 225733640, 8, 1440x900 
0x37CA2318, 38092262454898280, 225733678, 225733686, 8, 1440x900 
0x37CA2318, 38092262455750752, 225733762, 225733771, 9, 1440x900 
0x37CA2318, 38092262456213456, 225733808, 225733817, 9, 1440x900 
0x37CA2318, 38092262456874152, 225733878, 225733886, 8, 1440x900 
0x37CA2318, 38092262457539752, 225733943, 225733952, 9, 1440x900 
0x37CA2318, 38092262458208720, 225734013, 225734021, 8, 1440x900 
0x37CA2318, 38092262458869992, 225734078, 225734087, 9, 1440x900 
0x37CA2318, 38092262459544272, 225734144, 225734152, 8, 1440x900 
0x37CA2318, 38092262460197208, 225734208, 225734216, 8, 1440x900 
0x37CA2318, 38092262460839248, 225734268, 225734276, 8, 1440x900 
0x37CA2318, 38092262461499384, 225734336, 225734343, 7, 1440x900 
0x37CA2318, 38092262462163968, 225734408, 225734416, 8, 1440x900 
0x37CA2318, 38092262462831952, 225734474, 225734482, 8, 1440x900 
0x37CA2318, 38092262463679400, 225734558, 225734566, 8, 1440x900 
0x37CA2318, 38092262464341248, 225734623, 225734631, 8, 1440x900 
0x37CA2318, 38092262464817632, 225734672, 225734680, 8, 1440x900 
0x37CA2318, 38092262465663256, 225734753, 225734762, 9, 1440x900 
0x37CA2318, 38092262466324920, 225734819, 225734828, 9, 1440x900 
0x37CA2318, 38092262466994120, 225734888, 225734897, 9, 1440x900 
0x37CA2318, 38092262467459288, 225734933, 225734942, 9, 1440x900 
0x37CA2318, 38092262468306728, 225735018, 225735027, 9, 1440x900 
0x37CA2318, 38092262468966328, 225735088, 225735096, 8, 1440x900 
0x37CA2318, 38092262469627384, 225735153, 225735161, 8, 1440x900 
0x37CA2318, 38092262470104864, 225735202, 225735210, 8, 1440x900 
0x37CA2318, 38092262470967096, 225735288, 225735296, 8, 1440x900 
0x37CA2318, 38092262471624680, 225735347, 225735354, 7, 1440x900 
0x37CA2318, 38092262472217144, 225735407, 225735414, 7, 1440x900 
0x37CA2318, 38092262472930360, 225735477, 225735485, 8, 1440x900 
0x37CA2318, 38092262473600432, 225735547, 225735555, 8, 1440x900 
0x37CA2318, 38092262474261504, 225735612, 225735621, 9, 1440x900 
0x37CA2318, 38092262474742568, 225735662, 225735670, 8, 1440x900 
0x37CA2318, 38092262475574240, 225735743, 225735751, 8, 1440x900 
0x37CA2318, 38092262476245776, 225735811, 225735819, 8, 1440x900 
0x37CA2318, 38092262476904264, 225735878, 225735886, 8, 1440x900 
0x37CA2318, 38092262477406352, 225735927, 225735935, 8, 1440x900 
0x37CA2318, 38092262478225184, 225736013, 225736021, 8, 1440x900 
0x37CA2318, 38092262478878656, 225736078, 225736086, 8, 1440x900 
0x37CA2318, 38092262479555744, 225736143, 225736153, 10, 1440x900 
0x37CA2318, 38092262480876416, 225736277, 225736285, 8, 1440x900 
0x37CA2318, 38092262481536496, 225736342, 225736350, 8, 1440x900 
0x37CA2318, 38092262482206232, 225736407, 225736415, 8, 1440x900 
0x37CA2318, 38092262482665616, 225736453, 225736460, 7, 1440x900 
0x37CA2318, 38092262483522320, 225736543, 225736551, 8, 1440x900 
0x37CA2318, 38092262484181960, 225736607, 225736615, 8, 1440x900 
0x37CA2318, 38092262484763320, 225736663, 225736672, 9, 1440x900 
0x37CA2318, 38092262485314344, 225736722, 225736730, 8, 1440x900 
0x37CA2318, 38092262486160904, 225736803, 225736812, 9, 1440x900 
0x37CA2318, 38092262486821584, 225736873, 225736881, 8, 1440x900 
0x37CA2318, 38092262487427256, 225736932, 225736940, 8, 1440x900 
0x37CA2318, 38092262488140920, 225737002, 225737010, 8, 1440x900 
0x37CA2318, 38092262488820720, 225737069, 225737078, 9, 1440x900 
0x37CA2318, 38092262489475696, 225737139, 225737147, 8, 1440x900 
0x37CA2318, 38092262489945888, 225737182, 225737190, 8, 1440x900 
0x37CA2318, 38092262490792800, 225737267, 225737275, 8, 1440x900 
0x37CA2318, 38092262491456232, 225737338, 225737347, 9, 1440x900 
0x37CA2318, 38092262492111736, 225737397, 225737404, 7, 1440x900 
0x37CA2318, 38092262492579264, 225737444, 225737452, 8, 1440x900 
0x37CA2318, 38092262493437064, 225737533, 225737541, 8, 1440x900 
0x37CA2318, 38092262494099624, 225737597, 225737605, 8, 1440x900 
0x37CA2318, 38092262494765904, 225737667, 225737675, 8, 1440x900 
0x37CA2318, 38092262495429408, 225737732, 225737740, 8, 1440x900 
0x37CA2318, 38092262496092440, 225737798, 225737806, 8, 1440x900 
0x37CA2318, 38092262496751592, 225737867, 225737875, 8, 1440x900 
0x37CA2318, 38092262497267120, 225737917, 225737925, 8, 1440x900 
0x37CA2318, 38092262498062224, 225737998, 225738006, 8, 1440x900 
0x37CA2318, 38092262498723640, 225738058, 225738067, 9, 1440x900 
0x37CA2318, 38092262499392776, 225738127, 225738135, 8, 1440x900 
0x37CA2318, 38092262499856352, 225738177, 225738185, 8, 1440x900 
0x37CA2318, 38092262500704872, 225738263, 225738271, 8, 1440x900 
0x37CA2318, 38092262501366520, 225738328, 225738336, 8, 1440x900 
0x37CA2318, 38092262501839888, 225738373, 225738381, 8, 1440x900 
0x37CA2318, 38092262502494056, 225738436, 225738443, 7, 1440x900 
0x37CA2318, 38092262503158256, 225738507, 225738515, 8, 1440x900 
0x37CA2318, 38092262503824944, 225738573, 225738581, 8, 1440x900 
0x37CA2318, 38092262504494624, 225738638, 225738647, 9, 1440x900 
0x37CA2318, 38092262505156576, 225738708, 225738717, 9, 1440x900 
0x37CA2318, 38092262505816512, 225738769, 225738778, 9, 1440x900 
0x37CA2318, 38092262506493088, 225738838, 225738847, 9, 1440x900 
0x37CA2318, 38092262507135816, 225738902, 225738910, 8, 1440x900 
0x37CA2318, 38092262507796232, 225738967, 225738975, 8, 1440x900 
0x37CA2318, 38092262508448728, 225739033, 225739041, 8, 1440x900 
0x37CA2318, 38092262509108936, 225739103, 225739111, 8, 1440x900 
0x37CA2318, 38092262509784928, 225739168, 225739176, 8, 1440x900 
0x37CA2318, 38092262510438504, 225739232, 225739240, 8, 1440x900 
0x37CA2318, 38092262511102416, 225739299, 225739307, 8, 1440x900 
0x37CA2318, 38092262511765544, 225739368, 225739377, 9, 1440x900 
0x37CA2318, 38092262512425472, 225739431, 225739439, 8, 1440x900 
0x37CA2318, 38092262513090752, 225739496, 225739504, 8, 1440x900 
0x37CA2318, 38092262513744408, 225739563, 225739570, 7, 1440x900 
0x37CA2318, 38092262514406864, 225739627, 225739636, 9, 1440x900 
0x37CA2318, 38092262515074016, 225739698, 225739706, 8, 1440x900 
0x37CA2318, 38092262515852872, 225739774, 225739782, 8, 1440x900 
0x37CA2318, 38092262516386720, 225739828, 225739837, 9, 1440x900 
0x37CA2318, 38092262517241992, 225739917, 225739925, 8, 1440x900 
0x37CA2318, 38092262517716192, 225739962, 225739970, 8, 1440x900 
0x37CA2318, 38092262518550056, 225740043, 225740053, 10, 1440x900 
0x37CA2318, 38092262519057280, 225740097, 225740105, 8, 1440x900 
0x37CA2318, 38092262519884808, 225740178, 225740187, 9, 1440x900 
0x37CA2318, 38092262520393104, 225740226, 225740241, 15, 1440x900 
0x37CA2318, 38092262521044824, 225740295, 225740305, 10, 1440x900 
0x37CA2318, 38092262521701376, 225740357, 225740370, 13, 1440x900 
0x37CA2318, 38092262522368528, 225740422, 225740436, 14, 1440x900 
0x37CA2318, 38092262523039312, 225740488, 225740503, 15, 1440x900 
0x37CA2318, 38092262523702584, 225740555, 225740571, 16, 1440x900 
0x37CA2318, 38092262524373624, 225740622, 225740636, 14, 1440x900 
0x37CA2318, 38092262525033088, 225740694, 225740704, 10, 1440x900 
0x37CA2318, 38092262525696736, 225740757, 225740770, 13, 1440x900 
0x37CA2318, 38092262526355088, 225740822, 225740834, 12, 1440x900 
0x37CA2318, 38092262527037752, 225740893, 225740901, 8, 1440x900 
0x37CA2318, 38092262527652464, 225740952, 225740959, 7, 1440x900 
0x37CA2318, 38092262528284976, 225741013, 225741021, 8, 1440x900 
0x37CA2318, 38092262528941320, 225741078, 225741086, 8, 1440x900 
0x37CA2318, 38092262529603576, 225741148, 225741156, 8, 1440x900 
0x37CA2318, 38092262530267112, 225741212, 225741221, 9, 1440x900 
0x37CA2318, 38092262530931696, 225741278, 225741286, 8, 1440x900 
0x37CA2318, 38092262531587168, 225741343, 225741351, 8, 1440x900 
0x37CA2318, 38092262532247064, 225741409, 225741417, 8, 1440x900 
0x37CA2318, 38092262532907280, 225741477, 225741484, 7, 1440x900 
0x37CA2318, 38092262533572520, 225741542, 225741550, 8, 1440x900 
0x37CA2318, 38092262534227216, 225741608, 225741616, 8, 1440x900 
0x37CA2318, 38092262534896304, 225741678, 225741686, 8, 1440x900 
0x37CA2318, 38092262535663664, 225741757, 225741770, 13, 1440x900 
0x37CA2318, 38092262536252208, 225741812, 225741820, 8, 1440x900 
0x37CA2318, 38092262537050936, 225741896, 225741905, 9, 1440x900 
0x37CA2318, 38092262537580904, 225741943, 225741958, 15, 1440x900 
0x37CA2318, 38092262538238512, 225742009, 225742024, 15, 1440x900 
0x37CA2318, 38092262538899896, 225742079, 225742089, 10, 1440x900 
0x37CA2318, 38092262539557536, 225742142, 225742156, 14, 1440x900 
0x37CA2318, 38092262540218504, 225742207, 225742221, 14, 1440x900 
0x37CA2318, 38092262540888072, 225742272, 225742282, 10, 1440x900 
0x37CA2318, 38092262541556256, 225742342, 225742355, 13, 1440x900 
0x37CA2318, 38092262542218304, 225742408, 225742423, 15, 1440x900 
0x37CA2318, 38092262542878480, 225742473, 225742482, 9, 1440x900 
0x37CA2318, 38092262544192584, 225742607, 225742620, 13, 1440x900 
0x37CA2318, 38092262544849856, 225742672, 225742680, 8, 1440x900 
0x37CA2318, 38092262545502256, 225742737, 225742744, 7, 1440x900 
0x37CA2318, 38092262546142104, 225742802, 225742810, 8, 1440x900 
0x37CA2318, 38092262546798272, 225742867, 225742875, 8, 1440x900 
0x37CA2318, 38092262547468728, 225742932, 225742940, 8, 1440x900 
0x37CA2318, 38092262548118584, 225742998, 225743005, 7, 1440x900 
0x37CA2318, 38092262548782624, 225743063, 225743071, 8, 1440x900 
0x37CA2318, 38092262549635224, 225743152, 225743160, 8, 1440x900 
0x37CA2318, 38092262550112744, 225743198, 225743205, 7, 1440x900 
0x37CA2318, 38092262550772184, 225743268, 225743276, 8, 1440x900 
0x37CA2318, 38092262551438112, 225743333, 225743341, 8, 1440x900 
0x37CA2318, 38092262552174368, 225743408, 225743416, 8, 1440x900 
0x37CA2318, 38092262552750304, 225743462, 225743469, 7, 1440x900 
0x37CA2318, 38092262553417016, 225743529, 225743537, 8, 1440x900 
0x37CA2318, 38092262554071320, 225743597, 225743605, 8, 1440x900 
0x37CA2318, 38092262554731032, 225743663, 225743671, 8, 1440x900 
0x37CA2318, 38092262555596968, 225743748, 225743756, 8, 1440x900 
0x37CA2318, 38092262556060016, 225743798, 225743806, 8, 1440x900 
0x37CA2318, 38092262556719640, 225743858, 225743865, 7, 1440x900 
0x37CA2318, 38092262557587344, 225743947, 225743955, 8, 1440x900 
0x37CA2318, 38092262558170632, 225744008, 225744016, 8, 1440x900 
0x37CA2318, 38092262558705520, 225744063, 225744071, 8, 1440x900 
0x37CA2318, 38092262559367136, 225744124, 225744133, 9, 1440x900 
0x37CA2318, 38092262560034240, 225744193, 225744201, 8, 1440x900 
0x37CA2318, 38092262560700776, 225744259, 225744267, 8, 1440x900 
0x37CA2318, 38092262561351632, 225744322, 225744330, 8, 1440x900 
0x37CA2318, 38092262562011576, 225744387, 225744394, 7, 1440x900 
0x37CA2318, 38092262562871240, 225744472, 225744480, 8, 1440x900 
0x37CA2318, 38092262563336600, 225744518, 225744526, 8, 1440x900 
0x37CA2318, 38092262564000008, 225744588, 225744596, 8, 1440x900 
0x37CA2318, 38092262564668872, 225744653, 225744662, 9, 1440x900 
0x37CA2318, 38092262565321720, 225744722, 225744730, 8, 1440x900 
0x37CA2318, 38092262565987664, 225744788, 225744796, 8, 1440x900 
0x37CA2318, 38092262566639744, 225744852, 225744859, 7, 1440x900 
0x37CA2318, 38092262567296560, 225744917, 225744925, 8, 1440x900 
0x37CA2318, 38092262567967344, 225744983, 225744992, 9, 1440x900 
0x37CA2318, 38092262568627400, 225745053, 225745061, 8, 1440x900 
0x37CA2318, 38092262569280424, 225745119, 225745127, 8, 1440x900 
0x37CA2318, 38092262569940640, 225745183, 225745191, 8, 1440x900 
0x37CA2318, 38092262570683872, 225745257, 225745265, 8, 1440x900 
0x37CA2318, 38092262571263760, 225745317, 225745325, 8, 1440x900 
0x37CA2318, 38092262571922640, 225745383, 225745391, 8, 1440x900 
0x37CA2318, 38092262572582696, 225745448, 225745456, 8, 1440x900 
0x37CA2318, 38092262573246320, 225745514, 225745522, 8, 1440x900 
0x37CA2318, 38092262574103040, 225745598, 225745606, 8, 1440x900 
0x37CA2318, 38092262574754760, 225745662, 225745670, 8, 1440x900 
0x37CA2318, 38092262575423280, 225745729, 225745737, 8, 1440x900 
0x37CA2318, 38092262575898344, 225745778, 225745786, 8, 1440x900 
0x37CA2318, 38092262576742824, 225745862, 225745870, 8, 1440x900 
0x37CA2318, 38092262577402544, 225745927, 225745936, 9, 1440x900 
0x37CA2318, 38092262578062488, 225745992, 225746000, 8, 1440x900 
0x37CA2318, 38092262578535264, 225746038, 225746047, 9, 1440x900 
0x37CA2318, 38092262579227024, 225746108, 225746116, 8, 1440x900 
0x37CA2318, 38092262580053744, 225746193, 225746201, 8, 1440x900 
0x37CA2318, 38092262580706408, 225746257, 225746266, 9, 1440x900 
0x37CA2318, 38092262581180688, 225746307, 225746315, 8, 1440x900 
0x37CA2318, 38092262581848736, 225746377, 225746385, 8, 1440x900 
0x37CA2318, 38092262582691320, 225746458, 225746466, 8, 1440x900 
0x37CA2318, 38092262583352104, 225746518, 225746526, 8, 1440x900 
0x37CA2318, 38092262583818568, 225746567, 225746575, 8, 1440x900 
0x37CA2318, 38092262584474672, 225746633, 225746641, 8, 1440x900 
0x37CA2318, 38092262585138256, 225746703, 225746711, 8, 1440x900 
0x37CA2318, 38092262585810920, 225746773, 225746781, 8, 1440x900 
0x37CA2318, 38092262586465976, 225746838, 225746847, 9, 1440x900 
0x37CA2318, 38092262587128768, 225746902, 225746910, 8, 1440x900 
0x37CA2318, 38092262587794424, 225746968, 225746977, 9, 1440x900 
0x37CA2318, 38092262588451968, 225747033, 225747041, 8, 1440x900 
0x37CA2318, 38092262589117336, 225747097, 225747105, 8, 1440x900 
0x37CA2318, 38092262589820608, 225747168, 225747176, 8, 1440x900 
0x37CA2318, 38092262590634920, 225747251, 225747258, 7, 1440x900 
0x37CA2318, 38092262591302392, 225747317, 225747324, 7, 1440x900 
0x37CA2318, 38092262591965768, 225747383, 225747391, 8, 1440x900 
0x37CA2318, 38092262592428896, 225747428, 225747436, 8, 1440x900 
0x37CA2318, 38092262593083400, 225747497, 225747505, 8, 1440x900 
0x37CA2318, 38092262593743328, 225747564, 225747571, 7, 1440x900 
0x37CA2318, 38092262594405104, 225747627, 225747635, 8, 1440x900 
0x37CA2318, 38092262595069232, 225747693, 225747701, 8, 1440x900 
0x37CA2318, 38092262595919264, 225747783, 225747792, 9, 1440x900 
0x37CA2318, 38092262596466464, 225747839, 225747847, 8, 1440x900 
0x37CA2318, 38092262597061168, 225747892, 225747899, 7, 1440x900 
0x37CA2318, 38092262597906200, 225747978, 225747985, 7, 1440x900 
0x37CA2318, 38092262598575176, 225748047, 225748057, 10, 1440x900 
0x37CA2318, 38092262599037528, 225748091, 225748099, 8, 1440x900 
0x37CA2318, 38092262599692272, 225748157, 225748165, 8, 1440x900 
0x37CA2318, 38092262600557560, 225748243, 225748251, 8, 1440x900 
0x37CA2318, 38092262601226984, 225748313, 225748321, 8, 1440x900 
0x37CA2318, 38092262601879000, 225748378, 225748386, 8, 1440x900 
0x37CA2318, 38092262602346136, 225748422, 225748430, 8, 1440x900 
0x37CA2318, 38092262603006160, 225748487, 225748495, 8, 1440x900 
0x37CA2318, 38092262603666208, 225748553, 225748560, 7, 1440x900 
0x37CA2318, 38092262604331848, 225748622, 225748630, 8, 1440x900 
0x37CA2318, 38092262604986144, 225748687, 225748695, 8, 1440x900 
0x37CA2318, 38092262605656400, 225748753, 225748760, 7, 1440x900 
0x37CA2318, 38092262606326040, 225748818, 225748826, 8, 1440x900 
0x37CA2318, 38092262606979584, 225748886, 225748894, 8, 1440x900 
0x37CA2318, 38092262607639928, 225748951, 225748959, 8, 1440x900 
0x37CA2318, 38092262608489120, 225749038, 225749046, 8, 1440x900 
0x37CA2318, 38092262608970992, 225749085, 225749092, 7, 1440x900 
0x37CA2318, 38092262610284240, 225749218, 225749226, 8, 1440x900 
0x37CA2318, 38092262610947488, 225749283, 225749291, 8, 1440x900 
0x37CA2318, 38092262611617424, 225749353, 225749361, 8, 1440x900 
0x37CA2318, 38092262612269088, 225749417, 225749425, 8, 1440x900 
0x37CA2318, 38092262612929792, 225749483, 225749491, 8, 1440x900 
0x37CA2318, 38092262613587680, 225749547, 225749554, 7, 1440x900 
0x37CA2318, 38092262614257080, 225749617, 225749626, 9, 1440x900 
0x37CA2318, 38092262614910496, 225749683, 225749691, 8, 1440x900 
0x37CA2318, 38092262615760352, 225749762, 225749771, 9, 1440x900 
0x37CA2318, 38092262616238040, 225749814, 225749822, 8, 1440x900 
0x37CA2318, 38092262616974048, 225749888, 225749896, 8, 1440x900 
0x37CA2318, 38092262617550624, 225749942, 225749951, 9, 1440x900 
0x37CA2318, 38092262618213464, 225750012, 225750020, 8, 1440x900 
0x37CA2318, 38092262618885328, 225750078, 225750086, 8, 1440x900 
0x37CA2318, 38092262619730120, 225750163, 225750171, 8, 1440x900 
0x37CA2318, 38092262620400496, 225750232, 225750240, 8, 1440x900 
0x37CA2318, 38092262621052032, 225750293, 225750301, 8, 1440x900 
0x37CA2318, 38092262621525520, 225750342, 225750349, 7, 1440x900 
0x37CA2318, 38092262622231888, 225750412, 225750421, 9, 1440x900 
0x37CA2318, 38092262623035344, 225750493, 225750501, 8, 1440x900 
0x37CA2318, 38092262623692648, 225750562, 225750570, 8, 1440x900 
0x37CA2318, 38092262624170208, 225750607, 225750615, 8, 1440x900 
0x37CA2318, 38092262624822416, 225750669, 225750678, 9, 1440x900 
0x37CA2318, 38092262625493480, 225750737, 225750746, 9, 1440x900 
0x37CA2318, 38092262626149688, 225750805, 225750814, 9, 1440x900 
0x37CA2318, 38092262626806920, 225750867, 225750876, 9, 1440x900 
0x37CA2318, 38092262627467632, 225750933, 225750941, 8, 1440x900 
0x37CA2318, 38092262628127104, 225751001, 225751009, 8, 1440x900 
0x37CA2318, 38092262628786800, 225751066, 225751073, 7, 1440x900 
0x37CA2318, 38092262629482000, 225751134, 225751143, 9, 1440x900 
0x37CA2318, 38092262630103312, 225751197, 225751206, 9, 1440x900 
0x37CA2318, 38092262630763168, 225751262, 225751269, 7, 1440x900 
0x37CA2318, 38092262631423424, 225751328, 225751336, 8, 1440x900 
0x37CA2318, 38092262632084344, 225751393, 225751401, 8, 1440x900 
0x37CA2318, 38092262632743960, 225751462, 225751469, 7, 1440x900 
0x37CA2318, 38092262633406768, 225751527, 225751534, 7, 1440x900 
0x37CA2318, 38092262634073456, 225751598, 225751606, 8, 1440x900 
0x37CA2318, 38092262634739584, 225751663, 225751671, 8, 1440x900 
0x37CA2318, 38092262635395488, 225751728, 225751736, 8, 1440x900 
0x37CA2318, 38092262636044144, 225751797, 225751805, 8, 1440x900 
0x37CA2318, 38092262636712544, 225751862, 225751870, 8, 1440x900 
0x37CA2318, 38092262637563176, 225751947, 225751955, 8, 1440x900 
0x37CA2318, 38092262638225632, 225752014, 225752023, 9, 1440x900 
0x37CA2318, 38092262638882312, 225752078, 225752086, 8, 1440x900 
0x37CA2318, 38092262639366288, 225752128, 225752136, 8, 1440x900 
0x37CA2318, 38092262640218192, 225752213, 225752221, 8, 1440x900 
0x37CA2318, 38092262640877664, 225752273, 225752281, 8, 1440x900 
0x37CA2318, 38092262641532360, 225752342, 225752349, 7, 1440x900 
0x37CA2318, 38092262642006144, 225752388, 225752395, 7, 1440x900 
0x37CA2318, 38092262642864912, 225752473, 225752480, 7, 1440x900 
0x37CA2318, 38092262643517344, 225752537, 225752545, 8, 1440x900 
0x37CA2318, 38092262643983792, 225752583, 225752591, 8, 1440x900 
0x37CA2318, 38092262644844080, 225752673, 225752681, 8, 1440x900 
0x37CA2318, 38092262645506016, 225752737, 225752744, 7, 1440x900 
0x37CA2318, 38092262646158328, 225752804, 225752812, 8, 1440x900 
0x37CA2318, 38092262646634448, 225752853, 225752861, 8, 1440x900 
0x37CA2318, 38092262647477456, 225752933, 225752941, 8, 1440x900 
0x37CA2318, 38092262648138272, 225753003, 225753010, 7, 1440x900 
0x37CA2318, 38092262648809584, 225753073, 225753080, 7, 1440x900 
0x37CA2318, 38092262649283888, 225753117, 225753124, 7, 1440x900 
0x37CA2318, 38092262650123848, 225753202, 225753210, 8, 1440x900 
0x37CA2318, 38092262650793928, 225753270, 225753278, 8, 1440x900 
0x37CA2318, 38092262651445664, 225753333, 225753342, 9, 1440x900 
0x37CA2318, 38092262652132016, 225753402, 225753410, 8, 1440x900 
0x37CA2318, 38092262652793880, 225753467, 225753475, 8, 1440x900 
0x37CA2318, 38092262653444896, 225753533, 225753541, 8, 1440x900 
0x37CA2318, 38092262653952816, 225753588, 225753597, 9, 1440x900 
0x37CA2318, 38092262654580320, 225753646, 225753654, 8, 1440x900 
0x37CA2318, 38092262655435392, 225753728, 225753736, 8, 1440x900 
0x37CA2318, 38092262656098160, 225753797, 225753805, 8, 1440x900 
0x37CA2318, 38092262656598136, 225753847, 225753854, 7, 1440x900 
0x37CA2318, 38092262657410272, 225753932, 225753940, 8, 1440x900 
0x37CA2318, 38092262658081360, 225753998, 225754006, 8, 1440x900 
0x37CA2318, 38092262658750688, 225754068, 225754076, 8, 1440x900 
0x37CA2318, 38092262659213824, 225754113, 225754121, 8, 1440x900 
0x37CA2318, 38092262660062800, 225754198, 225754206, 8, 1440x900 
0x37CA2318, 38092262660714784, 225754263, 225754270, 7, 1440x900 
0x37CA2318, 38092262661382512, 225754332, 225754340, 8, 1440x900 
0x37CA2318, 38092262661856712, 225754378, 225754386, 8, 1440x900 
0x37CA2318, 38092262662696288, 225754458, 225754466, 8, 1440x900 
0x37CA2318, 38092262663211632, 225754513, 225754521, 8, 1440x900 
0x37CA2318, 38092262663830800, 225754568, 225754576, 8, 1440x900 
0x37CA2318, 38092262664505904, 225754642, 225754650, 8, 1440x900 
0x37CA2318, 38092262665169800, 225754708, 225754716, 8, 1440x900 
0x37CA2318, 38092262665829016, 225754773, 225754781, 8, 1440x900 
0x37CA2318, 38092262666496312, 225754838, 225754846, 8, 1440x900 
0x37CA2318, 38092262667148288, 225754902, 225754910, 8, 1440x900 
0x37CA2318, 38092262667808368, 225754967, 225754975, 8, 1440x900 
0x37CA2318, 38092262668475000, 225755033, 225755041, 8, 1440x900 
0x37CA2318, 38092262669137040, 225755102, 225755110, 8, 1440x900 
0x37CA2318, 38092262669790408, 225755168, 225755176, 8, 1440x900 
0x37CA2318, 38092262670450720, 225755234, 225755242, 8, 1440x900 
0x37CA2318, 38092262671115104, 225755298, 225755307, 9, 1440x900 
0x37CA2318, 38092262671792080, 225755368, 225755376, 8, 1440x900 
0x37CA2318, 38092262672638984, 225755451, 225755459, 8, 1440x900 
0x37CA2318, 38092262673127512, 225755498, 225755506, 8, 1440x900 
0x37CA2318, 38092262673766240, 225755563, 225755572, 9, 1440x900 
0x37CA2318, 38092262674437440, 225755633, 225755642, 9, 1440x900 
0x37CA2318, 38092262675130824, 225755703, 225755711, 8, 1440x900 
0x37CA2318, 38092262676472216, 225755838, 225755847, 9, 1440x900 
0x37CA2318, 38092262677075312, 225755894, 225755903, 9, 1440x900 
0x37CA2318, 38092262677733456, 225755961, 225755969, 8, 1440x900 
0x37CA2318, 38092262678395224, 225756028, 225756035, 7, 1440x900 
0x37CA2318, 38092262679058872, 225756093, 225756100, 7, 1440x900 
0x37CA2318, 38092262679716816, 225756159, 225756167, 8, 1440x900 
0x37CA2318, 38092262680376000, 225756227, 225756235, 8, 1440x900 
0x37CA2318, 38092262681036104, 225756293, 225756301, 8, 1440x900 
0x37CA2318, 38092262681704816, 225756358, 225756366, 8, 1440x900 
0x37CA2318, 38092262682359736, 225756424, 225756433, 9, 1440x900 
0x37CA2318, 38092262683018784, 225756488, 225756495, 7, 1440x900 
0x37CA2318, 38092262683681496, 225756557, 225756565, 8, 1440x900 
0x37CA2318, 38092262684350176, 225756622, 225756630, 8, 1440x900 
0x37CA2318, 38092262685197752, 225756708, 225756715, 7, 1440x900 
0x37CA2318, 38092262685660064, 225756756, 225756764, 8, 1440x900 
0x37CA2318, 38092262686485712, 225756838, 225756847, 9, 1440x900 
0x37CA2318, 38092262686986720, 225756888, 225756896, 8, 1440x900 
0x37CA2318, 38092262687655696, 225756953, 225756961, 8, 1440x900 
0x37CA2318, 38092262688510672, 225757042, 225757050, 8, 1440x900 
0x37CA2318, 38092262688974848, 225757083, 225757091, 8, 1440x900 
0x37CA2318, 38092262689730416, 225757158, 225757172, 14, 1440x900 
0x37CA2318, 38092262690331880, 225757224, 225757235, 11, 1440x900 
0x37CA2318, 38092262690996880, 225757288, 225757297, 9, 1440x900 
0x37CA2318, 38092262691670992, 225757357, 225757370, 13, 1440x900 
0x37CA2318, 38092262692309600, 225757418, 225757426, 8, 1440x900 
0x37CA2318, 38092262692971248, 225757483, 225757491, 8, 1440x900 
0x37CA2318, 38092262693597088, 225757543, 225757551, 8, 1440x900 
0x37CA2318, 38092262694257296, 225757611, 225757619, 8, 1440x900 
0x37CA2318, 38092262694917320, 225757678, 225757686, 8, 1440x900 
0x37CA2318, 38092262695579360, 225757743, 225757750, 7, 1440x900 
0x37CA2318, 38092262696237152, 225757808, 225757816, 8, 1440x900 
0x37CA2318, 38092262696896704, 225757877, 225757884, 7, 1440x900 
0x37CA2318, 38092262697557392, 225757942, 225757950, 8, 1440x900 
0x37CA2318, 38092262698223128, 225758008, 225758016, 8, 1440x900 
0x37CA2318, 38092262698883456, 225758073, 225758081, 8, 1440x900 
0x37CA2318, 38092262699552936, 225758148, 225758157, 9, 1440x900 
0x37CA2318, 38092262700207384, 225758207, 225758214, 7, 1440x900 
0x37CA2318, 38092262700895344, 225758279, 225758288, 9, 1440x900 
0x37CA2318, 38092262701528256, 225758338, 225758347, 9, 1440x900 
0x37CA2318, 38092262702190312, 225758406, 225758414, 8, 1440x900 
0x37CA2318, 38092262702913552, 225758478, 225758490, 12, 1440x900 
0x37CA2318, 38092262703559824, 225758541, 225758549, 8, 1440x900 
0x37CA2318, 38092262704174776, 225758603, 225758612, 9, 1440x900 
0x37CA2318, 38092262704834256, 225758668, 225758676, 8, 1440x900 
0x37CA2318, 38092262705495192, 225758736, 225758744, 8, 1440x900 
0x37CA2318, 38092262706155784, 225758803, 225758810, 7, 1440x900 
0x37CA2318, 38092262706814272, 225758867, 225758875, 8, 1440x900 
0x37CA2318, 38092262707528872, 225758943, 225758956, 13, 1440x900 
0x37CA2318, 38092262708172352, 225759002, 225759010, 8, 1440x900 
0x37CA2318, 38092262708790320, 225759067, 225759074, 7, 1440x900 
0x37CA2318, 38092262709450512, 225759132, 225759139, 7, 1440x900 
0x37CA2318, 38092262710113248, 225759203, 225759211, 8, 1440x900 
0x37CA2318, 38092262710775632, 225759268, 225759276, 8, 1440x900 
0x37CA2318, 38092262711435240, 225759332, 225759340, 8, 1440x900 
0x37CA2318, 38092262712100344, 225759398, 225759406, 8, 1440x900 
0x37CA2318, 38092262712769552, 225759467, 225759475, 8, 1440x900 
0x37CA2318, 38092262713618064, 225759553, 225759561, 8, 1440x900 
0x37CA2318, 38092262714275968, 225759673, 225759683, 10, 1440x900 
0x37CA2318, 38092262714959704, 225759684, 225759693, 9, 1440x900 
0x37CA2318, 38092262715738384, 225759758, 225759765, 7, 1440x900 
0x37CA2318, 38092262716200984, 225759806, 225759813, 7, 1440x900 
0x37CA2318, 38092262716893448, 225759873, 225759881, 8, 1440x900 
0x37CA2318, 38092262717524312, 225759938, 225759945, 7, 1440x900 
0x37CA2318, 38092262718182504, 225760003, 225760011, 8, 1440x900 
0x37CA2318, 38092262718842624, 225760072, 225760080, 8, 1440x900 
0x37CA2318, 38092262719506440, 225760143, 225760151, 8, 1440x900 
0x37CA2318, 38092262720176272, 225760208, 225760216, 8, 1440x900 
0x37CA2318, 38092262720826592, 225760272, 225760280, 8, 1440x900 
0x37CA2318, 38092262721687312, 225760358, 225760366, 8, 1440x900 
0x37CA2318, 38092262722339384, 225760422, 225760431, 9, 1440x900 
0x37CA2318, 38092262722812960, 225760473, 225760481, 8, 1440x900 
0x37CA2318, 38092262723465952, 225760538, 225760546, 8, 1440x900 
0x37CA2318, 38092262724125952, 225760603, 225760611, 8, 1440x900 
0x37CA2318, 38092262724844952, 225760672, 225760680, 8, 1440x900 
0x37CA2318, 38092262725611288, 225760748, 225760757, 9, 1440x900 
0x37CA2318, 38092262726111632, 225760802, 225760810, 8, 1440x900 
0x37CA2318, 38092262726968784, 225760888, 225760896, 8, 1440x900 
0x37CA2318, 38092262727440256, 225760933, 225760942, 9, 1440x900 
0x37CA2318, 38092262728096184, 225760999, 225761009, 10, 1440x900 
0x37CA2318, 38092262728957032, 225761082, 225761090, 8, 1440x900 
0x37CA2318, 38092262729610008, 225761147, 225761155, 8, 1440x900 
0x37CA2318, 38092262730081304, 225761197, 225761204, 7, 1440x900 
0x37CA2318, 38092262730925128, 225761283, 225761291, 8, 1440x900 
0x37CA2318, 38092262731596912, 225761347, 225761356, 9, 1440x900 
0x37CA2318, 38092262732208264, 225761412, 225761420, 8, 1440x900 
0x37CA2318, 38092262732907992, 225761483, 225761491, 8, 1440x900 
0x37CA2318, 38092262733570072, 225761548, 225761556, 8, 1440x900 
0x37CA2318, 38092262734240056, 225761613, 225761621, 8, 1440x900 
0x37CA2318, 38092262734878056, 225761679, 225761687, 8, 1440x900 
0x37CA2318, 38092262735543480, 225761742, 225761749, 7, 1440x900 
0x37CA2318, 38092262736207376, 225761807, 225761815, 8, 1440x900 
0x37CA2318, 38092262736886336, 225761873, 225761881, 8, 1440x900 
0x37CA2318, 38092262737355280, 225761922, 225761929, 7, 1440x900 
0x37CA2318, 38092262738191360, 225762006, 225762014, 8, 1440x900 
0x37CA2318, 38092262738870120, 225762073, 225762082, 9, 1440x900 
0x37CA2318, 38092262739529496, 225762143, 225762151, 8, 1440x900 
0x37CA2318, 38092262739994392, 225762187, 225762195, 8, 1440x900 
0x37CA2318, 38092262740844000, 225762273, 225762281, 8, 1440x900 
0x37CA2318, 38092262741496416, 225762337, 225762345, 8, 1440x900 
0x37CA2318, 38092262742159704, 225762403, 225762412, 9, 1440x900 
0x37CA2318, 38092262742634592, 225762452, 225762460, 8, 1440x900 
0x37CA2318, 38092262743484440, 225762539, 225762547, 8, 1440x900 
0x37CA2318, 38092262744137248, 225762602, 225762610, 8, 1440x900 
0x37CA2318, 38092262744715432, 225762662, 225762670, 8, 1440x900 
0x37CA2318, 38092262745479936, 225762738, 225762746, 8, 1440x900 
0x37CA2318, 38092262746132064, 225762798, 225762806, 8, 1440x900 
0x37CA2318, 38092262746784528, 225762869, 225762876, 7, 1440x900 
0x37CA2318, 38092262747266208, 225762913, 225762921, 8, 1440x900 
0x37CA2318, 38092262748125160, 225763002, 225763009, 7, 1440x900 
0x37CA2318, 38092262748795104, 225763069, 225763076, 7, 1440x900 
0x37CA2318, 38092262749448672, 225763137, 225763145, 8, 1440x900 
0x37CA2318, 38092262749917736, 225763182, 225763191, 9, 1440x900 
0x37CA2318, 38092262750768704, 225763268, 225763276, 8, 1440x900 
0x37CA2318, 38092262751429912, 225763333, 225763341, 8, 1440x900 
0x37CA2318, 38092262752086848, 225763397, 225763405, 8, 1440x900 
0x37CA2318, 38092262752560648, 225763447, 225763455, 8, 1440x900 
0x37CA2318, 38092262753408744, 225763528, 225763537, 9, 1440x900 
0x37CA2318, 38092262754070696, 225763598, 225763606, 8, 1440x900 
0x37CA2318, 38092262754723376, 225763663, 225763671, 8, 1440x900 
0x37CA2318, 38092262755206560, 225763708, 225763716, 8, 1440x900 
0x37CA2318, 38092262756054104, 225763791, 225763799, 8, 1440x900 
0x37CA2318, 38092262756719536, 225763863, 225763871, 8, 1440x900 
0x37CA2318, 38092262757230800, 225763912, 225763920, 8, 1440x900 
0x37CA2318, 38092262758043232, 225763993, 225764001, 8, 1440x900 
0x37CA2318, 38092262758703080, 225764062, 225764070, 8, 1440x900 
0x37CA2318, 38092262759373216, 225764127, 225764135, 8, 1440x900 
0x37CA2318, 38092262759905464, 225764182, 225764190, 8, 1440x900 
0x37CA2318, 38092262760682760, 225764257, 225764274, 17, 1440x900 
0x37CA2318, 38092262761344696, 225764323, 225764331, 8, 1440x900 
0x37CA2318, 38092262762013864, 225764393, 225764401, 8, 1440x900 
0x37CA2318, 38092262763324968, 225764524, 225764532, 8, 1440x900 
0x37CA2318, 38092262763980016, 225764588, 225764596, 8, 1440x900 
0x37CA2318, 38092262764659344, 225764653, 225764662, 9, 1440x900 
0x37CA2318, 38092262765123360, 225764703, 225764711, 8, 1440x900 
0x37CA2318, 38092262765972776, 225764784, 225764793, 9, 1440x900 
0x37CA2318, 38092262766633448, 225764848, 225764857, 9, 1440x900 
0x37CA2318, 38092262767294440, 225764914, 225764922, 8, 1440x900 
0x37CA2318, 38092262767757720, 225764962, 225764969, 7, 1440x900 
0x37CA2318, 38092262768413680, 225765027, 225765035, 8, 1440x900 
0x37CA2318, 38092262769074688, 225765092, 225765100, 8, 1440x900 
0x37CA2318, 38092262769739752, 225765161, 225765168, 7, 1440x900 
0x37CA2318, 38092262770395200, 225765227, 225765234, 7, 1440x900 
0x37CA2318, 38092262771059008, 225765297, 225765305, 8, 1440x900 
0x37CA2318, 38092262771721864, 225765357, 225765365, 8, 1440x900 
0x37CA2318, 38092262772383616, 225765423, 225765431, 8, 1440x900 
0x37CA2318, 38092262773048120, 225765492, 225765499, 7, 1440x900 
0x37CA2318, 38092262773709920, 225765557, 225765564, 7, 1440x900 
0x37CA2318, 38092262774564640, 225765648, 225765655, 7, 1440x900 
0x37CA2318, 38092262775036992, 225765693, 225765700, 7, 1440x900 
0x37CA2318, 38092262775896144, 225765778, 225765786, 8, 1440x900 
0x37CA2318, 38092262776546512, 225765848, 225765856, 8, 1440x900 
0x37CA2318, 38092262777021088, 225765893, 225765901, 8, 1440x900 
0x37CA2318, 38092262777700040, 225765957, 225765964, 7, 1440x900 
0x37CA2318, 38092262778530224, 225766038, 225766046, 8, 1440x900 
0x37CA2318, 38092262778991280, 225766088, 225766095, 7, 1440x900 
0x37CA2318, 38092262779656264, 225766152, 225766159, 7, 1440x900 
0x37CA2318, 38092262780312504, 225766222, 225766230, 8, 1440x900 
0x37CA2318, 38092262780974320, 225766288, 225766296, 8, 1440x900 
0x37CA2318, 38092262781644448, 225766353, 225766361, 8, 1440x900 
0x37CA2318, 38092262782485568, 225766438, 225766446, 8, 1440x900 
0x37CA2318, 38092262783162536, 225766504, 225766520, 16, 1440x900 
0x37CA2318, 38092262783664120, 225766558, 225766566, 8, 1440x900 
0x37CA2318, 38092262784490536, 225766637, 225766645, 8, 1440x900 
0x37CA2318, 38092262785152112, 225766701, 225766709, 8, 1440x900 
0x37CA2318, 38092262785812448, 225766773, 225766781, 8, 1440x900 
0x37CA2318, 38092262786285304, 225766818, 225766826, 8, 1440x900 
0x37CA2318, 38092262786941408, 225766878, 225766886, 8, 1440x900 
0x37CA2318, 38092262787650824, 225766951, 225766959, 8, 1440x900 
0x37CA2318, 38092262788336360, 225767024, 225767032, 8, 1440x900 
0x37CA2318, 38092262789018120, 225767088, 225767100, 12, 1440x900 
0x37CA2318, 38092262789663840, 225767152, 225767160, 8, 1440x900 
0x37CA2318, 38092262790254912, 225767213, 225767222, 9, 1440x900 
0x37CA2318, 38092262790960000, 225767282, 225767291, 9, 1440x900 
0x37CA2318, 38092262791578624, 225767347, 225767355, 8, 1440x900 
0x37CA2318, 38092262792229440, 225767412, 225767421, 9, 1440x900 
0x37CA2318, 38092262792913952, 225767482, 225767490, 8, 1440x900 
0x37CA2318, 38092262793557976, 225767548, 225767556, 8, 1440x900 
0x37CA2318, 38092262794210920, 225767612, 225767620, 8, 1440x900 
0x37CA2318, 38092262794870560, 225767678, 225767686, 8, 1440x900 
0x37CA2318, 38092262795530008, 225767743, 225767751, 8, 1440x900 
0x37CA2318, 38092262796200208, 225767807, 225767816, 9, 1440x900 
0x37CA2318, 38092262796852272, 225767872, 225767879, 7, 1440x900 
0x37CA2318, 38092262797510592, 225767937, 225767945, 8, 1440x900 
0x37CA2318, 38092262798172640, 225768007, 225768015, 8, 1440x900 
0x37CA2318, 38092262798834440, 225768067, 225768075, 8, 1440x900 
0x37CA2318, 38092262799683872, 225768158, 225768166, 8, 1440x900 
0x37CA2318, 38092262800348880, 225768223, 225768231, 8, 1440x900 
0x37CA2318, 38092262800945776, 225768283, 225768291, 8, 1440x900 
0x37CA2318, 38092262801672296, 225768358, 225768366, 8, 1440x900 
0x37CA2318, 38092262802335096, 225768423, 225768431, 8, 1440x900 
0x37CA2318, 38092262802994456, 225768488, 225768495, 7, 1440x900 
0x37CA2318, 38092262803467280, 225768533, 225768542, 9, 1440x900 
0x37CA2318, 38092262804127776, 225768602, 225768610, 8, 1440x900 
0x37CA2318, 38092262804966960, 225768687, 225768695, 8, 1440x900 
0x37CA2318, 38092262805637392, 225768752, 225768760, 8, 1440x900 
0x37CA2318, 38092262806101928, 225768797, 225768804, 7, 1440x900 
0x37CA2318, 38092262806960352, 225768887, 225768894, 7, 1440x900 
0x37CA2318, 38092262807619064, 225768948, 225768956, 8, 1440x900 
0x37CA2318, 38092262808272880, 225769017, 225769024, 7, 1440x900 
0x37CA2318, 38092262808756584, 225769062, 225769069, 7, 1440x900 
0x37CA2318, 38092262809410456, 225769133, 225769141, 8, 1440x900 
0x37CA2318, 38092262810070248, 225769198, 225769206, 8, 1440x900 
0x37CA2318, 38092262810730992, 225769263, 225769271, 8, 1440x900 
0x37CA2318, 38092262811400952, 225769328, 225769336, 8, 1440x900 
0x37CA2318, 38092262812049176, 225769392, 225769399, 7, 1440x900 
0x37CA2318, 38092262812901984, 225769476, 225769484, 8, 1440x900 
0x37CA2318, 38092262813444992, 225769532, 225769540, 8, 1440x900 
0x37CA2318, 38092262814043744, 225769592, 225769600, 8, 1440x900 
0x37CA2318, 38092262814729680, 225769658, 225769666, 8, 1440x900 
0x37CA2318, 38092262815359984, 225769722, 225769729, 7, 1440x900 
0x37CA2318, 38092262816109912, 225769796, 225769803, 7, 1440x900 
0x37CA2318, 38092262816876784, 225769876, 225769884, 8, 1440x900 
0x37CA2318, 38092262817445608, 225769933, 225769940, 7, 1440x900 
0x37CA2318, 38092262818001056, 225769987, 225769995, 8, 1440x900 
0x37CA2318, 38092262818665856, 225770052, 225770060, 8, 1440x900 
0x37CA2318, 38092262819980960, 225770186, 225770194, 8, 1440x900 
0x37CA2318, 38092262820641952, 225770253, 225770260, 7, 1440x900 
0x37CA2318, 38092262821306536, 225770317, 225770325, 8, 1440x900 
0x37CA2318, 38092262821965576, 225770382, 225770390, 8, 1440x900 
0x37CA2318, 38092262822625520, 225770448, 225770456, 8, 1440x900 
0x37CA2318, 38092262823287528, 225770517, 225770526, 9, 1440x900 
0x37CA2318, 38092262823954664, 225770583, 225770591, 8, 1440x900 
0x37CA2318, 38092262824608984, 225770648, 225770657, 9, 1440x900 
0x37CA2318, 38092262825268304, 225770714, 225770724, 10, 1440x900 
0x37CA2318, 38092262825926112, 225770781, 225770789, 8, 1440x900 
0x37CA2318, 38092262826602584, 225770847, 225770855, 8, 1440x900 
0x37CA2318, 38092262827460232, 225770932, 225770939, 7, 1440x900 
0x37CA2318, 38092262828110296, 225770997, 225771004, 7, 1440x900 
0x37CA2318, 38092262828629744, 225771051, 225771058, 7, 1440x900 
0x37CA2318, 38092262829243600, 225771112, 225771120, 8, 1440x900 
0x37CA2318, 38092262829906280, 225771182, 225771190, 8, 1440x900 
0x37CA2318, 38092262830568784, 225771248, 225771255, 7, 1440x900 
0x37CA2318, 38092262831227864, 225771308, 225771316, 8, 1440x900 
0x37CA2318, 38092262831883768, 225771373, 225771381, 8, 1440x900 
0x37CA2318, 38092262832750608, 225771463, 225771471, 8, 1440x900 
0x37CA2318, 38092262833217112, 225771513, 225771521, 8, 1440x900 
0x37CA2318, 38092262833883560, 225771578, 225771586, 8, 1440x900 
0x37CA2318, 38092262834537040, 225771642, 225771651, 9, 1440x900 
0x37CA2318, 38092262835197664, 225771707, 225771716, 9, 1440x900 
0x37CA2318, 38092262835857352, 225771773, 225771782, 9, 1440x900 
0x37CA2318, 38092262836524120, 225771843, 225771852, 9, 1440x900 
0x37CA2318, 38092262837177568, 225771908, 225771916, 8, 1440x900 
0x37CA2318, 38092262837840712, 225771971, 225771979, 8, 1440x900 
0x37CA2318, 38092262838500360, 225772037, 225772045, 8, 1440x900 
0x37CA2318, 38092262839172024, 225772107, 225772115, 8, 1440x900 
0x37CA2318, 38092262839823248, 225772173, 225772181, 8, 1440x900 
0x37CA2318, 38092262840480816, 225772233, 225772241, 8, 1440x900 
0x37CA2318, 38092262841148368, 225772302, 225772310, 8, 1440x900 
0x37CA2318, 38092262841810856, 225772368, 225772375, 7, 1440x900 
0x37CA2318, 38092262842471408, 225772433, 225772441, 8, 1440x900 
0x37CA2318, 38092262843131528, 225772498, 225772506, 8, 1440x900 
0x37CA2318, 38092262843799440, 225772567, 225772575, 8, 1440x900 
0x37CA2318, 38092262844644296, 225772652, 225772660, 8, 1440x900 
0x37CA2318, 38092262845309096, 225772722, 225772730, 8, 1440x900 
0x37CA2318, 38092262845813712, 225772773, 225772781, 8, 1440x900 
0x37CA2318, 38092262846631728, 225772853, 225772861, 8, 1440x900 
0x37CA2318, 38092262847096384, 225772898, 225772907, 9, 1440x900 
0x37CA2318, 38092262847799928, 225772968, 225772975, 7, 1440x900 
0x37CA2318, 38092262848436960, 225773027, 225773040, 13, 1440x900 
0x37CA2318, 38092262849105632, 225773100, 225773108, 8, 1440x900 
0x37CA2318, 38092262849764456, 225773162, 225773170, 8, 1440x900 
0x37CA2318, 38092262850423048, 225773227, 225773236, 9, 1440x900 
0x37CA2318, 38092262851084128, 225773292, 225773300, 8, 1440x900 
0x37CA2318, 38092262851714544, 225773358, 225773365, 7, 1440x900 
0x37CA2318, 38092262852373784, 225773422, 225773430, 8, 1440x900 
0x37CA2318, 38092262853047160, 225773492, 225773504, 12, 1440x900 
0x37CA2318, 38092262853758384, 225773564, 225773574, 10, 1440x900 
0x37CA2318, 38092262854392640, 225773623, 225773632, 9, 1440x900 
0x37CA2318, 38092262855052584, 225773692, 225773699, 7, 1440x900 
0x37CA2318, 38092262855687784, 225773753, 225773761, 8, 1440x900 
0x37CA2318, 38092262856545216, 225773843, 225773850, 7, 1440x900 
0x37CA2318, 38092262857195392, 225773907, 225773914, 7, 1440x900 
0x37CA2318, 38092262857669544, 225773953, 225773962, 9, 1440x900 
0x37CA2318, 38092262858337344, 225774022, 225774030, 8, 1440x900 
0x37CA2318, 38092262858989440, 225774087, 225774095, 8, 1440x900 
0x37CA2318, 38092262859652632, 225774157, 225774165, 8, 1440x900 
0x37CA2318, 38092262860314904, 225774222, 225774230, 8, 1440x900 
0x37CA2318, 38092262860988280, 225774288, 225774297, 9, 1440x900 
0x37CA2318, 38092262861648704, 225774353, 225774361, 8, 1440x900 
0x37CA2318, 38092262862327464, 225774418, 225774426, 8, 1440x900 
0x37CA2318, 38092262863148752, 225774503, 225774511, 8, 1440x900 
0x37CA2318, 38092262863618416, 225774552, 225774561, 9, 1440x900 
0x37CA2318, 38092262864286256, 225774617, 225774625, 8, 1440x900 
0x37CA2318, 38092262864946696, 225774683, 225774691, 8, 1440x900 
0x37CA2318, 38092262865609640, 225774748, 225774756, 8, 1440x900 
0x37CA2318, 38092262866274736, 225774817, 225774825, 8, 1440x900 
0x37CA2318, 38092262867121256, 225774903, 225774911, 8, 1440x900 
0x37CA2318, 38092262867587472, 225774948, 225774956, 8, 1440x900 
0x37CA2318, 38092262868252864, 225775018, 225775026, 8, 1440x900 
0x37CA2318, 38092262868910904, 225775077, 225775085, 8, 1440x900 
0x37CA2318, 38092262869568848, 225775147, 225775155, 8, 1440x900 
0x37CA2318, 38092262870228608, 225775212, 225775220, 8, 1440x900 
0x37CA2318, 38092262870895320, 225775277, 225775286, 9, 1440x900 
0x37CA2318, 38092262871555912, 225775343, 225775351, 8, 1440x900 
0x37CA2318, 38092262872210576, 225775414, 225775423, 9, 1440x900 
0x37CA2318, 38092262872873280, 225775472, 225775479, 7, 1440x900 
0x37CA2318, 38092262873539768, 225775538, 225775546, 8, 1440x900 
0x37CA2318, 38092262874200032, 225775606, 225775614, 8, 1440x900 
0x37CA2318, 38092262874862800, 225775677, 225775685, 8, 1440x900 
0x37CA2318, 38092262875611584, 225775752, 225775760, 8, 1440x900 
0x37CA2318, 38092262876188824, 225775808, 225775817, 9, 1440x900 
0x37CA2318, 38092262876860328, 225775873, 225775881, 8, 1440x900 
0x37CA2318, 38092262877519312, 225775943, 225775951, 8, 1440x900 
0x37CA2318, 38092262878176920, 225776007, 225776016, 9, 1440x900 
0x37CA2318, 38092262878884456, 225776073, 225776081, 8, 1440x900 
0x37CA2318, 38092262879484352, 225776133, 225776141, 8, 1440x900 
0x37CA2318, 38092262880151608, 225776202, 225776209, 7, 1440x900 
0x37CA2318, 38092262880810680, 225776267, 225776275, 8, 1440x900 
0x37CA2318, 38092262881471000, 225776333, 225776341, 8, 1440x900 
0x37CA2318, 38092262882131704, 225776398, 225776407, 9, 1440x900 
0x37CA2318, 38092262883450912, 225776532, 225776539, 7, 1440x900 
0x37CA2318, 38092262884111768, 225776597, 225776605, 8, 1440x900 
0x37CA2318, 38092262884771968, 225776663, 225776675, 12, 1440x900 
0x37CA2318, 38092262885453384, 225776732, 225776740, 8, 1440x900 
0x37CA2318, 38092262886091720, 225776797, 225776805, 8, 1440x900 
0x37CA2318, 38092262886751984, 225776863, 225776871, 8, 1440x900 
0x37CA2318, 38092262887415960, 225776928, 225776935, 7, 1440x900 
0x37CA2318, 38092262888080352, 225776993, 225777001, 8, 1440x900 
0x37CA2318, 38092262888735480, 225777058, 225777066, 8, 1440x900 
0x37CA2318, 38092262889402648, 225777128, 225777136, 8, 1440x900 
0x37CA2318, 38092262890066576, 225777193, 225777202, 9, 1440x900 
0x37CA2318, 38092262890726504, 225777262, 225777269, 7, 1440x900 
0x37CA2318, 38092262891379224, 225777322, 225777330, 8, 1440x900 
0x37CA2318, 38092262892046768, 225777391, 225777398, 7, 1440x900 
0x37CA2318, 38092262892707376, 225777457, 225777465, 8, 1440x900 
0x37CA2318, 38092262893367256, 225777522, 225777529, 7, 1440x900 
0x37CA2318, 38092262894027984, 225777587, 225777595, 8, 1440x900 
0x37CA2318, 38092262894688792, 225777656, 225777663, 7, 1440x900 
0x37CA2318, 38092262895349352, 225777721, 225777728, 7, 1440x900 
0x37CA2318, 38092262896008192, 225777787, 225777794, 7, 1440x900 
0x37CA2318, 38092262896676856, 225777853, 225777861, 8, 1440x900 
0x37CA2318, 38092262897342224, 225777927, 225777935, 8, 1440x900 
0x37CA2318, 38092262898024088, 225777988, 225777996, 8, 1440x900 
0x37CA2318, 38092262898660528, 225778055, 225778062, 7, 1440x900 
0x37CA2318, 38092262899318200, 225778118, 225778126, 8, 1440x900 
0x37CA2318, 38092262899998912, 225778187, 225778195, 8, 1440x900 
0x37CA2318, 38092262900638688, 225778253, 225778261, 8, 1440x900 
0x37CA2318, 38092262901297768, 225778316, 225778324, 8, 1440x900 
0x37CA2318, 38092262901963664, 225778382, 225778391, 9, 1440x900 
0x37CA2318, 38092262902644288, 225778453, 225778460, 7, 1440x900 
0x37CA2318, 38092262903284544, 225778514, 225778522, 8, 1440x900 
0x37CA2318, 38092262903940152, 225778582, 225778590, 8, 1440x900 
0x37CA2318, 38092262904601264, 225778646, 225778653, 7, 1440x900 
0x37CA2318, 38092262905261528, 225778712, 225778720, 8, 1440x900 
0x37CA2318, 38092262905921216, 225778778, 225778785, 7, 1440x900 
0x37CA2318, 38092262906588456, 225778846, 225778854, 8, 1440x900 
0x37CA2318, 38092262907246200, 225778912, 225778920, 8, 1440x900 
0x37CA2318, 38092262907902080, 225778977, 225778984, 7, 1440x900 
0x37CA2318, 38092262908564288, 225779042, 225779049, 7, 1440x900 
0x37CA2318, 38092262909229432, 225779109, 225779118, 9, 1440x900 
0x37CA2318, 38092262909958152, 225779183, 225779192, 9, 1440x900 
0x37CA2318, 38092262910556232, 225779243, 225779251, 8, 1440x900 
0x37CA2318, 38092262911218952, 225779308, 225779316, 8, 1440x900 
0x37CA2318, 38092262911877624, 225779378, 225779385, 7, 1440x900 
0x37CA2318, 38092262912561568, 225779443, 225779452, 9, 1440x900 
0x37CA2318, 38092262913192336, 225779508, 225779516, 8, 1440x900 
0x37CA2318, 38092262913850360, 225779569, 225779577, 8, 1440x900 
0x37CA2318, 38092262914510520, 225779637, 225779644, 7, 1440x900 
0x37CA2318, 38092262915175704, 225779703, 225779710, 7, 1440x900 
0x37CA2318, 38092262915837184, 225779768, 225779776, 8, 1440x900 
0x37CA2318, 38092262916492488, 225779833, 225779841, 8, 1440x900 
0x37CA2318, 38092262917152456, 225779902, 225779909, 7, 1440x900 
0x37CA2318, 38092262917826880, 225779973, 225779981, 8, 1440x900 
0x37CA2318, 38092262918478192, 225780038, 225780046, 8, 1440x900 
0x37CA2318, 38092262919135032, 225780098, 225780106, 8, 1440x900 
0x37CA2318, 38092262919799984, 225780167, 225780174, 7, 1440x900 
0x37CA2318, 38092262920463784, 225780232, 225780240, 8, 1440x900 
0x37CA2318, 38092262921123328, 225780297, 225780304, 7, 1440x900 
0x37CA2318, 38092262921783936, 225780363, 225780371, 8, 1440x900 
0x37CA2318, 38092262922448640, 225780433, 225780440, 7, 1440x900 
0x37CA2318, 38092262923104136, 225780497, 225780504, 7, 1440x900 
0x37CA2318, 38092262923765424, 225780562, 225780570, 8, 1440x900 
0x37CA2318, 38092262924424176, 225780628, 225780635, 7, 1440x900 
0x37CA2318, 38092262925088928, 225780697, 225780705, 8, 1440x900 
0x37CA2318, 38092262925768856, 225780762, 225780770, 8, 1440x900 
0x37CA2318, 38092262926407624, 225780826, 225780833, 7, 1440x900 
0x37CA2318, 38092262927064104, 225780893, 225780901, 8, 1440x900 
0x37CA2318, 38092262927729008, 225780958, 225780966, 8, 1440x900 
0x37CA2318, 38092262928384344, 225781026, 225781033, 7, 1440x900 
0x37CA2318, 38092262929046960, 225781093, 225781100, 7, 1440x900 
0x37CA2318, 38092262929704528, 225781162, 225781170, 8, 1440x900 
0x37CA2318, 38092262930375752, 225781227, 225781236, 9, 1440x900 
0x37CA2318, 38092262931032400, 225781288, 225781297, 9, 1440x900 
0x37CA2318, 38092262931696712, 225781357, 225781366, 9, 1440x900 
0x37CA2318, 38092262932373048, 225781428, 225781436, 8, 1440x900 
0x37CA2318, 38092262933033232, 225781493, 225781502, 9, 1440x900 
0x37CA2318, 38092262933688600, 225781553, 225781562, 9, 1440x900 
0x37CA2318, 38092262934348080, 225781622, 225781630, 8, 1440x900 
0x37CA2318, 38092262935008520, 225781687, 225781695, 8, 1440x900 
0x37CA2318, 38092262935668128, 225781752, 225781760, 8, 1440x900 
0x37CA2318, 38092262936331088, 225781818, 225781826, 8, 1440x900 
0x37CA2318, 38092262937000112, 225781887, 225781894, 7, 1440x900 
0x37CA2318, 38092262937670120, 225781952, 225781960, 8, 1440x900 
0x37CA2318, 38092262938328696, 225782018, 225782026, 8, 1440x900 
0x37CA2318, 38092262938995032, 225782086, 225782094, 8, 1440x900 
0x37CA2318, 38092262939656424, 225782151, 225782159, 8, 1440x900 
0x37CA2318, 38092262940313040, 225782217, 225782224, 7, 1440x900 
0x37CA2318, 38092262940979032, 225782283, 225782291, 8, 1440x900 
0x37CA2318, 38092262941641184, 225782351, 225782358, 7, 1440x900 
0x37CA2318, 38092262942300928, 225782416, 225782423, 7, 1440x900 
0x37CA2318, 38092262942956912, 225782482, 225782490, 8, 1440x900 
0x37CA2318, 38092262943622592, 225782548, 225782556, 8, 1440x900 
0x37CA2318, 38092262944290824, 225782618, 225782626, 8, 1440x900 
0x37CA2318, 38092262945137312, 225782703, 225782711, 8, 1440x900 
0x37CA2318, 38092262945787976, 225782767, 225782775, 8, 1440x900 
0x37CA2318, 38092262946574256, 225782842, 225782849, 7, 1440x900 
0x37CA2318, 38092262947121520, 225782897, 225782904, 7, 1440x900 
0x37CA2318, 38092262947773696, 225782968, 225782977, 9, 1440x900 
0x37CA2318, 38092262948244688, 225783012, 225783020, 8, 1440x900 
0x37CA2318, 38092262948920328, 225783082, 225783090, 8, 1440x900 
0x37CA2318, 38092262949759144, 225783162, 225783171, 9, 1440x900 
0x37CA2318, 38092262950430856, 225783232, 225783240, 8, 1440x900 
0x37CA2318, 38092262950893800, 225783277, 225783286, 9, 1440x900 
0x37CA2318, 38092262951748504, 225783363, 225783372, 9, 1440x900 
0x37CA2318, 38092262952209016, 225783408, 225783415, 7, 1440x900 
0x37CA2318, 38092262952884872, 225783477, 225783486, 9, 1440x900 
0x37CA2318, 38092262953731688, 225783562, 225783570, 8, 1440x900 
0x37CA2318, 38092262954394632, 225783628, 225783636, 8, 1440x900 
0x37CA2318, 38092262954863616, 225783676, 225783685, 9, 1440x900 
0x37CA2318, 38092262955716480, 225783757, 225783764, 7, 1440x900 
0x37CA2318, 38092262956177808, 225783808, 225783816, 8, 1440x900 
0x37CA2318, 38092262956842256, 225783873, 225783880, 7, 1440x900 
0x37CA2318, 38092262957509912, 225783937, 225783945, 8, 1440x900 
0x37CA2318, 38092262958168824, 225784003, 225784011, 8, 1440x900 
0x37CA2318, 38092262958828944, 225784069, 225784077, 8, 1440x900 
0x37CA2318, 38092262959488472, 225784138, 225784151, 13, 1440x900 
0x37CA2318, 38092262960167472, 225784203, 225784210, 7, 1440x900 
0x37CA2318, 38092262960803856, 225784267, 225784275, 8, 1440x900 
0x37CA2318, 38092262961473944, 225784337, 225784345, 8, 1440x900 
0x37CA2318, 38092262962149216, 225784402, 225784409, 7, 1440x900 
0x37CA2318, 38092262962806376, 225784467, 225784475, 8, 1440x900 
0x37CA2318, 38092262963466328, 225784534, 225784543, 9, 1440x900 
0x37CA2318, 38092262964787776, 225784667, 225784675, 8, 1440x900 
0x37CA2318, 38092262965459112, 225784734, 225784742, 8, 1440x900 
0x37CA2318, 38092262966111440, 225784802, 225784810, 8, 1440x900 
0x37CA2318, 38092262966781192, 225784868, 225784876, 8, 1440x900 
0x37CA2318, 38092262967446792, 225784937, 225784945, 8, 1440x900 
0x37CA2318, 38092262968087384, 225784998, 225785006, 8, 1440x900 
0x37CA2318, 38092262968742112, 225785058, 225785066, 8, 1440x900 
0x37CA2318, 38092262969599784, 225785147, 225785154, 7, 1440x900 
0x37CA2318, 38092262970067976, 225785192, 225785199, 7, 1440x900 
0x37CA2318, 38092262970724896, 225785258, 225785265, 7, 1440x900 
0x37CA2318, 38092262971387624, 225785328, 225785336, 8, 1440x900 
0x37CA2318, 38092262972047472, 225785393, 225785401, 8, 1440x900 
0x37CA2318, 38092262972714152, 225785458, 225785466, 8, 1440x900 
0x37CA2318, 38092262973368536, 225785526, 225785534, 8, 1440x900 
0x37CA2318, 38092262974038416, 225785593, 225785600, 7, 1440x900 
0x37CA2318, 38092262974699312, 225785658, 225785665, 7, 1440x900 
0x37CA2318, 38092262975356384, 225785722, 225785730, 8, 1440x900 
0x37CA2318, 38092262976015680, 225785788, 225785795, 7, 1440x900 
0x37CA2318, 38092262976803488, 225785867, 225785874, 7, 1440x900 
0x37CA2318, 38092262977339232, 225785918, 225785926, 8, 1440x900 
0x37CA2318, 38092262977995528, 225785983, 225785992, 9, 1440x900 
0x37CA2318, 38092262978657208, 225786052, 225786060, 8, 1440x900 
0x37CA2318, 38092262979315744, 225786118, 225786125, 7, 1440x900 
0x37CA2318, 38092262979980160, 225786183, 225786191, 8, 1440x900 
0x37CA2318, 38092262980635992, 225786248, 225786256, 8, 1440x900 
0x37CA2318, 38092262981297496, 225786316, 225786324, 8, 1440x900 
0x37CA2318, 38092262981961008, 225786386, 225786394, 8, 1440x900 
0x37CA2318, 38092262982626208, 225786448, 225786456, 8, 1440x900 
0x37CA2318, 38092262983298880, 225786522, 225786529, 7, 1440x900 
0x37CA2318, 38092262983945160, 225786584, 225786592, 8, 1440x900 
0x37CA2318, 38092262984609288, 225786649, 225786658, 9, 1440x900 
0x37CA2318, 38092262985322960, 225786722, 225786730, 8, 1440x900 
0x37CA2318, 38092262985932840, 225786781, 225786789, 8, 1440x900 
0x37CA2318, 38092262986792312, 225786868, 225786876, 8, 1440x900 
0x37CA2318, 38092262987263032, 225786918, 225786926, 8, 1440x900 
0x37CA2318, 38092262987918432, 225786979, 225786987, 8, 1440x900 
0x37CA2318, 38092262988576016, 225787047, 225787055, 8, 1440x900 
0x37CA2318, 38092262989430976, 225787133, 225787141, 8, 1440x900 
0x37CA2318, 38092262989905248, 225787180, 225787187, 7, 1440x900 
0x37CA2318, 38092262990742376, 225787262, 225787270, 8, 1440x900 
0x37CA2318, 38092262991404896, 225787327, 225787335, 8, 1440x900 
0x37CA2318, 38092262992070792, 225787397, 225787405, 8, 1440x900 
0x37CA2318, 38092262992543168, 225787442, 225787450, 8, 1440x900 
0x37CA2318, 38092262993394848, 225787529, 225787537, 8, 1440x900 
0x37CA2318, 38092262994056552, 225787597, 225787605, 8, 1440x900 
0x37CA2318, 38092262994666744, 225787658, 225787666, 8, 1440x900 
0x37CA2318, 38092262995180816, 225787708, 225787716, 8, 1440x900 
0x37CA2318, 38092262995846600, 225787777, 225787785, 8, 1440x900 
0x37CA2318, 38092262996501712, 225787839, 225787847, 8, 1440x900 
0x37CA2318, 38092262997171416, 225787908, 225787916, 8, 1440x900 
0x37CA2318, 38092262997822568, 225787968, 225787977, 9, 1440x900 
0x37CA2318, 38092262998481464, 225788039, 225788047, 8, 1440x900 
0x37CA2318, 38092262999159056, 225788107, 225788115, 8, 1440x900 
0x37CA2318, 38092262999821408, 225788173, 225788182, 9, 1440x900 
0x37CA2318, 38092263000476024, 225788233, 225788240, 7, 1440x900 
0x37CA2318, 38092263001136648, 225788301, 225788309, 8, 1440x900 
0x37CA2318, 38092263002002040, 225788387, 225788396, 9, 1440x900 
0x37CA2318, 38092263002478856, 225788437, 225788446, 9, 1440x900 
0x37CA2318, 38092263003324624, 225788523, 225788531, 8, 1440x900 
0x37CA2318, 38092263003929368, 225788582, 225788590, 8, 1440x900 
0x37CA2318, 38092263004644752, 225788653, 225788661, 8, 1440x900 
0x37CA2318, 38092263005306472, 225788718, 225788725, 7, 1440x900 
0x37CA2318, 38092263005769320, 225788762, 225788770, 8, 1440x900 
0x37CA2318, 38092263006434344, 225788833, 225788840, 7, 1440x900 
0x37CA2318, 38092263007089536, 225788896, 225788904, 8, 1440x900 
0x37CA2318, 38092263007747264, 225788957, 225788965, 8, 1440x900 
0x37CA2318, 38092263008407672, 225789027, 225789034, 7, 1440x900 
0x37CA2318, 38092263009072568, 225789092, 225789100, 8, 1440x900 
0x37CA2318, 38092263009732792, 225789157, 225789165, 8, 1440x900 
0x37CA2318, 38092263010392904, 225789227, 225789234, 7, 1440x900 
0x37CA2318, 38092263011052952, 225789292, 225789299, 7, 1440x900 
0x37CA2318, 38092263011716536, 225789358, 225789365, 7, 1440x900 
0x37CA2318, 38092263012572976, 225789443, 225789452, 9, 1440x900 
0x37CA2318, 38092263013234432, 225789514, 225789522, 8, 1440x900 
0x37CA2318, 38092263013887888, 225789577, 225789585, 8, 1440x900 
0x37CA2318, 38092263014365672, 225789627, 225789636, 9, 1440x900 
0x37CA2318, 38092263015031608, 225789692, 225789700, 8, 1440x900 
0x37CA2318, 38092263015873736, 225789778, 225789786, 8, 1440x900 
0x37CA2318, 38092263016338264, 225789823, 225789831, 8, 1440x900 
0x37CA2318, 38092263017012648, 225789887, 225789895, 8, 1440x900 
0x37CA2318, 38092263017670832, 225789953, 225789961, 8, 1440x900 
0x37CA2318, 38092263018332136, 225790021, 225790029, 8, 1440x900 
0x37CA2318, 38092263018992608, 225790087, 225790095, 8, 1440x900 
0x37CA2318, 38092263019648848, 225790152, 225790159, 7, 1440x900 
0x37CA2318, 38092263020341936, 225790223, 225790230, 7, 1440x900 
0x37CA2318, 38092263020978664, 225790283, 225790291, 8, 1440x900 
0x37CA2318, 38092263021638248, 225790352, 225790358, 6, 1440x900 
0x37CA2318, 38092263022301472, 225790420, 225790428, 8, 1440x900 
0x37CA2318, 38092263022980944, 225790483, 225790491, 8, 1440x900 
0x37CA2318, 38092263023622128, 225790547, 225790555, 8, 1440x900 
0x37CA2318, 38092263024277944, 225790613, 225790621, 8, 1440x900 
0x37CA2318, 38092263024941984, 225790678, 225790686, 8, 1440x900 
0x37CA2318, 38092263025793376, 225790768, 225790776, 8, 1440x900 
0x37CA2318, 38092263026461208, 225790837, 225790844, 7, 1440x900 
0x37CA2318, 38092263027112936, 225790897, 225790904, 7, 1440x900 
0x37CA2318, 38092263028437816, 225791033, 225791041, 8, 1440x900 
0x37CA2318, 38092263029110160, 225791102, 225791110, 8, 1440x900 
0x37CA2318, 38092263029770896, 225791164, 225791173, 9, 1440x900 
0x37CA2318, 38092263030235360, 225791217, 225791225, 8, 1440x900 
0x37CA2318, 38092263031080912, 225791293, 225791301, 8, 1440x900 
0x37CA2318, 38092263031753816, 225791363, 225791372, 9, 1440x900 
0x37CA2318, 38092263032383856, 225791428, 225791436, 8, 1440x900 
0x37CA2318, 38092263033061784, 225791491, 225791498, 7, 1440x900 
0x37CA2318, 38092263033731800, 225791563, 225791571, 8, 1440x900 
0x37CA2318, 38092263034392200, 225791627, 225791635, 8, 1440x900 
0x37CA2318, 38092263034867464, 225791672, 225791680, 8, 1440x900 
0x37CA2318, 38092263035713672, 225791758, 225791767, 9, 1440x900 
0x37CA2318, 38092263036374104, 225791827, 225791835, 8, 1440x900 
0x37CA2318, 38092263037036560, 225791893, 225791901, 8, 1440x900 
0x37CA2318, 38092263037507224, 225791942, 225791950, 8, 1440x900 
0x37CA2318, 38092263038372984, 225792028, 225792036, 8, 1440x900 
0x37CA2318, 38092263039024544, 225792093, 225792101, 8, 1440x900 
0x37CA2318, 38092263039684216, 225792159, 225792166, 7, 1440x900 
0x37CA2318, 38092263040157712, 225792203, 225792211, 8, 1440x900 
0x37CA2318, 38092263041016128, 225792288, 225792296, 8, 1440x900 
0x37CA2318, 38092263041658624, 225792352, 225792360, 8, 1440x900 
0x37CA2318, 38092263042331664, 225792422, 225792430, 8, 1440x900 
0x37CA2318, 38092263042799528, 225792467, 225792475, 8, 1440x900 
0x37CA2318, 38092263043645024, 225792553, 225792562, 9, 1440x900 
0x37CA2318, 38092263044307040, 225792618, 225792626, 8, 1440x900 
0x37CA2318, 38092263044889424, 225792678, 225792686, 8, 1440x900 
0x37CA2318, 38092263045634416, 225792754, 225792762, 8, 1440x900 
0x37CA2318, 38092263046297232, 225792817, 225792826, 9, 1440x900 
0x37CA2318, 38092263046956984, 225792887, 225792896, 9, 1440x900 
0x37CA2318, 38092263047545648, 225792942, 225792950, 8, 1440x900 
0x37CA2318, 38092263048274776, 225793014, 225793021, 7, 1440x900 
0x37CA2318, 38092263048950984, 225793083, 225793092, 9, 1440x900 
0x37CA2318, 38092263049601456, 225793153, 225793161, 8, 1440x900 
0x37CA2318, 38092263050074976, 225793193, 225793202, 9, 1440x900 
0x37CA2318, 38092263050924016, 225793282, 225793292, 10, 1440x900 
0x37CA2318, 38092263051584664, 225793344, 225793352, 8, 1440x900 
0x37CA2318, 38092263052243512, 225793412, 225793420, 8, 1440x900 
0x37CA2318, 38092263052711152, 225793462, 225793470, 8, 1440x900 
0x37CA2318, 38092263053559112, 225793547, 225793555, 8, 1440x900 
0x37CA2318, 38092263054222656, 225793608, 225793617, 9, 1440x900 
0x37CA2318, 38092263054882280, 225793677, 225793685, 8, 1440x900 
0x37CA2318, 38092263055355912, 225793727, 225793735, 8, 1440x900 
0x37CA2318, 38092263056212304, 225793808, 225793815, 7, 1440x900 
0x37CA2318, 38092263056874696, 225793874, 225793883, 9, 1440x900 
0x37CA2318, 38092263057400928, 225793932, 225793940, 8, 1440x900 
0x37CA2318, 38092263058200952, 225794007, 225794016, 9, 1440x900 
0x37CA2318, 38092263058858360, 225794073, 225794082, 9, 1440x900 
0x37CA2318, 38092263059522288, 225794142, 225794150, 8, 1440x900 
0x37CA2318, 38092263059991944, 225794188, 225794196, 8, 1440x900 
0x37CA2318, 38092263060844784, 225794278, 225794286, 8, 1440x900 
0x37CA2318, 38092263061496592, 225794338, 225794346, 8, 1440x900 
0x37CA2318, 38092263062173080, 225794408, 225794416, 8, 1440x900 
0x37CA2318, 38092263062636472, 225794453, 225794461, 8, 1440x900 
0x37CA2318, 38092263063485056, 225794537, 225794545, 8, 1440x900 
0x37CA2318, 38092263064137496, 225794603, 225794611, 8, 1440x900 
0x37CA2318, 38092263064812072, 225794668, 225794677, 9, 1440x900 
0x37CA2318, 38092263065285536, 225794717, 225794725, 8, 1440x900 
0x37CA2318, 38092263066129416, 225794803, 225794811, 8, 1440x900 
0x37CA2318, 38092263066796272, 225794867, 225794876, 9, 1440x900 
0x37CA2318, 38092263067414696, 225794932, 225794940, 8, 1440x900 
0x37CA2318, 38092263068119920, 225794998, 225795007, 9, 1440x900 
0x37CA2318, 38092263068774032, 225795063, 225795072, 9, 1440x900 
0x37CA2318, 38092263069436984, 225795133, 225795141, 8, 1440x900 
0x37CA2318, 38092263069911248, 225795180, 225795188, 8, 1440x900 
0x37CA2318, 38092263070758608, 225795263, 225795271, 8, 1440x900 
0x37CA2318, 38092263071418304, 225795329, 225795337, 8, 1440x900 
0x37CA2318, 38092263072078408, 225795393, 225795401, 8, 1440x900 
0x37CA2318, 38092263072554584, 225795443, 225795451, 8, 1440x900 
0x37CA2318, 38092263073402016, 225795529, 225795537, 8, 1440x900 
0x37CA2318, 38092263074063152, 225795593, 225795602, 9, 1440x900 
0x37CA2318, 38092263074723048, 225795658, 225795665, 7, 1440x900 
0x37CA2318, 38092263075193536, 225795707, 225795715, 8, 1440x900 
0x37CA2318, 38092263076045216, 225795794, 225795802, 8, 1440x900 
0x37CA2318, 38092263076695832, 225795857, 225795865, 8, 1440x900 
0x37CA2318, 38092263077357080, 225795928, 225795936, 8, 1440x900 
0x37CA2318, 38092263077840552, 225795973, 225795981, 8, 1440x900 
0x37CA2318, 38092263078689832, 225796057, 225796065, 8, 1440x900 
0x37CA2318, 38092263079342768, 225796122, 225796130, 8, 1440x900 
0x37CA2318, 38092263079930256, 225796183, 225796191, 8, 1440x900 
0x37CA2318, 38092263080686288, 225796258, 225796266, 8, 1440x900 
0x37CA2318, 38092263081345664, 225796324, 225796332, 8, 1440x900 
0x37CA2318, 38092263081995256, 225796388, 225796396, 8, 1440x900 
0x37CA2318, 38092263082467160, 225796433, 225796440, 7, 1440x900 
0x37CA2318, 38092263083311560, 225796517, 225796526, 9, 1440x900 
0x37CA2318, 38092263083983224, 225796588, 225796596, 8, 1440x900 
0x37CA2318, 38092263084634688, 225796654, 225796662, 8, 1440x900 
0x37CA2318, 38092263085958552, 225796787, 225796795, 8, 1440x900 
0x37CA2318, 38092263086619008, 225796853, 225796861, 8, 1440x900 
0x37CA2318, 38092263087289488, 225796918, 225796927, 9, 1440x900 
0x37CA2318, 38092263087762912, 225796968, 225796976, 8, 1440x900 
0x37CA2318, 38092263088603528, 225797052, 225797060, 8, 1440x900 
0x37CA2318, 38092263089273384, 225797118, 225797126, 8, 1440x900 
0x37CA2318, 38092263089940600, 225797183, 225797191, 8, 1440x900 
0x37CA2318, 38092263090592560, 225797252, 225797260, 8, 1440x900 
0x37CA2318, 38092263091261432, 225797313, 225797321, 8, 1440x900 
0x37CA2318, 38092263091923928, 225797383, 225797391, 8, 1440x900 
0x37CA2318, 38092263092443688, 225797432, 225797440, 8, 1440x900 
0x37CA2318, 38092263093239824, 225797518, 225797525, 7, 1440x900 
0x37CA2318, 38092263093905328, 225797579, 225797587, 8, 1440x900 
0x37CA2318, 38092263094562208, 225797647, 225797655, 8, 1440x900 
0x37CA2318, 38092263095037592, 225797692, 225797701, 9, 1440x900 
0x37CA2318, 38092263095882512, 225797778, 225797786, 8, 1440x900 
0x37CA2318, 38092263096549528, 225797842, 225797850, 8, 1440x900 
0x37CA2318, 38092263097203656, 225797907, 225797916, 9, 1440x900 
0x37CA2318, 38092263097678376, 225797958, 225797966, 8, 1440x900 
0x37CA2318, 38092263098524008, 225798044, 225798051, 7, 1440x900 
0x37CA2318, 38092263099185376, 225798109, 225798117, 8, 1440x900 
0x37CA2318, 38092263099846096, 225798173, 225798182, 9, 1440x900 
0x37CA2318, 38092263100318512, 225798223, 225798231, 8, 1440x900 
0x37CA2318, 38092263101167048, 225798307, 225798315, 8, 1440x900 
0x37CA2318, 38092263101827832, 225798373, 225798381, 8, 1440x900 
0x37CA2318, 38092263102454232, 225798437, 225798445, 8, 1440x900 
0x37CA2318, 38092263103139736, 225798503, 225798511, 8, 1440x900 
0x37CA2318, 38092263103810440, 225798569, 225798578, 9, 1440x900 
0x37CA2318, 38092263104471744, 225798638, 225798646, 8, 1440x900 
0x37CA2318, 38092263104958760, 225798683, 225798691, 8, 1440x900 
0x37CA2318, 38092263105798736, 225798768, 225798776, 8, 1440x900 
0x37CA2318, 38092263106450696, 225798833, 225798842, 9, 1440x900 
0x37CA2318, 38092263107120568, 225798897, 225798905, 8, 1440x900 
0x37CA2318, 38092263107582648, 225798946, 225798953, 7, 1440x900 
0x37CA2318, 38092263108434184, 225799034, 225799042, 8, 1440x900 
0x37CA2318, 38092263109101776, 225799098, 225799106, 8, 1440x900 
0x37CA2318, 38092263109761864, 225799164, 225799172, 8, 1440x900 
0x37CA2318, 38092263110228536, 225799212, 225799220, 8, 1440x900 
0x37CA2318, 38092263111085160, 225799298, 225799306, 8, 1440x900 
0x37CA2318, 38092263111748360, 225799363, 225799371, 8, 1440x900 
0x37CA2318, 38092263112400328, 225799429, 225799438, 9, 1440x900 
0x37CA2318, 38092263112873256, 225799473, 225799480, 7, 1440x900 
0x37CA2318, 38092263113731856, 225799561, 225799569, 8, 1440x900 
0x37CA2318, 38092263114401360, 225799627, 225799636, 9, 1440x900 
0x37CA2318, 38092263114967168, 225799687, 225799695, 8, 1440x900 
0x37CA2318, 38092263115723336, 225799762, 225799770, 8, 1440x900 
0x37CA2318, 38092263116382976, 225799828, 225799836, 8, 1440x900 
0x37CA2318, 38092263117033488, 225799892, 225799900, 8, 1440x900 
0x37CA2318, 38092263117506400, 225799938, 225799947, 9, 1440x900 
0x37CA2318, 38092263118357592, 225800023, 225800032, 9, 1440x900 
0x37CA2318, 38092263119013728, 225800088, 225800097, 9, 1440x900 
0x37CA2318, 38092263119674064, 225800157, 225800165, 8, 1440x900 
0x37CA2318, 38092263120148536, 225800207, 225800215, 8, 1440x900 
0x37CA2318, 38092263120996784, 225800288, 225800296, 8, 1440x900 
0x37CA2318, 38092263121648048, 225800352, 225800361, 9, 1440x900 
0x37CA2318, 38092263122328008, 225800422, 225800430, 8, 1440x900 
0x37CA2318, 38092263122794816, 225800468, 225800476, 8, 1440x900 
0x37CA2318, 38092263123450608, 225800533, 225800540, 7, 1440x900 
0x37CA2318, 38092263124114984, 225800598, 225800606, 8, 1440x900 
0x37CA2318, 38092263124774832, 225800663, 225800671, 8, 1440x900 
0x37CA2318, 38092263125440808, 225800733, 225800740, 7, 1440x900 
0x37CA2318, 38092263126095264, 225800799, 225800806, 7, 1440x900 
0x37CA2318, 38092263126758016, 225800862, 225800869, 7, 1440x900 
0x37CA2318, 38092263127417744, 225800927, 225800935, 8, 1440x900 
0x37CA2318, 38092263128082960, 225800998, 225801005, 7, 1440x900 
0x37CA2318, 38092263128927504, 225801078, 225801086, 8, 1440x900 
0x37CA2318, 38092263129599592, 225801152, 225801160, 8, 1440x900 
0x37CA2318, 38092263130071264, 225801198, 225801206, 8, 1440x900 
0x37CA2318, 38092263130918888, 225801282, 225801290, 8, 1440x900 
0x37CA2318, 38092263131579904, 225801347, 225801355, 8, 1440x900 
0x37CA2318, 38092263132250936, 225801414, 225801422, 8, 1440x900 
0x37CA2318, 38092263132713952, 225801462, 225801470, 8, 1440x900 
0x37CA2318, 38092263133564824, 225801548, 225801556, 8, 1440x900 
0x37CA2318, 38092263134225328, 225801613, 225801622, 9, 1440x900 
0x37CA2318, 38092263134894976, 225801678, 225801686, 8, 1440x900 
0x37CA2318, 38092263135359696, 225801728, 225801736, 8, 1440x900 
0x37CA2318, 38092263136208304, 225801807, 225801816, 9, 1440x900 
0x37CA2318, 38092263136872216, 225801878, 225801886, 8, 1440x900 
0x37CA2318, 38092263137494768, 225801938, 225801945, 7, 1440x900 
0x37CA2318, 38092263138190704, 225802008, 225802016, 8, 1440x900 
0x37CA2318, 38092263138844280, 225802069, 225802077, 8, 1440x900 
0x37CA2318, 38092263139518296, 225802142, 225802150, 8, 1440x900 
0x37CA2318, 38092263140000192, 225802187, 225802195, 8, 1440x900 
0x37CA2318, 38092263140835864, 225802272, 225802280, 8, 1440x900 
0x37CA2318, 38092263141490704, 225802337, 225802345, 8, 1440x900 
0x37CA2318, 38092263142163976, 225802403, 225802412, 9, 1440x900 
0x37CA2318, 38092263142627040, 225802452, 225802460, 8, 1440x900 
0x37CA2318, 38092263143467752, 225802538, 225802546, 8, 1440x900 
0x37CA2318, 38092263144149048, 225802607, 225802615, 8, 1440x900 
0x37CA2318, 38092263144799056, 225802667, 225802675, 8, 1440x900 
0x37CA2318, 38092263146123400, 225802802, 225802810, 8, 1440x900 
0x37CA2318, 38092263146782704, 225802868, 225802876, 8, 1440x900 
0x37CA2318, 38092263147343352, 225802928, 225802937, 9, 1440x900 
0x37CA2318, 38092263147916904, 225802979, 225802988, 9, 1440x900 
0x37CA2318, 38092263148766624, 225803067, 225803075, 8, 1440x900 
0x37CA2318, 38092263149428544, 225803133, 225803142, 9, 1440x900 
0x37CA2318, 38092263149895552, 225803178, 225803185, 7, 1440x900 
0x37CA2318, 38092263150762088, 225803263, 225803272, 9, 1440x900 
0x37CA2318, 38092263151431616, 225803333, 225803341, 8, 1440x900 
0x37CA2318, 38092263152092728, 225803398, 225803407, 9, 1440x900 
0x37CA2318, 38092263152557664, 225803447, 225803455, 8, 1440x900 
0x37CA2318, 38092263153407640, 225803533, 225803541, 8, 1440x900 
0x37CA2318, 38092263154069296, 225803593, 225803602, 9, 1440x900 
0x37CA2318, 38092263154734576, 225803664, 225803672, 8, 1440x900 
0x37CA2318, 38092263155198192, 225803708, 225803716, 8, 1440x900 
0x37CA2318, 38092263156046200, 225803792, 225803800, 8, 1440x900 
0x37CA2318, 38092263156716416, 225803858, 225803867, 9, 1440x900 
0x37CA2318, 38092263157353232, 225803927, 225803936, 9, 1440x900 
0x37CA2318, 38092263157838160, 225803972, 225803980, 8, 1440x900 
0x37CA2318, 38092263158687792, 225804057, 225804065, 8, 1440x900 
0x37CA2318, 38092263159349528, 225804123, 225804131, 8, 1440x900 
0x37CA2318, 38092263159841264, 225804171, 225804178, 7, 1440x900 
0x37CA2318, 38092263160478576, 225804233, 225804241, 8, 1440x900 
0x37CA2318, 38092263161330256, 225804323, 225804330, 7, 1440x900 
0x37CA2318, 38092263161988848, 225804388, 225804396, 8, 1440x900 
0x37CA2318, 38092263162462368, 225804437, 225804445, 8, 1440x900 
0x37CA2318, 38092263163306584, 225804522, 225804530, 8, 1440x900 
0x37CA2318, 38092263163972080, 225804585, 225804593, 8, 1440x900 
0x37CA2318, 38092263164632312, 225804652, 225804660, 8, 1440x900 
0x37CA2318, 38092263165101920, 225804697, 225804705, 8, 1440x900 
0x37CA2318, 38092263165953504, 225804783, 225804792, 9, 1440x900 
0x37CA2318, 38092263166607816, 225804852, 225804860, 8, 1440x900 
0x37CA2318, 38092263167269208, 225804913, 225804923, 10, 1440x900 
0x37CA2318, 38092263167746512, 225804962, 225804971, 9, 1440x900 
0x37CA2318, 38092263168607392, 225805047, 225805055, 8, 1440x900 
0x37CA2318, 38092263169264840, 225805114, 225805122, 8, 1440x900 
0x37CA2318, 38092263169870408, 225805177, 225805185, 8, 1440x900 
0x37CA2318, 38092263170592752, 225805247, 225805254, 7, 1440x900 
0x37CA2318, 38092263171250544, 225805312, 225805322, 10, 1440x900 
0x37CA2318, 38092263171910448, 225805383, 225805391, 8, 1440x900 
0x37CA2318, 38092263172385248, 225805427, 225805435, 8, 1440x900 
0x37CA2318, 38092263173230864, 225805513, 225805521, 8, 1440x900 
0x37CA2318, 38092263173901664, 225805578, 225805587, 9, 1440x900 
0x37CA2318, 38092263174561936, 225805648, 225805656, 8, 1440x900 
0x37CA2318, 38092263175030360, 225805693, 225805701, 8, 1440x900 
0x37CA2318, 38092263175888520, 225805778, 225805786, 8, 1440x900 
0x37CA2318, 38092263176539792, 225805843, 225805851, 8, 1440x900 
0x37CA2318, 38092263177203616, 225805912, 225805920, 8, 1440x900 
0x37CA2318, 38092263177673520, 225805958, 225805966, 8, 1440x900 
0x37CA2318, 38092263178528608, 225806042, 225806050, 8, 1440x900 
0x37CA2318, 38092263179191032, 225806108, 225806116, 8, 1440x900 
0x37CA2318, 38092263179845584, 225806173, 225806182, 9, 1440x900 
0x37CA2318, 38092263180323312, 225806223, 225806231, 8, 1440x900 
0x37CA2318, 38092263181168848, 225806307, 225806315, 8, 1440x900 
0x37CA2318, 38092263181836136, 225806373, 225806381, 8, 1440x900 
0x37CA2318, 38092263182377536, 225806428, 225806436, 8, 1440x900 
0x37CA2318, 38092263183161176, 225806503, 225806512, 9, 1440x900 
0x37CA2318, 38092263183820536, 225806573, 225806581, 8, 1440x900 
0x37CA2318, 38092263184479376, 225806638, 225806646, 8, 1440x900 
0x37CA2318, 38092263184952616, 225806682, 225806691, 9, 1440x900 
0x37CA2318, 38092263185802040, 225806768, 225806776, 8, 1440x900 
0x37CA2318, 38092263186456600, 225806838, 225806847, 9, 1440x900 
0x37CA2318, 38092263187127832, 225806902, 225806910, 8, 1440x900 
0x37CA2318, 38092263187593232, 225806948, 225806956, 8, 1440x900 
0x37CA2318, 38092263188458048, 225807037, 225807045, 8, 1440x900 
0x37CA2318, 38092263189120792, 225807102, 225807110, 8, 1440x900 
0x37CA2318, 38092263189771408, 225807164, 225807173, 9, 1440x900 
0x37CA2318, 38092263190245232, 225807213, 225807221, 8, 1440x900 
0x37CA2318, 38092263191101624, 225807298, 225807306, 8, 1440x900 
0x37CA2318, 38092263191763824, 225807367, 225807375, 8, 1440x900 
0x37CA2318, 38092263192387832, 225807429, 225807436, 7, 1440x900 
0x37CA2318, 38092263193085272, 225807497, 225807505, 8, 1440x900 
0x37CA2318, 38092263193746176, 225807562, 225807571, 9, 1440x900 
0x37CA2318, 38092263194408160, 225807633, 225807641, 8, 1440x900 
0x37CA2318, 38092263194893400, 225807678, 225807686, 8, 1440x900 
0x37CA2318, 38092263195730824, 225807762, 225807770, 8, 1440x900 
0x37CA2318, 38092263196383712, 225807829, 225807836, 7, 1440x900 
0x37CA2318, 38092263197046608, 225807892, 225807901, 9, 1440x900 
0x37CA2318, 38092263197522864, 225807943, 225807951, 8, 1440x900 
0x37CA2318, 38092263198387648, 225808028, 225808036, 8, 1440x900 
0x37CA2318, 38092263199046280, 225808093, 225808101, 8, 1440x900 
0x37CA2318, 38092263199707744, 225808162, 225808170, 8, 1440x900 
0x37CA2318, 38092263200171264, 225808207, 225808216, 9, 1440x900 
0x37CA2318, 38092263201028344, 225808293, 225808301, 8, 1440x900 
0x37CA2318, 38092263201679328, 225808357, 225808365, 8, 1440x900 
0x37CA2318, 38092263202330736, 225808422, 225808430, 8, 1440x900 
0x37CA2318, 38092263202812440, 225808473, 225808481, 8, 1440x900 
0x37CA2318, 38092263203662064, 225808553, 225808561, 8, 1440x900 
0x37CA2318, 38092263204323104, 225808622, 225808630, 8, 1440x900 
0x37CA2318, 38092263204884576, 225808676, 225808683, 7, 1440x900 
0x37CA2318, 38092263205638424, 225808752, 225808760, 8, 1440x900 
0x37CA2318, 38092263206307080, 225808822, 225808830, 8, 1440x900 
0x37CA2318, 38092263206967592, 225808883, 225808892, 9, 1440x900 
0x37CA2318, 38092263208296608, 225809018, 225809026, 8, 1440x900 
0x37CA2318, 38092263208958448, 225809083, 225809092, 9, 1440x900 
0x37CA2318, 38092263209619136, 225809153, 225809161, 8, 1440x900 
0x37CA2318, 38092263210093408, 225809198, 225809206, 8, 1440x900 
0x37CA2318, 38092263210938800, 225809282, 225809290, 8, 1440x900 
0x37CA2318, 38092263211611368, 225809348, 225809356, 8, 1440x900 
0x37CA2318, 38092263212269704, 225809417, 225809425, 8, 1440x900 
0x37CA2318, 38092263212736416, 225809462, 225809470, 8, 1440x900 
0x37CA2318, 38092263213584176, 225809548, 225809557, 9, 1440x900 
0x37CA2318, 38092263214251000, 225809612, 225809619, 7, 1440x900 
0x37CA2318, 38092263214927032, 225809682, 225809690, 8, 1440x900 
0x37CA2318, 38092263215578072, 225809748, 225809756, 8, 1440x900 
0x37CA2318, 38092263216243168, 225809813, 225809821, 8, 1440x900 
0x37CA2318, 38092263216902712, 225809877, 225809886, 9, 1440x900 
0x37CA2318, 38092263217418072, 225809933, 225809941, 8, 1440x900 
0x37CA2318, 38092263218217200, 225810008, 225810017, 9, 1440x900 
0x37CA2318, 38092263218878032, 225810077, 225810085, 8, 1440x900 
0x37CA2318, 38092263219540768, 225810142, 225810150, 8, 1440x900 
0x37CA2318, 38092263220015160, 225810192, 225810200, 8, 1440x900 
0x37CA2318, 38092263220865768, 225810278, 225810286, 8, 1440x900 
0x37CA2318, 38092263221524688, 225810343, 225810351, 8, 1440x900 
0x37CA2318, 38092263222182944, 225810407, 225810415, 8, 1440x900 
0x37CA2318, 38092263222657312, 225810453, 225810462, 9, 1440x900 
0x37CA2318, 38092263223511320, 225810538, 225810547, 9, 1440x900 
0x37CA2318, 38092263224161776, 225810607, 225810615, 8, 1440x900 
0x37CA2318, 38092263224824240, 225810673, 225810682, 9, 1440x900 
0x37CA2318, 38092263225291656, 225810713, 225810721, 8, 1440x900 
0x37CA2318, 38092263226147344, 225810801, 225810808, 7, 1440x900 
0x37CA2318, 38092263226809032, 225810873, 225810881, 8, 1440x900 
0x37CA2318, 38092263227426296, 225810933, 225810941, 8, 1440x900 
0x37CA2318, 38092263228124144, 225811002, 225811011, 9, 1440x900 
0x37CA2318, 38092263228794744, 225811067, 225811075, 8, 1440x900 
0x37CA2318, 38092263229446192, 225811133, 225811141, 8, 1440x900 
0x37CA2318, 38092263229928968, 225811184, 225811192, 8, 1440x900 
0x37CA2318, 38092263230768976, 225811267, 225811275, 8, 1440x900 
0x37CA2318, 38092263231421768, 225811333, 225811341, 8, 1440x900 
0x37CA2318, 38092263232094272, 225811398, 225811406, 8, 1440x900 
0x37CA2318, 38092263232568608, 225811447, 225811455, 8, 1440x900 
0x37CA2318, 38092263233417440, 225811533, 225811541, 8, 1440x900 
0x37CA2318, 38092263234077232, 225811597, 225811605, 8, 1440x900 
0x37CA2318, 38092263234739000, 225811667, 225811675, 8, 1440x900 
0x37CA2318, 38092263235210240, 225811709, 225811718, 9, 1440x900 
0x37CA2318, 38092263236052144, 225811792, 225811800, 8, 1440x900 
0x37CA2318, 38092263236722392, 225811858, 225811865, 7, 1440x900 
0x37CA2318, 38092263237380720, 225811926, 225811934, 8, 1440x900 
0x37CA2318, 38092263237848376, 225811972, 225811980, 8, 1440x900 
0x37CA2318, 38092263238703056, 225812057, 225812065, 8, 1440x900 
0x37CA2318, 38092263239357056, 225812127, 225812135, 8, 1440x900 
0x37CA2318, 38092263239951520, 225812182, 225812191, 9, 1440x900 
0x37CA2318, 38092263240680840, 225812257, 225812265, 8, 1440x900 
0x37CA2318, 38092263241342976, 225812323, 225812331, 8, 1440x900 
0x37CA2318, 38092263241995456, 225812393, 225812400, 7, 1440x900 
0x37CA2318, 38092263242479320, 225812438, 225812446, 8, 1440x900 
0x37CA2318, 38092263243318960, 225812523, 225812531, 8, 1440x900 
0x37CA2318, 38092263243987920, 225812587, 225812595, 8, 1440x900 
0x37CA2318, 38092263244640128, 225812653, 225812661, 8, 1440x900 
0x37CA2318, 38092263245118048, 225812702, 225812710, 8, 1440x900 
0x37CA2318, 38092263245964656, 225812789, 225812797, 8, 1440x900 
0x37CA2318, 38092263246635616, 225812852, 225812860, 8, 1440x900 
0x37CA2318, 38092263247289008, 225812917, 225812925, 8, 1440x900 
0x37CA2318, 38092263247764104, 225812967, 225812975, 8, 1440x900 
0x37CA2318, 38092263248609760, 225813047, 225813056, 9, 1440x900 
0x37CA2318, 38092263249272688, 225813113, 225813122, 9, 1440x900 
0x37CA2318, 38092263249955576, 225813182, 225813191, 9, 1440x900 
0x37CA2318, 38092263250594320, 225813248, 225813255, 7, 1440x900 
0x37CA2318, 38092263251263008, 225813313, 225813322, 9, 1440x900 
0x37CA2318, 38092263251919776, 225813382, 225813390, 8, 1440x900 
0x37CA2318, 38092263252455440, 225813437, 225813445, 8, 1440x900 
0x37CA2318, 38092263253243000, 225813513, 225813521, 8, 1440x900 
0x37CA2318, 38092263253892776, 225813574, 225813582, 8, 1440x900 
0x37CA2318, 38092263254555368, 225813642, 225813650, 8, 1440x900 
0x37CA2318, 38092263255035584, 225813693, 225813701, 8, 1440x900 
0x37CA2318, 38092263255885784, 225813777, 225813784, 7, 1440x900 
0x37CA2318, 38092263256545616, 225813842, 225813850, 8, 1440x900 
0x37CA2318, 38092263257206616, 225813908, 225813917, 9, 1440x900 
0x37CA2318, 38092263257673344, 225813953, 225813960, 7, 1440x900 
0x37CA2318, 38092263258526640, 225814043, 225814051, 8, 1440x900 
0x37CA2318, 38092263259188416, 225814108, 225814116, 8, 1440x900 
0x37CA2318, 38092263259841656, 225814173, 225814182, 9, 1440x900 
0x37CA2318, 38092263260319984, 225814223, 225814231, 8, 1440x900 
0x37CA2318, 38092263261167264, 225814308, 225814316, 8, 1440x900 
0x37CA2318, 38092263261835584, 225814372, 225814380, 8, 1440x900 
0x37CA2318, 38092263262469112, 225814438, 225814446, 8, 1440x900 
0x37CA2318, 38092263263156352, 225814503, 225814512, 9, 1440x900 
0x37CA2318, 38092263263809456, 225814568, 225814576, 8, 1440x900 
0x37CA2318, 38092263264467432, 225814633, 225814640, 7, 1440x900 
0x37CA2318, 38092263265805104, 225814773, 225814781, 8, 1440x900 
0x37CA2318, 38092263266465576, 225814834, 225814842, 8, 1440x900 
0x37CA2318, 38092263267126912, 225814903, 225814911, 8, 1440x900 
0x37CA2318, 38092263267588008, 225814948, 225814956, 8, 1440x900 
0x37CA2318, 38092263268430056, 225815033, 225815041, 8, 1440x900 
0x37CA2318, 38092263269091624, 225815097, 225815105, 8, 1440x900 
0x37CA2318, 38092263269762488, 225815163, 225815171, 8, 1440x900 
0x37CA2318, 38092263270228984, 225815212, 225815221, 9, 1440x900 
0x37CA2318, 38092263271087128, 225815297, 225815305, 8, 1440x900 
0x37CA2318, 38092263271741104, 225815363, 225815371, 8, 1440x900 
0x37CA2318, 38092263272400296, 225815432, 225815440, 8, 1440x900 
0x37CA2318, 38092263272870280, 225815478, 225815486, 8, 1440x900 
0x37CA2318, 38092263273724168, 225815563, 225815571, 8, 1440x900 
0x37CA2318, 38092263274378360, 225815627, 225815635, 8, 1440x900 
0x37CA2318, 38092263274989472, 225815687, 225815695, 8, 1440x900 
0x37CA2318, 38092263275706768, 225815758, 225815767, 9, 1440x900 
0x37CA2318, 38092263276366912, 225815824, 225815833, 9, 1440x900 
0x37CA2318, 38092263277047272, 225815892, 225815900, 8, 1440x900 
0x37CA2318, 38092263277513088, 225815943, 225815951, 8, 1440x900 
0x37CA2318, 38092263278359008, 225816028, 225816036, 8, 1440x900 
0x37CA2318, 38092263279030088, 225816093, 225816101, 8, 1440x900 
0x37CA2318, 38092263279680320, 225816153, 225816161, 8, 1440x900 
0x37CA2318, 38092263280146400, 225816202, 225816210, 8, 1440x900 
0x37CA2318, 38092263280994880, 225816287, 225816296, 9, 1440x900 
0x37CA2318, 38092263281656784, 225816357, 225816365, 8, 1440x900 
0x37CA2318, 38092263282328256, 225816423, 225816431, 8, 1440x900 
0x37CA2318, 38092263282794016, 225816468, 225816476, 8, 1440x900 
0x37CA2318, 38092263283640936, 225816552, 225816560, 8, 1440x900 
0x37CA2318, 38092263284311568, 225816623, 225816631, 8, 1440x900 
0x37CA2318, 38092263284971096, 225816687, 225816695, 8, 1440x900 
0x37CA2318, 38092263285432088, 225816733, 225816741, 8, 1440x900 
0x37CA2318, 38092263286286496, 225816821, 225816828, 7, 1440x900 
0x37CA2318, 38092263286946864, 225816883, 225816891, 8, 1440x900 
0x37CA2318, 38092263287494344, 225816938, 225816946, 8, 1440x900 
0x37CA2318, 38092263288254408, 225817014, 225817022, 8, 1440x900 
0x37CA2318, 38092263288925872, 225817083, 225817091, 8, 1440x900 
0x37CA2318, 38092263289585712, 225817148, 225817156, 8, 1440x900 
0x37CA2318, 38092263290058432, 225817198, 225817206, 8, 1440x900 
0x37CA2318, 38092263290902096, 225817278, 225817286, 8, 1440x900 
0x37CA2318, 38092263291572440, 225817342, 225817350, 8, 1440x900 
0x37CA2318, 38092263292233552, 225817409, 225817416, 7, 1440x900 
0x37CA2318, 38092263292698456, 225817457, 225817464, 7, 1440x900 
0x37CA2318, 38092263293548160, 225817541, 225817549, 8, 1440x900 
0x37CA2318, 38092263294218176, 225817607, 225817615, 8, 1440x900 
0x37CA2318, 38092263294820976, 225817667, 225817675, 8, 1440x900 
0x37CA2318, 38092263295539656, 225817738, 225817746, 8, 1440x900 
0x37CA2318, 38092263296201128, 225817807, 225817815, 8, 1440x900 
0x37CA2318, 38092263296862664, 225817873, 225817881, 8, 1440x900 
0x37CA2318, 38092263297506384, 225817938, 225817946, 8, 1440x900 
0x37CA2318, 38092263298202504, 225818007, 225818016, 9, 1440x900 
0x37CA2318, 38092263298853432, 225818078, 225818086, 8, 1440x900 
0x37CA2318, 38092263299512968, 225818142, 225818151, 9, 1440x900 
0x37CA2318, 38092263299987600, 225818187, 225818195, 8, 1440x900 
0x37CA2318, 38092263300842272, 225818273, 225818281, 8, 1440x900 
0x37CA2318, 38092263301511944, 225818338, 225818347, 9, 1440x900 
0x37CA2318, 38092263302162768, 225818403, 225818412, 9, 1440x900 
0x37CA2318, 38092263302635288, 225818453, 225818461, 8, 1440x900 
0x37CA2318, 38092263303490728, 225818537, 225818546, 9, 1440x900 
0x37CA2318, 38092263304155464, 225818607, 225818615, 8, 1440x900 
0x37CA2318, 38092263304813488, 225818673, 225818681, 8, 1440x900 
0x37CA2318, 38092263305278744, 225818718, 225818726, 8, 1440x900 
0x37CA2318, 38092263306135376, 225818802, 225818810, 8, 1440x900 
0x37CA2318, 38092263306806816, 225818872, 225818880, 8, 1440x900 
0x37CA2318, 38092263307457664, 225818937, 225818945, 8, 1440x900 
0x37CA2318, 38092263307930368, 225818983, 225818991, 8, 1440x900 
0x37CA2318, 38092263308778112, 225819067, 225819075, 8, 1440x900 
0x37CA2318, 38092263309440304, 225819132, 225819141, 9, 1440x900 
0x37CA2318, 38092263309911616, 225819183, 225819191, 8, 1440x900 
0x37CA2318, 38092263310768664, 225819263, 225819270, 7, 1440x900 
0x37CA2318, 38092263311421048, 225819328, 225819335, 7, 1440x900 
0x37CA2318, 38092263312081512, 225819397, 225819405, 8, 1440x900 
0x37CA2318, 38092263312555072, 225819442, 225819451, 9, 1440x900 
0x37CA2318, 38092263313402304, 225819532, 225819540, 8, 1440x900 
0x37CA2318, 38092263314053024, 225819592, 225819600, 8, 1440x900 
0x37CA2318, 38092263314732912, 225819663, 225819671, 8, 1440x900 
0x37CA2318, 38092263315195904, 225819707, 225819715, 8, 1440x900 
0x37CA2318, 38092263316046440, 225819792, 225819800, 8, 1440x900 
0x37CA2318, 38092263316699848, 225819857, 225819866, 9, 1440x900 
0x37CA2318, 38092263317350176, 225819922, 225819930, 8, 1440x900 
0x37CA2318, 38092263318032544, 225819988, 225819996, 8, 1440x900 
0x37CA2318, 38092263318691008, 225820056, 225820064, 8, 1440x900 
0x37CA2318, 38092263319354784, 225820124, 225820132, 8, 1440x900 
0x37CA2318, 38092263319863000, 225820177, 225820185, 8, 1440x900 
0x37CA2318, 38092263320681472, 225820257, 225820266, 9, 1440x900 
0x37CA2318, 38092263321332792, 225820318, 225820326, 8, 1440x900 
0x37CA2318, 38092263321994368, 225820388, 225820397, 9, 1440x900 
0x37CA2318, 38092263323321248, 225820523, 225820531, 8, 1440x900 
0x37CA2318, 38092263323976728, 225820587, 225820595, 8, 1440x900 
0x37CA2318, 38092263324646480, 225820652, 225820661, 9, 1440x900 
0x37CA2318, 38092263325115784, 225820701, 225820709, 8, 1440x900 
0x37CA2318, 38092263325967392, 225820788, 225820796, 8, 1440x900 
0x37CA2318, 38092263326628640, 225820853, 225820861, 8, 1440x900 
0x37CA2318, 38092263327208504, 225820914, 225820923, 9, 1440x900 
0x37CA2318, 38092263327760760, 225820963, 225820971, 8, 1440x900 
0x37CA2318, 38092263328415128, 225821033, 225821041, 8, 1440x900 
0x37CA2318, 38092263329075320, 225821098, 225821106, 8, 1440x900 
0x37CA2318, 38092263329738560, 225821162, 225821171, 9, 1440x900 
0x37CA2318, 38092263330400824, 225821227, 225821234, 7, 1440x900 
0x37CA2318, 38092263331055600, 225821292, 225821300, 8, 1440x900 
0x37CA2318, 38092263331714000, 225821358, 225821365, 7, 1440x900 
0x37CA2318, 38092263332381464, 225821424, 225821432, 8, 1440x900 
0x37CA2318, 38092263333047008, 225821493, 225821500, 7, 1440x900 
0x37CA2318, 38092263333702192, 225821557, 225821564, 7, 1440x900 
0x37CA2318, 38092263334365904, 225821627, 225821635, 8, 1440x900 
0x37CA2318, 38092263335035200, 225821692, 225821700, 8, 1440x900 
0x37CA2318, 38092263335699872, 225821758, 225821766, 8, 1440x900 
0x37CA2318, 38092263336356184, 225821823, 225821831, 8, 1440x900 
0x37CA2318, 38092263337203656, 225821907, 225821916, 9, 1440x900 
0x37CA2318, 38092263337687256, 225821958, 225821966, 8, 1440x900 
0x37CA2318, 38092263338534040, 225822044, 225822053, 9, 1440x900 
0x37CA2318, 38092263339032576, 225822092, 225822099, 7, 1440x900 
0x37CA2318, 38092263339673104, 225822152, 225822160, 8, 1440x900 
0x37CA2318, 38092263340326680, 225822218, 225822226, 8, 1440x900 
0x37CA2318, 38092263340991672, 225822283, 225822291, 8, 1440x900 
0x37CA2318, 38092263341654832, 225822352, 225822359, 7, 1440x900 
0x37CA2318, 38092263342316384, 225822417, 225822425, 8, 1440x900 
0x37CA2318, 38092263342975320, 225822483, 225822491, 8, 1440x900 
0x37CA2318, 38092263343645880, 225822553, 225822563, 10, 1440x900 
0x37CA2318, 38092263344301328, 225822618, 225822626, 8, 1440x900 
0x37CA2318, 38092263344959272, 225822682, 225822690, 8, 1440x900 
0x37CA2318, 38092263345625384, 225822753, 225822761, 8, 1440x900 
0x37CA2318, 38092263346285336, 225822818, 225822826, 8, 1440x900 
0x37CA2318, 38092263346941224, 225822881, 225822889, 8, 1440x900 
0x37CA2318, 38092263347602912, 225822947, 225822955, 8, 1440x900 
0x37CA2318, 38092263348254128, 225823013, 225823021, 8, 1440x900 
0x37CA2318, 38092263348919728, 225823078, 225823086, 8, 1440x900 
0x37CA2318, 38092263349771736, 225823163, 225823171, 8, 1440x900 
0x37CA2318, 38092263350438640, 225823233, 225823241, 8, 1440x900 
0x37CA2318, 38092263351091072, 225823298, 225823306, 8, 1440x900 
0x37CA2318, 38092263351564048, 225823347, 225823355, 8, 1440x900 
0x37CA2318, 38092263352425784, 225823432, 225823440, 8, 1440x900 
0x37CA2318, 38092263353070168, 225823498, 225823506, 8, 1440x900 
0x37CA2318, 38092263353714400, 225823557, 225823564, 7, 1440x900 
0x37CA2318, 38092263354401824, 225823626, 225823633, 7, 1440x900 
0x37CA2318, 38092263355052544, 225823691, 225823698, 7, 1440x900 
0x37CA2318, 38092263355716384, 225823758, 225823765, 7, 1440x900 
0x37CA2318, 38092263356185176, 225823807, 225823814, 7, 1440x900 
0x37CA2318, 38092263356856744, 225823872, 225823880, 8, 1440x900 
0x37CA2318, 38092263357514992, 225823942, 225823950, 8, 1440x900 
0x37CA2318, 38092263358176104, 225824007, 225824015, 8, 1440x900 
0x37CA2318, 38092263358842984, 225824073, 225824082, 9, 1440x900 
0x37CA2318, 38092263359512064, 225824143, 225824153, 10, 1440x900 
0x37CA2318, 38092263360155864, 225824207, 225824215, 8, 1440x900 
0x37CA2318, 38092263360818768, 225824273, 225824281, 8, 1440x900 
0x37CA2318, 38092263361484448, 225824337, 225824345, 8, 1440x900 
0x37CA2318, 38092263362136696, 225824406, 225824414, 8, 1440x900 
0x37CA2318, 38092263362792808, 225824463, 225824471, 8, 1440x900 
0x37CA2318, 38092263363453152, 225824533, 225824541, 8, 1440x900 
0x37CA2318, 38092263364127008, 225824601, 225824610, 9, 1440x900 
0x37CA2318, 38092263364773040, 225824662, 225824670, 8, 1440x900 
0x37CA2318, 38092263365434616, 225824728, 225824736, 8, 1440x900 
0x37CA2318, 38092263366294896, 225824818, 225824826, 8, 1440x900 
0x37CA2318, 38092263366760472, 225824862, 225824870, 8, 1440x900 
0x37CA2318, 38092263367423760, 225824933, 225824941, 8, 1440x900 
0x37CA2318, 38092263368099040, 225824998, 225825006, 8, 1440x900 
0x37CA2318, 38092263368754072, 225825062, 225825070, 8, 1440x900 
0x37CA2318, 38092263369409696, 225825127, 225825134, 7, 1440x900 
0x37CA2318, 38092263370069872, 225825193, 225825200, 7, 1440x900 
0x37CA2318, 38092263370732568, 225825262, 225825270, 8, 1440x900 
0x37CA2318, 38092263371401696, 225825328, 225825336, 8, 1440x900 
0x37CA2318, 38092263372053184, 225825398, 225825406, 8, 1440x900 
0x37CA2318, 38092263372710416, 225825458, 225825465, 7, 1440x900 
0x37CA2318, 38092263373371376, 225825524, 225825532, 8, 1440x900 
0x37CA2318, 38092263374043368, 225825597, 225825605, 8, 1440x900 
0x37CA2318, 38092263374694448, 225825658, 225825666, 8, 1440x900 
0x37CA2318, 38092263375352512, 225825722, 225825729, 7, 1440x900 
0x37CA2318, 38092263376099280, 225825797, 225825806, 9, 1440x900 
0x37CA2318, 38092263376675304, 225825858, 225825866, 8, 1440x900 
0x37CA2318, 38092263377332592, 225825917, 225825925, 8, 1440x900 
0x37CA2318, 38092263377993144, 225825987, 225825994, 7, 1440x900 
0x37CA2318, 38092263378663896, 225826057, 225826065, 8, 1440x900 
0x37CA2318, 38092263379976640, 225826187, 225826195, 8, 1440x900 
0x37CA2318, 38092263380643128, 225826253, 225826262, 9, 1440x900 
0x37CA2318, 38092263381310352, 225826323, 225826331, 8, 1440x900 
0x37CA2318, 38092263381964168, 225826387, 225826395, 8, 1440x900 
0x37CA2318, 38092263382633816, 225826453, 225826461, 8, 1440x900 
0x37CA2318, 38092263383286200, 225826518, 225826527, 9, 1440x900 
0x37CA2318, 38092263383953464, 225826583, 225826592, 9, 1440x900 
0x37CA2318, 38092263384606368, 225826649, 225826658, 9, 1440x900 
0x37CA2318, 38092263385263840, 225826713, 225826720, 7, 1440x900 
0x37CA2318, 38092263386016528, 225826787, 225826798, 11, 1440x900 
0x37CA2318, 38092263386605256, 225826848, 225826857, 9, 1440x900 
0x37CA2318, 38092263387248288, 225826917, 225826925, 8, 1440x900 
0x37CA2318, 38092263387922592, 225826983, 225826991, 8, 1440x900 
0x37CA2318, 38092263388583000, 225827046, 225827054, 8, 1440x900 
0x37CA2318, 38092263389245744, 225827113, 225827121, 8, 1440x900 
0x37CA2318, 38092263389905792, 225827183, 225827191, 8, 1440x900 
0x37CA2318, 38092263390569432, 225827248, 225827256, 8, 1440x900 
0x37CA2318, 38092263391229472, 225827313, 225827321, 8, 1440x900 
0x37CA2318, 38092263391888752, 225827377, 225827385, 8, 1440x900 
0x37CA2318, 38092263392544864, 225827443, 225827451, 8, 1440x900 
0x37CA2318, 38092263393204784, 225827508, 225827515, 7, 1440x900 
0x37CA2318, 38092263393863960, 225827573, 225827581, 8, 1440x900 
0x37CA2318, 38092263394714784, 225827658, 225827666, 8, 1440x900 
0x37CA2318, 38092263395367768, 225827724, 225827731, 7, 1440x900 
0x37CA2318, 38092263395837536, 225827768, 225827776, 8, 1440x900 
0x37CA2318, 38092263396499232, 225827837, 225827845, 8, 1440x900 
0x37CA2318, 38092263397156904, 225827901, 225827909, 8, 1440x900 
0x37CA2318, 38092263397816912, 225827968, 225827975, 7, 1440x900 
0x37CA2318, 38092263398477568, 225828034, 225828042, 8, 1440x900 
0x37CA2318, 38092263399141680, 225828102, 225828110, 8, 1440x900 
0x37CA2318, 38092263399989984, 225828187, 225828195, 8, 1440x900 
0x37CA2318, 38092263400465216, 225828238, 225828246, 8, 1440x900 
0x37CA2318, 38092263401131464, 225828303, 225828311, 8, 1440x900 
0x37CA2318, 38092263401786008, 225828367, 225828376, 9, 1440x900 
0x37CA2318, 38092263402446344, 225828433, 225828441, 8, 1440x900 
0x37CA2318, 38092263403107312, 225828502, 225828510, 8, 1440x900 
0x37CA2318, 38092263403775064, 225828567, 225828576, 9, 1440x900 
0x37CA2318, 38092263404623680, 225828653, 225828661, 8, 1440x900 
0x37CA2318, 38092263405096960, 225828698, 225828706, 8, 1440x900 
0x37CA2318, 38092263405747392, 225828762, 225828770, 8, 1440x900 
0x37CA2318, 38092263406412544, 225828828, 225828835, 7, 1440x900 
0x37CA2318, 38092263407068200, 225828892, 225828900, 8, 1440x900 
0x37CA2318, 38092263407728320, 225828958, 225828967, 9, 1440x900 
0x37CA2318, 38092263408388384, 225829023, 225829032, 9, 1440x900 
0x37CA2318, 38092263409053720, 225829093, 225829101, 8, 1440x900 
0x37CA2318, 38092263409709088, 225829157, 225829165, 8, 1440x900 
0x37CA2318, 38092263410370584, 225829223, 225829231, 8, 1440x900 
0x37CA2318, 38092263411037360, 225829292, 225829300, 8, 1440x900 
0x37CA2318, 38092263411690592, 225829357, 225829365, 8, 1440x900 
0x37CA2318, 38092263412553800, 225829448, 225829455, 7, 1440x900 
0x37CA2318, 38092263413213832, 225829513, 225829522, 9, 1440x900 
0x37CA2318, 38092263413679928, 225829559, 225829566, 7, 1440x900 
0x37CA2318, 38092263414331320, 225829619, 225829627, 8, 1440x900 
0x37CA2318, 38092263414990776, 225829686, 225829694, 8, 1440x900 
0x37CA2318, 38092263415847360, 225829773, 225829782, 9, 1440x900 
0x37CA2318, 38092263416321000, 225829822, 225829830, 8, 1440x900 
0x37CA2318, 38092263417178760, 225829906, 225829914, 8, 1440x900 
0x37CA2318, 38092263417837872, 225829973, 225829981, 8, 1440x900 
0x37CA2318, 38092263418408368, 225830032, 225830040, 8, 1440x900 
0x37CA2318, 38092263418963848, 225830083, 225830090, 7, 1440x900 
0x37CA2318, 38092263419613440, 225830147, 225830155, 8, 1440x900 
0x37CA2318, 38092263420273056, 225830212, 225830221, 9, 1440x900 
0x37CA2318, 38092263420933840, 225830278, 225830287, 9, 1440x900 
0x37CA2318, 38092263421598584, 225830343, 225830352, 9, 1440x900 
0x37CA2318, 38092263422253624, 225830412, 225830419, 7, 1440x900 
0x37CA2318, 38092263422913848, 225830478, 225830485, 7, 1440x900 
0x37CA2318, 38092263423577912, 225830543, 225830551, 8, 1440x900 
0x37CA2318, 38092263424425744, 225830628, 225830636, 8, 1440x900 
0x37CA2318, 38092263425105008, 225830697, 225830704, 7, 1440x900 
0x37CA2318, 38092263425562072, 225830748, 225830756, 8, 1440x900 
0x37CA2318, 38092263426228680, 225830813, 225830821, 8, 1440x900 
0x37CA2318, 38092263426969264, 225830888, 225830896, 8, 1440x900 
0x37CA2318, 38092263427542272, 225830942, 225830950, 8, 1440x900 
0x37CA2318, 38092263428397744, 225831030, 225831038, 8, 1440x900 
0x37CA2318, 38092263428869472, 225831078, 225831086, 8, 1440x900 
0x37CA2318, 38092263429528768, 225831138, 225831146, 8, 1440x900 
0x37CA2318, 38092263430180944, 225831208, 225831214, 6, 1440x900 
0x37CA2318, 38092263430849440, 225831272, 225831280, 8, 1440x900 
0x37CA2318, 38092263431507968, 225831337, 225831344, 7, 1440x900 
0x37CA2318, 38092263432170288, 225831408, 225831416, 8, 1440x900 
0x37CA2318, 38092263432833056, 225831478, 225831486, 8, 1440x900 
0x37CA2318, 38092263433501224, 225831543, 225831551, 8, 1440x900 
0x37CA2318, 38092263434178912, 225831607, 225831616, 9, 1440x900 
0x37CA2318, 38092263434856824, 225831675, 225831684, 9, 1440x900 
0x37CA2318, 38092263435479624, 225831738, 225831745, 7, 1440x900 
0x37CA2318, 38092263436147576, 225831802, 225831809, 7, 1440x900 
0x37CA2318, 38092263436811808, 225831868, 225831876, 8, 1440x900 
0x37CA2318, 38092263437469368, 225831933, 225831941, 8, 1440x900 
0x37CA2318, 38092263438127184, 225831999, 225832008, 9, 1440x900 
0x37CA2318, 38092263438783496, 225832063, 225832071, 8, 1440x900 
0x37CA2318, 38092263439439552, 225832128, 225832137, 9, 1440x900 
0x37CA2318, 38092263440109448, 225832198, 225832206, 8, 1440x900 
0x37CA2318, 38092263440962904, 225832283, 225832291, 8, 1440x900 
0x37CA2318, 38092263441618432, 225832348, 225832355, 7, 1440x900 
0x37CA2318, 38092263442082208, 225832393, 225832401, 8, 1440x900 
0x37CA2318, 38092263442931688, 225832477, 225832485, 8, 1440x900 
0x37CA2318, 38092263443608512, 225832552, 225832560, 8, 1440x900 
0x37CA2318, 38092263444259808, 225832613, 225832622, 9, 1440x900 
0x37CA2318, 38092263444743352, 225832663, 225832671, 8, 1440x900 
0x37CA2318, 38092263445591944, 225832748, 225832757, 9, 1440x900 
0x37CA2318, 38092263446058176, 225832798, 225832806, 8, 1440x900 
0x37CA2318, 38092263446719760, 225832863, 225832871, 8, 1440x900 
0x37CA2318, 38092263447394960, 225832927, 225832935, 8, 1440x900 
0x37CA2318, 38092263448707528, 225833057, 225833064, 7, 1440x900 
0x37CA2318, 38092263449365200, 225833123, 225833130, 7, 1440x900 
0x37CA2318, 38092263450035144, 225833193, 225833201, 8, 1440x900 
0x37CA2318, 38092263450688536, 225833258, 225833266, 8, 1440x900 
0x37CA2318, 38092263451348432, 225833323, 225833330, 7, 1440x900 
0x37CA2318, 38092263452024120, 225833392, 225833400, 8, 1440x900 
0x37CA2318, 38092263452668960, 225833453, 225833462, 9, 1440x900 
0x37CA2318, 38092263453328496, 225833523, 225833531, 8, 1440x900 
0x37CA2318, 38092263453990736, 225833589, 225833597, 8, 1440x900 
0x37CA2318, 38092263454657640, 225833653, 225833662, 9, 1440x900 
0x37CA2318, 38092263455310632, 225833722, 225833730, 8, 1440x900 
0x37CA2318, 38092263455969696, 225833787, 225833795, 8, 1440x900 
0x37CA2318, 38092263456629568, 225833853, 225833861, 8, 1440x900 
0x37CA2318, 38092263457295920, 225833918, 225833926, 8, 1440x900 
0x37CA2318, 38092263457950048, 225833983, 225833991, 8, 1440x900 
0x37CA2318, 38092263458648712, 225834057, 225834065, 8, 1440x900 
0x37CA2318, 38092263459275616, 225834118, 225834127, 9, 1440x900 
0x37CA2318, 38092263459942152, 225834182, 225834190, 8, 1440x900 
0x37CA2318, 38092263460592976, 225834247, 225834255, 8, 1440x900 
0x37CA2318, 38092263461453408, 225834333, 225834341, 8, 1440x900 
0x37CA2318, 38092263462026872, 225834392, 225834400, 8, 1440x900 
0x37CA2318, 38092263462577312, 225834448, 225834456, 8, 1440x900 
0x37CA2318, 38092263463442688, 225834532, 225834541, 9, 1440x900 
0x37CA2318, 38092263463899368, 225834579, 225834587, 8, 1440x900 
0x37CA2318, 38092263464570008, 225834647, 225834655, 8, 1440x900 
0x37CA2318, 38092263465222416, 225834712, 225834720, 8, 1440x900 
0x37CA2318, 38092263465879184, 225834778, 225834786, 8, 1440x900 
0x37CA2318, 38092263466537072, 225834841, 225834849, 8, 1440x900 
0x37CA2318, 38092263467206192, 225834907, 225834915, 8, 1440x900 
0x37CA2318, 38092263467857128, 225834972, 225834980, 8, 1440x900 
0x37CA2318, 38092263468519120, 225835037, 225835046, 9, 1440x900 
0x37CA2318, 38092263469177328, 225835106, 225835114, 8, 1440x900 
0x37CA2318, 38092263469844928, 225835172, 225835180, 8, 1440x900 
0x37CA2318, 38092263470510512, 225835238, 225835246, 8, 1440x900 
0x37CA2318, 38092263471357408, 225835328, 225835336, 8, 1440x900 
0x37CA2318, 38092263471889048, 225835378, 225835386, 8, 1440x900 
0x37CA2318, 38092263472496016, 225835438, 225835446, 8, 1440x900 
0x37CA2318, 38092263473354384, 225835523, 225835532, 9, 1440x900 
0x37CA2318, 38092263474007888, 225835588, 225835597, 9, 1440x900 
0x37CA2318, 38092263474477664, 225835638, 225835646, 8, 1440x900 
0x37CA2318, 38092263475136896, 225835703, 225835711, 8, 1440x900 
0x37CA2318, 38092263476002840, 225835792, 225835800, 8, 1440x900 
0x37CA2318, 38092263476654416, 225835858, 225835866, 8, 1440x900 
0x37CA2318, 38092263477130712, 225835904, 225835912, 8, 1440x900 
0x37CA2318, 38092263477976152, 225835987, 225835995, 8, 1440x900 
0x37CA2318, 38092263478628640, 225836053, 225836061, 8, 1440x900 
0x37CA2318, 38092263479299424, 225836117, 225836125, 8, 1440x900 
0x37CA2318, 38092263479769904, 225836163, 225836171, 8, 1440x900 
0x37CA2318, 38092263480643584, 225836254, 225836263, 9, 1440x900 
0x37CA2318, 38092263481121792, 225836303, 225836311, 8, 1440x900 
0x37CA2318, 38092263481942992, 225836383, 225836391, 8, 1440x900 
0x37CA2318, 38092263482406232, 225836428, 225836437, 9, 1440x900 
0x37CA2318, 38092263483118336, 225836498, 225836506, 8, 1440x900 
0x37CA2318, 38092263483734656, 225836561, 225836570, 9, 1440x900 
0x37CA2318, 38092263484416704, 225836627, 225836635, 8, 1440x900 
0x37CA2318, 38092263485047984, 225836691, 225836698, 7, 1440x900 
0x37CA2318, 38092263485710752, 225836757, 225836765, 8, 1440x900 
0x37CA2318, 38092263486374344, 225836823, 225836830, 7, 1440x900 
0x37CA2318, 38092263487033584, 225836889, 225836897, 8, 1440x900 
0x37CA2318, 38092263487691608, 225836958, 225836967, 9, 1440x900 
0x37CA2318, 38092263488357024, 225837023, 225837031, 8, 1440x900 
0x37CA2318, 38092263489212808, 225837112, 225837120, 8, 1440x900 
0x37CA2318, 38092263489872432, 225837173, 225837179, 6, 1440x900 
0x37CA2318, 38092263490535952, 225837238, 225837246, 8, 1440x900 
0x37CA2318, 38092263491202608, 225837306, 225837313, 7, 1440x900 
0x37CA2318, 38092263491760864, 225837361, 225837368, 7, 1440x900 
0x37CA2318, 38092263492317656, 225837418, 225837425, 7, 1440x900 
0x37CA2318, 38092263492992880, 225837487, 225837496, 9, 1440x900 
0x37CA2318, 38092263493641744, 225837553, 225837562, 9, 1440x900 
0x37CA2318, 38092263494307344, 225837619, 225837628, 9, 1440x900 
0x37CA2318, 38092263494964624, 225837688, 225837696, 8, 1440x900 
0x37CA2318, 38092263495626976, 225837752, 225837760, 8, 1440x900 
0x37CA2318, 38092263496283224, 225837817, 225837825, 8, 1440x900 
0x37CA2318, 38092263496943960, 225837887, 225837895, 8, 1440x900 
0x37CA2318, 38092263497608224, 225837947, 225837957, 10, 1440x900 
0x37CA2318, 38092263498271472, 225838018, 225838026, 8, 1440x900 
0x37CA2318, 38092263498925496, 225838083, 225838092, 9, 1440x900 
0x37CA2318, 38092263499591776, 225838147, 225838156, 9, 1440x900 
0x37CA2318, 38092263500253768, 225838213, 225838221, 8, 1440x900 
0x37CA2318, 38092263500917336, 225838278, 225838287, 9, 1440x900 
0x37CA2318, 38092263501573168, 225838343, 225838351, 8, 1440x900 
0x37CA2318, 38092263502233408, 225838412, 225838419, 7, 1440x900 
0x37CA2318, 38092263502895088, 225838478, 225838485, 7, 1440x900 
0x37CA2318, 38092263503560312, 225838542, 225838551, 9, 1440x900 
0x37CA2318, 38092263504215816, 225838607, 225838615, 8, 1440x900 
0x37CA2318, 38092263504879080, 225838673, 225838681, 8, 1440x900 
0x37CA2318, 38092263505542896, 225838742, 225838749, 7, 1440x900 
0x37CA2318, 38092263506204832, 225838806, 225838813, 7, 1440x900 
0x37CA2318, 38092263506861304, 225838872, 225838879, 7, 1440x900 
0x37CA2318, 38092263507523256, 225838938, 225838946, 8, 1440x900 
0x37CA2318, 38092263508188224, 225839006, 225839013, 7, 1440x900 
0x37CA2318, 38092263508845056, 225839072, 225839079, 7, 1440x900 
0x37CA2318, 38092263509508232, 225839142, 225839150, 8, 1440x900 
0x37CA2318, 38092263510167552, 225839208, 225839215, 7, 1440x900 
0x37CA2318, 38092263510835240, 225839274, 225839281, 7, 1440x900 
0x37CA2318, 38092263511687984, 225839357, 225839365, 8, 1440x900 
0x37CA2318, 38092263512349624, 225839422, 225839431, 9, 1440x900 
0x37CA2318, 38092263513000912, 225839488, 225839496, 8, 1440x900 
0x37CA2318, 38092263513485008, 225839538, 225839546, 8, 1440x900 
0x37CA2318, 38092263514339000, 225839622, 225839630, 8, 1440x900 
0x37CA2318, 38092263514999384, 225839687, 225839695, 8, 1440x900 
0x37CA2318, 38092263515602640, 225839747, 225839754, 7, 1440x900 
0x37CA2318, 38092263516121072, 225839798, 225839806, 8, 1440x900 
0x37CA2318, 38092263517441128, 225839932, 225839939, 7, 1440x900 
0x37CA2318, 38092263518111864, 225839997, 225840005, 8, 1440x900 
0x37CA2318, 38092263518772040, 225840063, 225840071, 8, 1440x900 
0x37CA2318, 38092263519434408, 225840133, 225840141, 8, 1440x900 
0x37CA2318, 38092263520094768, 225840198, 225840206, 8, 1440x900 
0x37CA2318, 38092263520755952, 225840262, 225840269, 7, 1440x900 
0x37CA2318, 38092263521416456, 225840327, 225840335, 8, 1440x900 
0x37CA2318, 38092263522075912, 225840393, 225840400, 7, 1440x900 
0x37CA2318, 38092263522738512, 225840461, 225840468, 7, 1440x900 
0x37CA2318, 38092263523404976, 225840527, 225840535, 8, 1440x900 
0x37CA2318, 38092263524061776, 225840592, 225840599, 7, 1440x900 
0x37CA2318, 38092263524721224, 225840658, 225840665, 7, 1440x900 
0x37CA2318, 38092263525437608, 225840728, 225840736, 8, 1440x900 
0x37CA2318, 38092263526074240, 225840793, 225840801, 8, 1440x900 
0x37CA2318, 38092263526709168, 225840859, 225840866, 7, 1440x900 
0x37CA2318, 38092263527368544, 225840923, 225840931, 8, 1440x900 
0x37CA2318, 38092263528065520, 225840998, 225841007, 9, 1440x900 
0x37CA2318, 38092263528710040, 225841057, 225841066, 9, 1440x900 
0x37CA2318, 38092263529358320, 225841125, 225841134, 9, 1440x900 
0x37CA2318, 38092263530005728, 225841187, 225841196, 9, 1440x900 
0x37CA2318, 38092263530673480, 225841254, 225841262, 8, 1440x900 
0x37CA2318, 38092263531321208, 225841317, 225841324, 7, 1440x900 
0x37CA2318, 38092263531983024, 225841383, 225841391, 8, 1440x900 
0x37CA2318, 38092263532644152, 225841451, 225841458, 7, 1440x900 
0x37CA2318, 38092263533308888, 225841517, 225841525, 8, 1440x900 
0x37CA2318, 38092263533963472, 225841583, 225841590, 7, 1440x900 
0x37CA2318, 38092263534622984, 225841647, 225841655, 8, 1440x900 
0x37CA2318, 38092263535284056, 225841717, 225841724, 7, 1440x900 
0x37CA2318, 38092263535948760, 225841781, 225841789, 8, 1440x900 
0x37CA2318, 38092263536609520, 225841852, 225841860, 8, 1440x900 
0x37CA2318, 38092263537274656, 225841913, 225841921, 8, 1440x900 
0x37CA2318, 38092263537939232, 225841981, 225841989, 8, 1440x900 
0x37CA2318, 38092263538594600, 225842047, 225842054, 7, 1440x900 
0x37CA2318, 38092263539255728, 225842112, 225842120, 8, 1440x900 
0x37CA2318, 38092263539919136, 225842183, 225842189, 6, 1440x900 
0x37CA2318, 38092263540585440, 225842246, 225842254, 8, 1440x900 
0x37CA2318, 38092263541239128, 225842311, 225842319, 8, 1440x900 
0x37CA2318, 38092263541899120, 225842377, 225842385, 8, 1440x900 
0x37CA2318, 38092263542573056, 225842446, 225842454, 8, 1440x900 
0x37CA2318, 38092263543224232, 225842511, 225842519, 8, 1440x900 
0x37CA2318, 38092263543879024, 225842576, 225842584, 8, 1440x900 
0x37CA2318, 38092263544539104, 225842642, 225842650, 8, 1440x900 
0x37CA2318, 38092263545201120, 225842708, 225842715, 7, 1440x900 
0x37CA2318, 38092263545865080, 225842773, 225842780, 7, 1440x900 
0x37CA2318, 38092263546522600, 225842843, 225842851, 8, 1440x900 
0x37CA2318, 38092263547183832, 225842903, 225842912, 9, 1440x900 
0x37CA2318, 38092263547844176, 225842971, 225842979, 8, 1440x900 
0x37CA2318, 38092263548510272, 225843038, 225843046, 8, 1440x900 
0x37CA2318, 38092263549164776, 225843102, 225843110, 8, 1440x900 
0x37CA2318, 38092263549827440, 225843172, 225843181, 9, 1440x900 
0x37CA2318, 38092263550488304, 225843238, 225843247, 9, 1440x900 
0x37CA2318, 38092263551154232, 225843308, 225843316, 8, 1440x900 
0x37CA2318, 38092263551808648, 225843369, 225843377, 8, 1440x900 
0x37CA2318, 38092263552467472, 225843437, 225843445, 8, 1440x900 
0x37CA2318, 38092263553132376, 225843503, 225843510, 7, 1440x900 
0x37CA2318, 38092263553787816, 225843568, 225843575, 7, 1440x900 
0x37CA2318, 38092263554449712, 225843632, 225843641, 9, 1440x900 
0x37CA2318, 38092263555126464, 225843703, 225843710, 7, 1440x900 
0x37CA2318, 38092263555783712, 225843766, 225843773, 7, 1440x900 
0x37CA2318, 38092263556440640, 225843829, 225843837, 8, 1440x900 
0x37CA2318, 38092263557213296, 225843908, 225843917, 9, 1440x900 
0x37CA2318, 38092263557970168, 225843984, 225843992, 8, 1440x900 
0x37CA2318, 38092263558622784, 225844049, 225844057, 8, 1440x900 
0x37CA2318, 38092263559089864, 225844097, 225844105, 8, 1440x900 
0x37CA2318, 38092263559789032, 225844172, 225844181, 9, 1440x900 
0x37CA2318, 38092263560422368, 225844227, 225844235, 8, 1440x900 
0x37CA2318, 38092263561083024, 225844293, 225844302, 9, 1440x900 
0x37CA2318, 38092263561764000, 225844363, 225844371, 8, 1440x900 
0x37CA2318, 38092263562435432, 225844431, 225844438, 7, 1440x900 
0x37CA2318, 38092263563063328, 225844492, 225844500, 8, 1440x900 
0x37CA2318, 38092263563722112, 225844558, 225844565, 7, 1440x900 
0x37CA2318, 38092263564386184, 225844628, 225844636, 8, 1440x900 
0x37CA2318, 38092263565061440, 225844697, 225844705, 8, 1440x900 
0x37CA2318, 38092263565709104, 225844762, 225844770, 8, 1440x900 
0x37CA2318, 38092263566367520, 225844828, 225844836, 8, 1440x900 
0x37CA2318, 38092263567072120, 225844901, 225844910, 9, 1440x900 
0x37CA2318, 38092263567726144, 225844964, 225844973, 9, 1440x900 
0x37CA2318, 38092263568386040, 225845023, 225845037, 14, 1440x900 
0x37CA2318, 38092263569048680, 225845092, 225845106, 14, 1440x900 
0x37CA2318, 38092263569705112, 225845157, 225845171, 14, 1440x900 
0x37CA2318, 38092263570377416, 225845223, 225845234, 11, 1440x900 
0x37CA2318, 38092263571042408, 225845291, 225845304, 13, 1440x900 
0x37CA2318, 38092263571720480, 225845358, 225845370, 12, 1440x900 
0x37CA2318, 38092263572375160, 225845426, 225845433, 7, 1440x900 
0x37CA2318, 38092263573002688, 225845487, 225845494, 7, 1440x900 
0x37CA2318, 38092263573634176, 225845553, 225845561, 8, 1440x900 
0x37CA2318, 38092263574487696, 225845638, 225845646, 8, 1440x900 
0x37CA2318, 38092263574959472, 225845682, 225845690, 8, 1440x900 
0x37CA2318, 38092263575673048, 225845753, 225845762, 9, 1440x900 
0x37CA2318, 38092263576307656, 225845822, 225845830, 8, 1440x900 
0x37CA2318, 38092263576970304, 225845882, 225845890, 8, 1440x900 
0x37CA2318, 38092263577647096, 225845953, 225845962, 9, 1440x900 
0x37CA2318, 38092263578275832, 225846018, 225846026, 8, 1440x900 
0x37CA2318, 38092263578936000, 225846087, 225846095, 8, 1440x900 
0x37CA2318, 38092263579596744, 225846149, 225846157, 8, 1440x900 
0x37CA2318, 38092263580256008, 225846217, 225846225, 8, 1440x900 
0x37CA2318, 38092263581046464, 225846293, 225846301, 8, 1440x900 
0x37CA2318, 38092263581564896, 225846346, 225846353, 7, 1440x900 
0x37CA2318, 38092263582230736, 225846408, 225846417, 9, 1440x900 
0x37CA2318, 38092263582891800, 225846478, 225846485, 7, 1440x900 
0x37CA2318, 38092263583552408, 225846542, 225846551, 9, 1440x900 
0x37CA2318, 38092263584206640, 225846607, 225846614, 7, 1440x900 
0x37CA2318, 38092263584867280, 225846672, 225846680, 8, 1440x900 
0x37CA2318, 38092263585527120, 225846738, 225846746, 8, 1440x900 
0x37CA2318, 38092263586187912, 225846803, 225846811, 8, 1440x900 
0x37CA2318, 38092263586847336, 225846871, 225846878, 7, 1440x900 
0x37CA2318, 38092263587507312, 225846937, 225846944, 7, 1440x900 
0x37CA2318, 38092263588161936, 225847002, 225847010, 8, 1440x900 
0x37CA2318, 38092263588835120, 225847073, 225847081, 8, 1440x900 
0x37CA2318, 38092263589486832, 225847137, 225847145, 8, 1440x900 
0x37CA2318, 38092263590149904, 225847203, 225847210, 7, 1440x900 
0x37CA2318, 38092263590994360, 225847287, 225847295, 8, 1440x900 
0x37CA2318, 38092263591673112, 225847354, 225847361, 7, 1440x900 
0x37CA2318, 38092263592166624, 225847403, 225847410, 7, 1440x900 
0x37CA2318, 38092263592986248, 225847487, 225847494, 7, 1440x900 
0x37CA2318, 38092263593647360, 225847553, 225847561, 8, 1440x900 
0x37CA2318, 38092263594137608, 225847601, 225847608, 7, 1440x900 
0x37CA2318, 38092263595426264, 225847728, 225847735, 7, 1440x900 
0x37CA2318, 38092263596095448, 225847793, 225847801, 8, 1440x900 
0x37CA2318, 38092263596753720, 225847862, 225847869, 7, 1440x900 
0x37CA2318, 38092263597428520, 225847928, 225847936, 8, 1440x900 
0x37CA2318, 38092263598085072, 225847993, 225848002, 9, 1440x900 
0x37CA2318, 38092263598914160, 225848082, 225848089, 7, 1440x900 
0x37CA2318, 38092263599406096, 225848133, 225848141, 8, 1440x900 
0x37CA2318, 38092263600072848, 225848197, 225848205, 8, 1440x900 
0x37CA2318, 38092263600726672, 225848262, 225848269, 7, 1440x900 
0x37CA2318, 38092263601403232, 225848327, 225848334, 7, 1440x900 
0x37CA2318, 38092263602062888, 225848389, 225848399, 10, 1440x900 
0x37CA2318, 38092263602730568, 225848458, 225848466, 8, 1440x900 
0x37CA2318, 38092263603392000, 225848523, 225848531, 8, 1440x900 
0x37CA2318, 38092263604052152, 225848593, 225848600, 7, 1440x900 
0x37CA2318, 38092263604715504, 225848657, 225848664, 7, 1440x900 
0x37CA2318, 38092263605371768, 225848723, 225848732, 9, 1440x900 
0x37CA2318, 38092263606031840, 225848788, 225848796, 8, 1440x900 
0x37CA2318, 38092263606699184, 225848857, 225848865, 8, 1440x900 
0x37CA2318, 38092263607365440, 225848922, 225848931, 9, 1440x900 
0x37CA2318, 38092263608017896, 225848989, 225848997, 8, 1440x900 
0x37CA2318, 38092263608678264, 225849052, 225849060, 8, 1440x900 
0x37CA2318, 38092263609544128, 225849139, 225849148, 9, 1440x900 
0x37CA2318, 38092263610010128, 225849185, 225849193, 8, 1440x900 
0x37CA2318, 38092263610873248, 225849273, 225849280, 7, 1440x900 
0x37CA2318, 38092263611381528, 225849323, 225849331, 8, 1440x900 
0x37CA2318, 38092263612002232, 225849387, 225849394, 7, 1440x900 
0x37CA2318, 38092263612850064, 225849472, 225849480, 8, 1440x900 
0x37CA2318, 38092263613503312, 225849538, 225849546, 8, 1440x900 
0x37CA2318, 38092263613982760, 225849585, 225849593, 8, 1440x900 
0x37CA2318, 38092263614841848, 225849672, 225849679, 7, 1440x900 
0x37CA2318, 38092263615499888, 225849733, 225849742, 9, 1440x900 
0x37CA2318, 38092263616160048, 225849801, 225849808, 7, 1440x900 
0x37CA2318, 38092263616624368, 225849848, 225849855, 7, 1440x900 
0x37CA2318, 38092263617280984, 225849913, 225849920, 7, 1440x900 
0x37CA2318, 38092263617977144, 225849983, 225849990, 7, 1440x900 
0x37CA2318, 38092263618604392, 225850047, 225850055, 8, 1440x900 
0x37CA2318, 38092263619296528, 225850119, 225850126, 7, 1440x900 
0x37CA2318, 38092263619943704, 225850183, 225850190, 7, 1440x900 
0x37CA2318, 38092263620584096, 225850246, 225850254, 8, 1440x900 
0x37CA2318, 38092263621274600, 225850313, 225850321, 8, 1440x900 
0x37CA2318, 38092263621908928, 225850377, 225850384, 7, 1440x900 
0x37CA2318, 38092263622565344, 225850442, 225850449, 7, 1440x900 
0x37CA2318, 38092263623263600, 225850512, 225850519, 7, 1440x900 
0x37CA2318, 38092263623889632, 225850578, 225850586, 8, 1440x900 
0x37CA2318, 38092263624589960, 225850647, 225850660, 13, 1440x900 
0x37CA2318, 38092263625255928, 225850718, 225850726, 8, 1440x900 
0x37CA2318, 38092263625881776, 225850776, 225850784, 8, 1440x900 
0x37CA2318, 38092263626541496, 225850843, 225850850, 7, 1440x900 
0x37CA2318, 38092263627202120, 225850908, 225850915, 7, 1440x900 
0x37CA2318, 38092263627855080, 225850971, 225850978, 7, 1440x900 
0x37CA2318, 38092263628535728, 225851043, 225851052, 9, 1440x900 
0x37CA2318, 38092263629178648, 225851103, 225851112, 9, 1440x900 
0x37CA2318, 38092263629921592, 225851178, 225851185, 7, 1440x900 
0x37CA2318, 38092263630490160, 225851237, 225851244, 7, 1440x900 
0x37CA2318, 38092263631176192, 225851308, 225851315, 7, 1440x900 
0x37CA2318, 38092263631828512, 225851373, 225851380, 7, 1440x900 
0x37CA2318, 38092263632509088, 225851438, 225851445, 7, 1440x900 
0x37CA2318, 38092263633141712, 225851501, 225851509, 8, 1440x900 
0x37CA2318, 38092263633801560, 225851568, 225851576, 8, 1440x900 
0x37CA2318, 38092263634489288, 225851637, 225851645, 8, 1440x900 
0x37CA2318, 38092263635121528, 225851698, 225851706, 8, 1440x900 
0x37CA2318, 38092263635787568, 225851768, 225851778, 10, 1440x900 
0x37CA2318, 38092263636451872, 225851833, 225851842, 9, 1440x900 
0x37CA2318, 38092263637305424, 225851917, 225851925, 8, 1440x900 
0x37CA2318, 38092263637966992, 225851988, 225851996, 8, 1440x900 
0x37CA2318, 38092263638618432, 225852053, 225852061, 8, 1440x900 
0x37CA2318, 38092263639093384, 225852098, 225852106, 8, 1440x900 
0x37CA2318, 38092263639944200, 225852185, 225852193, 8, 1440x900 
0x37CA2318, 38092263640595984, 225852247, 225852254, 7, 1440x900 
0x37CA2318, 38092263641259400, 225852317, 225852325, 8, 1440x900 
0x37CA2318, 38092263641732000, 225852363, 225852371, 8, 1440x900 
0x37CA2318, 38092263642589648, 225852448, 225852456, 8, 1440x900 
0x37CA2318, 38092263643252808, 225852513, 225852521, 8, 1440x900 
0x37CA2318, 38092263643908600, 225852577, 225852586, 9, 1440x900 
0x37CA2318, 38092263644565168, 225852648, 225852656, 8, 1440x900 
0x37CA2318, 38092263645218544, 225852707, 225852714, 7, 1440x900 
0x37CA2318, 38092263645887872, 225852776, 225852783, 7, 1440x900 
0x37CA2318, 38092263646385704, 225852826, 225852834, 8, 1440x900 
0x37CA2318, 38092263647218504, 225852908, 225852915, 7, 1440x900 
0x37CA2318, 38092263647878616, 225852973, 225852981, 8, 1440x900 
0x37CA2318, 38092263648335312, 225853022, 225853030, 8, 1440x900 
0x37CA2318, 38092263649149032, 225853102, 225853110, 8, 1440x900 
0x37CA2318, 38092263649660864, 225853153, 225853161, 8, 1440x900 
0x37CA2318, 38092263650324608, 225853222, 225853230, 8, 1440x900 
0x37CA2318, 38092263650988784, 225853288, 225853297, 9, 1440x900 
0x37CA2318, 38092263651660616, 225853353, 225853361, 8, 1440x900 
0x37CA2318, 38092263652314616, 225853422, 225853430, 8, 1440x900 
0x37CA2318, 38092263652976688, 225853488, 225853496, 8, 1440x900 
0x37CA2318, 38092263653637184, 225853553, 225853561, 8, 1440x900 
0x37CA2318, 38092263654304696, 225853623, 225853631, 8, 1440x900 
0x37CA2318, 38092263654969864, 225853689, 225853697, 8, 1440x900 
0x37CA2318, 38092263655624432, 225853753, 225853761, 8, 1440x900 
0x37CA2318, 38092263656414504, 225853833, 225853842, 9, 1440x900 
0x37CA2318, 38092263657123664, 225853898, 225853905, 7, 1440x900 
0x37CA2318, 38092263657606176, 225853948, 225853955, 7, 1440x900 
0x37CA2318, 38092263658473056, 225854038, 225854046, 8, 1440x900 
0x37CA2318, 38092263658935720, 225854083, 225854091, 8, 1440x900 
0x37CA2318, 38092263659588504, 225854147, 225854155, 8, 1440x900 
0x37CA2318, 38092263660438480, 225854232, 225854240, 8, 1440x900 
0x37CA2318, 38092263661573000, 225854343, 225854350, 7, 1440x900 
0x37CA2318, 38092263662225288, 225854408, 225854416, 8, 1440x900 
0x37CA2318, 38092263662886080, 225854473, 225854481, 8, 1440x900 
0x37CA2318, 38092263663605920, 225854553, 225854561, 8, 1440x900 
0x37CA2318, 38092263664216224, 225854612, 225854620, 8, 1440x900 
0x37CA2318, 38092263664869200, 225854678, 225854686, 8, 1440x900 
0x37CA2318, 38092263665530456, 225854743, 225854752, 9, 1440x900 
0x37CA2318, 38092263666189640, 225854808, 225854816, 8, 1440x900 
0x37CA2318, 38092263666858080, 225854873, 225854882, 9, 1440x900 
0x37CA2318, 38092263667512256, 225854938, 225854947, 9, 1440x900 
0x37CA2318, 38092263668178432, 225855003, 225855010, 7, 1440x900 
0x37CA2318, 38092263668835344, 225855068, 225855075, 7, 1440x900 
0x37CA2318, 38092263669499408, 225855133, 225855141, 8, 1440x900 
0x37CA2318, 38092263670157488, 225855202, 225855209, 7, 1440x900 
0x37CA2318, 38092263670817704, 225855268, 225855276, 8, 1440x900 
0x37CA2318, 38092263671479632, 225855338, 225855347, 9, 1440x900 
0x37CA2318, 38092263672152640, 225855403, 225855411, 8, 1440x900 
0x37CA2318, 38092263672803656, 225855467, 225855475, 8, 1440x900 
0x37CA2318, 38092263673464448, 225855538, 225855546, 8, 1440x900 
0x37CA2318, 38092263674131688, 225855602, 225855610, 8, 1440x900 
0x37CA2318, 38092263674784152, 225855668, 225855676, 8, 1440x900 
0x37CA2318, 38092263675447048, 225855732, 225855740, 8, 1440x900 
0x37CA2318, 38092263676103848, 225855800, 225855810, 10, 1440x900 
0x37CA2318, 38092263676772552, 225855863, 225855871, 8, 1440x900 
0x37CA2318, 38092263677436752, 225855931, 225855939, 8, 1440x900 
0x37CA2318, 38092263678090568, 225855997, 225856004, 7, 1440x900 
0x37CA2318, 38092263678750840, 225856062, 225856069, 7, 1440x900 
0x37CA2318, 38092263679416584, 225856127, 225856135, 8, 1440x900 
0x37CA2318, 38092263680071160, 225856193, 225856200, 7, 1440x900 
0x37CA2318, 38092263680733328, 225856261, 225856269, 8, 1440x900 
0x37CA2318, 38092263681395768, 225856332, 225856340, 8, 1440x900 
0x37CA2318, 38092263682071432, 225856397, 225856405, 8, 1440x900 
0x37CA2318, 38092263682727792, 225856463, 225856472, 9, 1440x900 
0x37CA2318, 38092263683582048, 225856547, 225856555, 8, 1440x900 
0x37CA2318, 38092263684044880, 225856592, 225856600, 8, 1440x900 
0x37CA2318, 38092263684707648, 225856659, 225856667, 8, 1440x900 
0x37CA2318, 38092263685369584, 225856728, 225856736, 8, 1440x900 
0x37CA2318, 38092263686033512, 225856792, 225856800, 8, 1440x900 
0x37CA2318, 38092263686695944, 225856857, 225856865, 8, 1440x900 
0x37CA2318, 38092263687351392, 225856922, 225856929, 7, 1440x900 
0x37CA2318, 38092263688010936, 225856988, 225856995, 7, 1440x900 
0x37CA2318, 38092263688671232, 225857058, 225857066, 8, 1440x900 
0x37CA2318, 38092263689349456, 225857123, 225857132, 9, 1440x900 
0x37CA2318, 38092263690000936, 225857187, 225857195, 8, 1440x900 
0x37CA2318, 38092263690660296, 225857252, 225857260, 8, 1440x900 
0x37CA2318, 38092263691330432, 225857318, 225857326, 8, 1440x900 
0x37CA2318, 38092263691994768, 225857387, 225857395, 8, 1440x900 
0x37CA2318, 38092263692650144, 225857452, 225857460, 8, 1440x900 
0x37CA2318, 38092263693314208, 225857517, 225857525, 8, 1440x900 
0x37CA2318, 38092263693977784, 225857583, 225857591, 8, 1440x900 
0x37CA2318, 38092263694823568, 225857667, 225857675, 8, 1440x900 
0x37CA2318, 38092263695295864, 225857720, 225857728, 8, 1440x900 
0x37CA2318, 38092263695958688, 225857787, 225857795, 8, 1440x900 
0x37CA2318, 38092263696620328, 225857852, 225857860, 8, 1440x900 
0x37CA2318, 38092263697289072, 225857918, 225857926, 8, 1440x900 
0x37CA2318, 38092263697941696, 225857982, 225857990, 8, 1440x900 
0x37CA2318, 38092263698602680, 225858053, 225858062, 9, 1440x900 
0x37CA2318, 38092263699262992, 225858113, 225858120, 7, 1440x900 
0x37CA2318, 38092263699920352, 225858178, 225858185, 7, 1440x900 
0x37CA2318, 38092263700579912, 225858243, 225858251, 8, 1440x900 
0x37CA2318, 38092263701242760, 225858312, 225858319, 7, 1440x900 
0x37CA2318, 38092263701902864, 225858377, 225858384, 7, 1440x900 
0x37CA2318, 38092263702559504, 225858443, 225858450, 7, 1440x900 
0x37CA2318, 38092263703219472, 225858507, 225858515, 8, 1440x900 
0x37CA2318, 38092263703880144, 225858573, 225858582, 9, 1440x900 
0x37CA2318, 38092263704544112, 225858641, 225858648, 7, 1440x900 
0x37CA2318, 38092263705409536, 225858728, 225858736, 8, 1440x900 
0x37CA2318, 38092263706055112, 225858793, 225858801, 8, 1440x900 
0x37CA2318, 38092263706531816, 225858843, 225858851, 8, 1440x900 
0x37CA2318, 38092263707189536, 225858907, 225858915, 8, 1440x900 
0x37CA2318, 38092263707851240, 225858972, 225858980, 8, 1440x900 
0x37CA2318, 38092263708509904, 225859037, 225859045, 8, 1440x900 
0x37CA2318, 38092263709177824, 225859103, 225859111, 8, 1440x900 
0x37CA2318, 38092263709834808, 225859171, 225859178, 7, 1440x900 
0x37CA2318, 38092263710494792, 225859236, 225859243, 7, 1440x900 
0x37CA2318, 38092263711154720, 225859302, 225859309, 7, 1440x900 
0x37CA2318, 38092263711819664, 225859368, 225859375, 7, 1440x900 
0x37CA2318, 38092263712474848, 225859433, 225859441, 8, 1440x900 
0x37CA2318, 38092263713135088, 225859498, 225859506, 8, 1440x900 
0x37CA2318, 38092263713795296, 225859567, 225859574, 7, 1440x900 
0x37CA2318, 38092263714464952, 225859637, 225859645, 8, 1440x900 
0x37CA2318, 38092263715317568, 225859718, 225859727, 9, 1440x900 
0x37CA2318, 38092263715778544, 225859768, 225859777, 9, 1440x900 
0x37CA2318, 38092263716455960, 225859832, 225859839, 7, 1440x900 
0x37CA2318, 38092263717308784, 225859917, 225859926, 9, 1440x900 
0x37CA2318, 38092263717968432, 225859983, 225859992, 9, 1440x900 
0x37CA2318, 38092263718621768, 225860053, 225860062, 9, 1440x900 
0x37CA2318, 38092263719093072, 225860098, 225860106, 8, 1440x900 
0x37CA2318, 38092263719942200, 225860183, 225860191, 8, 1440x900 
0x37CA2318, 38092263720603600, 225860247, 225860256, 9, 1440x900 
0x37CA2318, 38092263721264360, 225860313, 225860320, 7, 1440x900 
0x37CA2318, 38092263721731816, 225860362, 225860369, 7, 1440x900 
0x37CA2318, 38092263722588104, 225860448, 225860456, 8, 1440x900 
0x37CA2318, 38092263723258224, 225860513, 225860522, 9, 1440x900 
0x37CA2318, 38092263723909544, 225860578, 225860585, 7, 1440x900 
0x37CA2318, 38092263724377664, 225860623, 225860631, 8, 1440x900 
0x37CA2318, 38092263725032504, 225860688, 225860696, 8, 1440x900 
0x37CA2318, 38092263725695152, 225860757, 225860765, 8, 1440x900 
0x37CA2318, 38092263726354960, 225860822, 225860829, 7, 1440x900 
0x37CA2318, 38092263727020296, 225860891, 225860899, 8, 1440x900 
0x37CA2318, 38092263727676912, 225860953, 225860962, 9, 1440x900 
0x37CA2318, 38092263728338584, 225861022, 225861030, 8, 1440x900 
0x37CA2318, 38092263729160192, 225861103, 225861111, 8, 1440x900 
0x37CA2318, 38092263729854488, 225861174, 225861182, 8, 1440x900 
0x37CA2318, 38092263730327368, 225861223, 225861231, 8, 1440x900 
0x37CA2318, 38092263730975512, 225861282, 225861290, 8, 1440x900 
0x37CA2318, 38092263731666408, 225861352, 225861360, 8, 1440x900 
0x37CA2318, 38092263732318576, 225861417, 225861424, 7, 1440x900 
0x37CA2318, 38092263732964336, 225861482, 225861490, 8, 1440x900 
0x37CA2318, 38092263733623752, 225861548, 225861556, 8, 1440x900 
0x37CA2318, 38092263734283824, 225861616, 225861623, 7, 1440x900 
0x37CA2318, 38092263734948896, 225861681, 225861688, 7, 1440x900 
0x37CA2318, 38092263735608304, 225861747, 225861754, 7, 1440x900 
0x37CA2318, 38092263736927688, 225861882, 225861890, 8, 1440x900 
0x37CA2318, 38092263737596376, 225861948, 225861956, 8, 1440x900 
0x37CA2318, 38092263738442744, 225862032, 225862040, 8, 1440x900 
0x37CA2318, 38092263739113088, 225862098, 225862108, 10, 1440x900 
0x37CA2318, 38092263739579424, 225862147, 225862155, 8, 1440x900 
0x37CA2318, 38092263740422656, 225862229, 225862237, 8, 1440x900 
0x37CA2318, 38092263740966912, 225862288, 225862296, 8, 1440x900 
0x37CA2318, 38092263741550176, 225862343, 225862352, 9, 1440x900 
0x37CA2318, 38092263742219472, 225862413, 225862420, 7, 1440x900 
0x37CA2318, 38092263742882904, 225862477, 225862486, 9, 1440x900 
0x37CA2318, 38092263743543928, 225862542, 225862551, 9, 1440x900 
0x37CA2318, 38092263744199984, 225862607, 225862615, 8, 1440x900 
0x37CA2318, 38092263744859288, 225862672, 225862680, 8, 1440x900 
0x37CA2318, 38092263745521696, 225862741, 225862750, 9, 1440x900 
0x37CA2318, 38092263746237080, 225862812, 225862820, 8, 1440x900 
0x37CA2318, 38092263746847480, 225862872, 225862880, 8, 1440x900 
0x37CA2318, 38092263747500936, 225862937, 225862944, 7, 1440x900 
0x37CA2318, 38092263748162960, 225863007, 225863015, 8, 1440x900 
0x37CA2318, 38092263748817056, 225863069, 225863078, 9, 1440x900 
0x37CA2318, 38092263749491368, 225863143, 225863151, 8, 1440x900 
0x37CA2318, 38092263750145872, 225863202, 225863211, 9, 1440x900 
0x37CA2318, 38092263750797008, 225863268, 225863277, 9, 1440x900 
0x37CA2318, 38092263751457288, 225863337, 225863345, 8, 1440x900 
0x37CA2318, 38092263752124312, 225863402, 225863410, 8, 1440x900 
0x37CA2318, 38092263752988696, 225863487, 225863495, 8, 1440x900 
0x37CA2318, 38092263753639136, 225863552, 225863560, 8, 1440x900 
0x37CA2318, 38092263754299648, 225863617, 225863625, 8, 1440x900 
0x37CA2318, 38092263754772560, 225863667, 225863675, 8, 1440x900 
0x37CA2318, 38092263755622040, 225863748, 225863756, 8, 1440x900 
0x37CA2318, 38092263756281264, 225863813, 225863821, 8, 1440x900 
0x37CA2318, 38092263756835472, 225863868, 225863876, 8, 1440x900 
0x37CA2318, 38092263757405768, 225863927, 225863934, 7, 1440x900 
0x37CA2318, 38092263758242904, 225864013, 225864020, 7, 1440x900 
0x37CA2318, 38092263758725920, 225864058, 225864065, 7, 1440x900 
0x37CA2318, 38092263759383504, 225864123, 225864131, 8, 1440x900 
0x37CA2318, 38092263760054728, 225864192, 225864199, 7, 1440x900 
0x37CA2318, 38092263760710392, 225864258, 225864265, 7, 1440x900 
0x37CA2318, 38092263761370376, 225864323, 225864330, 7, 1440x900 
0x37CA2318, 38092263762034968, 225864388, 225864396, 8, 1440x900 
0x37CA2318, 38092263762890224, 225864478, 225864485, 7, 1440x900 
0x37CA2318, 38092263763550712, 225864543, 225864552, 9, 1440x900 
0x37CA2318, 38092263764219720, 225864608, 225864615, 7, 1440x900 
0x37CA2318, 38092263764684560, 225864657, 225864671, 14, 1440x900 
0x37CA2318, 38092263765531200, 225864738, 225864746, 8, 1440x900 
0x37CA2318, 38092263765996200, 225864787, 225864794, 7, 1440x900 
0x37CA2318, 38092263766655784, 225864853, 225864860, 7, 1440x900 
0x37CA2318, 38092263767321744, 225864918, 225864926, 8, 1440x900 
0x37CA2318, 38092263767984144, 225864987, 225864995, 8, 1440x900 
0x37CA2318, 38092263768644760, 225865054, 225865062, 8, 1440x900 
0x37CA2318, 38092263769505312, 225865140, 225865147, 7, 1440x900 
0x37CA2318, 38092263769978360, 225865188, 225865196, 8, 1440x900 
0x37CA2318, 38092263770825768, 225865273, 225865281, 8, 1440x900 
0x37CA2318, 38092263771485936, 225865338, 225865346, 8, 1440x900 
0x37CA2318, 38092263771957264, 225865388, 225865396, 8, 1440x900 
0x37CA2318, 38092263772617256, 225865452, 225865460, 8, 1440x900 
0x37CA2318, 38092263773467392, 225865537, 225865545, 8, 1440x900 
0x37CA2318, 38092263773932776, 225865583, 225865591, 8, 1440x900 
0x37CA2318, 38092263774591584, 225865646, 225865653, 7, 1440x900 
0x37CA2318, 38092263775438752, 225865728, 225865736, 8, 1440x900 
0x37CA2318, 38092263775907272, 225865776, 225865784, 8, 1440x900 
0x37CA2318, 38092263776772512, 225865863, 225865870, 7, 1440x900 
0x37CA2318, 38092263777237632, 225865908, 225865916, 8, 1440x900 
0x37CA2318, 38092263777893528, 225865976, 225865983, 7, 1440x900 
0x37CA2318, 38092263778746800, 225866061, 225866068, 7, 1440x900 
0x37CA2318, 38092263779366976, 225866122, 225866129, 7, 1440x900 
0x37CA2318, 38092263779873400, 225866173, 225866180, 7, 1440x900 
0x37CA2318, 38092263780539552, 225866243, 225866251, 8, 1440x900 
0x37CA2318, 38092263781199664, 225866308, 225866316, 8, 1440x900 
0x37CA2318, 38092263782061256, 225866397, 225866405, 8, 1440x900 
0x37CA2318, 38092263782714112, 225866462, 225866470, 8, 1440x900 
0x37CA2318, 38092263783369552, 225866527, 225866535, 8, 1440x900 
0x37CA2318, 38092263784037680, 225866593, 225866601, 8, 1440x900 
0x37CA2318, 38092263784503336, 225866642, 225866650, 8, 1440x900 
0x37CA2318, 38092263785167128, 225866702, 225866710, 8, 1440x900 
0x37CA2318, 38092263786027088, 225866791, 225866799, 8, 1440x900 
0x37CA2318, 38092263786481728, 225866836, 225866844, 8, 1440x900 
0x37CA2318, 38092263787147752, 225866901, 225866909, 8, 1440x900 
0x37CA2318, 38092263787805104, 225866968, 225866975, 7, 1440x900 
0x37CA2318, 38092263788464976, 225867038, 225867045, 7, 1440x900 
0x37CA2318, 38092263789124792, 225867098, 225867106, 8, 1440x900 
0x37CA2318, 38092263789798880, 225867167, 225867175, 8, 1440x900 
0x37CA2318, 38092263790659728, 225867254, 225867262, 8, 1440x900 
0x37CA2318, 38092263791314552, 225867318, 225867327, 9, 1440x900 
0x37CA2318, 38092263791782016, 225867368, 225867376, 8, 1440x900 
0x37CA2318, 38092263792446496, 225867433, 225867442, 9, 1440x900 
0x37CA2318, 38092263793760872, 225867567, 225867576, 9, 1440x900 
0x37CA2318, 38092263794426008, 225867633, 225867642, 9, 1440x900 
0x37CA2318, 38092263795081776, 225867693, 225867701, 8, 1440x900 
0x37CA2318, 38092263795742136, 225867761, 225867769, 8, 1440x900 
0x37CA2318, 38092263796403696, 225867827, 225867835, 8, 1440x900 
0x37CA2318, 38092263797072864, 225867897, 225867905, 8, 1440x900 
0x37CA2318, 38092263797730800, 225867962, 225867970, 8, 1440x900 
0x37CA2318, 38092263798392792, 225868027, 225868035, 8, 1440x900 
0x37CA2318, 38092263799129256, 225868103, 225868111, 8, 1440x900 
0x37CA2318, 38092263799722888, 225868162, 225868170, 8, 1440x900 
0x37CA2318, 38092263800374240, 225868228, 225868236, 8, 1440x900 
0x37CA2318, 38092263801033472, 225868292, 225868300, 8, 1440x900 
0x37CA2318, 38092263801697136, 225868362, 225868371, 9, 1440x900 
0x37CA2318, 38092263802363920, 225868428, 225868436, 8, 1440x900 
0x37CA2318, 38092263803026208, 225868493, 225868501, 8, 1440x900 
0x37CA2318, 38092263803767472, 225868568, 225868576, 8, 1440x900 
0x37CA2318, 38092263804337112, 225868624, 225868632, 8, 1440x900 
0x37CA2318, 38092263805006432, 225868693, 225868701, 8, 1440x900 
0x37CA2318, 38092263805658488, 225868758, 225868766, 8, 1440x900 
0x37CA2318, 38092263806331256, 225868823, 225868831, 8, 1440x900 
0x37CA2318, 38092263806977776, 225868884, 225868892, 8, 1440x900 
0x37CA2318, 38092263807641664, 225868952, 225868959, 7, 1440x900 
0x37CA2318, 38092263808305920, 225869017, 225869024, 7, 1440x900 
0x37CA2318, 38092263808966040, 225869083, 225869090, 7, 1440x900 
0x37CA2318, 38092263809631520, 225869148, 225869157, 9, 1440x900 
0x37CA2318, 38092263810284808, 225869213, 225869221, 8, 1440x900 
0x37CA2318, 38092263810944384, 225869281, 225869288, 7, 1440x900 
0x37CA2318, 38092263811604136, 225869346, 225869353, 7, 1440x900 
0x37CA2318, 38092263812268216, 225869412, 225869420, 8, 1440x900 
0x37CA2318, 38092263812938816, 225869488, 225869496, 8, 1440x900 
0x37CA2318, 38092263813586584, 225869547, 225869555, 8, 1440x900 
0x37CA2318, 38092263814256240, 225869612, 225869619, 7, 1440x900 
0x37CA2318, 38092263814924104, 225869681, 225869688, 7, 1440x900 
0x37CA2318, 38092263815581080, 225869748, 225869756, 8, 1440x900 
0x37CA2318, 38092263816245720, 225869817, 225869825, 8, 1440x900 
0x37CA2318, 38092263816909648, 225869877, 225869884, 7, 1440x900 
0x37CA2318, 38092263817567128, 225869942, 225869949, 7, 1440x900 
0x37CA2318, 38092263818421152, 225870029, 225870037, 8, 1440x900 
0x37CA2318, 38092263819100384, 225870098, 225870106, 8, 1440x900 
0x37CA2318, 38092263819566480, 225870148, 225870156, 8, 1440x900 
0x37CA2318, 38092263820217728, 225870212, 225870220, 8, 1440x900 
0x37CA2318, 38092263820880672, 225870278, 225870286, 8, 1440x900 
0x37CA2318, 38092263821536696, 225870343, 225870351, 8, 1440x900 
0x37CA2318, 38092263822204144, 225870408, 225870416, 8, 1440x900 
0x37CA2318, 38092263822868288, 225870478, 225870486, 8, 1440x900 
0x37CA2318, 38092263823536456, 225870542, 225870550, 8, 1440x900 
0x37CA2318, 38092263824195088, 225870607, 225870616, 9, 1440x900 
0x37CA2318, 38092263824862808, 225870678, 225870686, 8, 1440x900 
0x37CA2318, 38092263825517184, 225870743, 225870751, 8, 1440x900 
0x37CA2318, 38092263826176032, 225870808, 225870816, 8, 1440x900 
0x37CA2318, 38092263826836688, 225870872, 225870880, 8, 1440x900 
0x37CA2318, 38092263827501232, 225870936, 225870944, 8, 1440x900 
0x37CA2318, 38092263828157312, 225871002, 225871009, 7, 1440x900 
0x37CA2318, 38092263828817584, 225871067, 225871074, 7, 1440x900 
0x37CA2318, 38092263829481008, 225871133, 225871141, 8, 1440x900 
0x37CA2318, 38092263830348120, 225871223, 225871231, 8, 1440x900 
0x37CA2318, 38092263831000464, 225871288, 225871297, 9, 1440x900 
0x37CA2318, 38092263831466160, 225871337, 225871345, 8, 1440x900 
0x37CA2318, 38092263832132792, 225871402, 225871410, 8, 1440x900 
0x37CA2318, 38092263832980912, 225871483, 225871492, 9, 1440x900 
0x37CA2318, 38092263833642376, 225871553, 225871561, 8, 1440x900 
0x37CA2318, 38092263834248560, 225871612, 225871621, 9, 1440x900 
0x37CA2318, 38092263834772432, 225871668, 225871675, 7, 1440x900 
0x37CA2318, 38092263835426152, 225871732, 225871740, 8, 1440x900 
0x37CA2318, 38092263836092176, 225871798, 225871806, 8, 1440x900 
0x37CA2318, 38092263836752408, 225871863, 225871871, 8, 1440x900 
0x37CA2318, 38092263837422848, 225871933, 225871940, 7, 1440x900 
0x37CA2318, 38092263838066864, 225871993, 225872000, 7, 1440x900 
0x37CA2318, 38092263838734792, 225872063, 225872071, 8, 1440x900 
0x37CA2318, 38092263839393048, 225872128, 225872136, 8, 1440x900 
0x37CA2318, 38092263840058264, 225872193, 225872201, 8, 1440x900 
0x37CA2318, 38092263840712200, 225872263, 225872271, 8, 1440x900 
0x37CA2318, 38092263841372360, 225872327, 225872335, 8, 1440x900 
0x37CA2318, 38092263842038696, 225872391, 225872400, 9, 1440x900 
0x37CA2318, 38092263842702440, 225872462, 225872470, 8, 1440x900 
0x37CA2318, 38092263843558712, 225872544, 225872552, 8, 1440x900 
0x37CA2318, 38092263844211328, 225872613, 225872621, 8, 1440x900 
0x37CA2318, 38092263844688968, 225872657, 225872665, 8, 1440x900 
0x37CA2318, 38092263845342896, 225872723, 225872731, 8, 1440x900 
0x37CA2318, 38092263846301568, 225872817, 225872824, 7, 1440x900 
0x37CA2318, 38092263846955184, 225872882, 225872890, 8, 1440x900 
0x37CA2318, 38092263847445456, 225872937, 225872945, 8, 1440x900 
0x37CA2318, 38092263848100832, 225873003, 225873011, 8, 1440x900 
0x37CA2318, 38092263848764608, 225873062, 225873070, 8, 1440x900 
0x37CA2318, 38092263849423080, 225873128, 225873137, 9, 1440x900 
0x37CA2318, 38092263850086576, 225873197, 225873204, 7, 1440x900 
0x37CA2318, 38092263850779472, 225873268, 225873277, 9, 1440x900 
0x37CA2318, 38092263851449248, 225873338, 225873346, 8, 1440x900 
0x37CA2318, 38092263852088240, 225873395, 225873404, 9, 1440x900 
0x37CA2318, 38092263852731264, 225873458, 225873469, 11, 1440x900 
0x37CA2318, 38092263853408824, 225873528, 225873535, 7, 1440x900 
0x37CA2318, 38092263854056464, 225873592, 225873599, 7, 1440x900 
0x37CA2318, 38092263854726072, 225873663, 225873672, 9, 1440x900 
0x37CA2318, 38092263855375960, 225873722, 225873730, 8, 1440x900 
0x37CA2318, 38092263856044256, 225873792, 225873799, 7, 1440x900 
0x37CA2318, 38092263856704128, 225873863, 225873871, 8, 1440x900 
0x37CA2318, 38092263857369760, 225873928, 225873936, 8, 1440x900 
0x37CA2318, 38092263858022240, 225873993, 225874001, 8, 1440x900 
0x37CA2318, 38092263858677192, 225874053, 225874060, 7, 1440x900 
0x37CA2318, 38092263859542000, 225874142, 225874149, 7, 1440x900 
0x37CA2318, 38092263860009184, 225874186, 225874193, 7, 1440x900 
0x37CA2318, 38092263860858040, 225874272, 225874280, 8, 1440x900 
0x37CA2318, 38092263861520448, 225874338, 225874346, 8, 1440x900 
0x37CA2318, 38092263862141056, 225874401, 225874409, 8, 1440x900 
0x37CA2318, 38092263862852648, 225874473, 225874480, 7, 1440x900 
0x37CA2318, 38092263863518576, 225874539, 225874546, 7, 1440x900 
0x37CA2318, 38092263864170448, 225874602, 225874609, 7, 1440x900 
0x37CA2318, 38092263864791152, 225874668, 225874676, 8, 1440x900 
0x37CA2318, 38092263865494936, 225874739, 225874747, 8, 1440x900 
0x37CA2318, 38092263865956616, 225874787, 225874795, 8, 1440x900 
0x37CA2318, 38092263866622936, 225874848, 225874855, 7, 1440x900 
0x37CA2318, 38092263867283608, 225874913, 225874921, 8, 1440x900 
0x37CA2318, 38092263867938416, 225874981, 225874989, 8, 1440x900 
0x37CA2318, 38092263868598504, 225875046, 225875054, 8, 1440x900 
0x37CA2318, 38092263869258632, 225875112, 225875120, 8, 1440x900 
0x37CA2318, 38092263869922976, 225875177, 225875185, 8, 1440x900 
0x37CA2318, 38092263870578744, 225875243, 225875251, 8, 1440x900 
0x37CA2318, 38092263871239744, 225875308, 225875316, 8, 1440x900 
0x37CA2318, 38092263871902064, 225875377, 225875385, 8, 1440x900 
0x37CA2318, 38092263872564096, 225875442, 225875449, 7, 1440x900 
0x37CA2318, 38092263873414240, 225875532, 225875541, 9, 1440x900 
0x37CA2318, 38092263873889056, 225875578, 225875586, 8, 1440x900 
0x37CA2318, 38092263874548448, 225875647, 225875655, 8, 1440x900 
0x37CA2318, 38092263875214696, 225875709, 225875717, 8, 1440x900 
0x37CA2318, 38092263875889776, 225875778, 225875786, 8, 1440x900 
0x37CA2318, 38092263876726192, 225875862, 225875869, 7, 1440x900 
0x37CA2318, 38092263877190720, 225875906, 225875913, 7, 1440x900 
0x37CA2318, 38092263877850888, 225875972, 225875981, 9, 1440x900 
0x37CA2318, 38092263878708160, 225876057, 225876066, 9, 1440x900 
0x37CA2318, 38092263879360832, 225876123, 225876130, 7, 1440x900 
0x37CA2318, 38092263879837584, 225876173, 225876181, 8, 1440x900 
0x37CA2318, 38092263880490144, 225876237, 225876245, 8, 1440x900 
0x37CA2318, 38092263881150008, 225876303, 225876311, 8, 1440x900 
0x37CA2318, 38092263881810920, 225876372, 225876380, 8, 1440x900 
0x37CA2318, 38092263882485104, 225876438, 225876446, 8, 1440x900 
0x37CA2318, 38092263883341168, 225876522, 225876530, 8, 1440x900 
0x37CA2318, 38092263883797664, 225876567, 225876576, 9, 1440x900 
0x37CA2318, 38092263885124096, 225876703, 225876711, 8, 1440x900 
0x37CA2318, 38092263885968096, 225876784, 225876793, 9, 1440x900 
0x37CA2318, 38092263886572376, 225876848, 225876856, 8, 1440x900 
0x37CA2318, 38092263887103760, 225876897, 225876905, 8, 1440x900 
0x37CA2318, 38092263887770488, 225876962, 225876970, 8, 1440x900 
0x37CA2318, 38092263888425120, 225877028, 225877036, 8, 1440x900 
0x37CA2318, 38092263889087840, 225877097, 225877105, 8, 1440x900 
0x37CA2318, 38092263889754624, 225877168, 225877176, 8, 1440x900 
0x37CA2318, 38092263890415296, 225877230, 225877239, 9, 1440x900 
0x37CA2318, 38092263891067256, 225877293, 225877301, 8, 1440x900 
0x37CA2318, 38092263891727952, 225877359, 225877366, 7, 1440x900 
0x37CA2318, 38092263892392624, 225877428, 225877436, 8, 1440x900 
0x37CA2318, 38092263893047248, 225877493, 225877500, 7, 1440x900 
0x37CA2318, 38092263893708072, 225877557, 225877565, 8, 1440x900 
0x37CA2318, 38092263894556632, 225877648, 225877656, 8, 1440x900 
0x37CA2318, 38092263895036576, 225877693, 225877701, 8, 1440x900 
0x37CA2318, 38092263895877768, 225877778, 225877786, 8, 1440x900 
0x37CA2318, 38092263896538888, 225877843, 225877852, 9, 1440x900 
0x37CA2318, 38092263897029200, 225877893, 225877901, 8, 1440x900 
0x37CA2318, 38092263897673776, 225877953, 225877961, 8, 1440x900 
0x37CA2318, 38092263898521176, 225878042, 225878050, 8, 1440x900 
0x37CA2318, 38092263898992576, 225878087, 225878095, 8, 1440x900 
0x37CA2318, 38092263899650544, 225878158, 225878166, 8, 1440x900 
0x37CA2318, 38092263900319672, 225878218, 225878226, 8, 1440x900 
0x37CA2318, 38092263900975592, 225878282, 225878290, 8, 1440x900 
0x37CA2318, 38092263901635072, 225878347, 225878355, 8, 1440x900 
0x37CA2318, 38092263902301080, 225878417, 225878425, 8, 1440x900 
0x37CA2318, 38092263902962696, 225878483, 225878491, 8, 1440x900 
0x37CA2318, 38092263903631360, 225878548, 225878555, 7, 1440x900 
0x37CA2318, 38092263904291600, 225878613, 225878621, 8, 1440x900 
0x37CA2318, 38092263904955872, 225878682, 225878690, 8, 1440x900 
0x37CA2318, 38092263905613920, 225878748, 225878755, 7, 1440x900 
0x37CA2318, 38092263906274216, 225878813, 225878821, 8, 1440x900 
0x37CA2318, 38092263907139312, 225878903, 225878911, 8, 1440x900 
0x37CA2318, 38092263907600216, 225878947, 225878955, 8, 1440x900 
0x37CA2318, 38092263908263328, 225879018, 225879026, 8, 1440x900 
0x37CA2318, 38092263908916560, 225879083, 225879091, 8, 1440x900 
0x37CA2318, 38092263909582944, 225879147, 225879155, 8, 1440x900 
0x37CA2318, 38092263910239008, 225879213, 225879221, 8, 1440x900 
0x37CA2318, 38092263910896464, 225879278, 225879286, 8, 1440x900 
0x37CA2318, 38092263911756584, 225879362, 225879370, 8, 1440x900 
0x37CA2318, 38092263912229200, 225879412, 225879420, 8, 1440x900 
0x37CA2318, 38092263913081712, 225879498, 225879506, 8, 1440x900 
0x37CA2318, 38092263913743800, 225879562, 225879570, 8, 1440x900 
0x37CA2318, 38092263914413312, 225879629, 225879637, 8, 1440x900 
0x37CA2318, 38092263914886872, 225879678, 225879686, 8, 1440x900 
0x37CA2318, 38092263915733856, 225879764, 225879772, 8, 1440x900 
0x37CA2318, 38092263916199624, 225879813, 225879821, 8, 1440x900 
0x37CA2318, 38092263916857792, 225879872, 225879879, 7, 1440x900 
0x37CA2318, 38092263917526816, 225879939, 225879947, 8, 1440x900 
0x37CA2318, 38092263918180392, 225880008, 225880017, 9, 1440x900 
0x37CA2318, 38092263918844184, 225880073, 225880082, 9, 1440x900 
0x37CA2318, 38092263919503824, 225880143, 225880151, 8, 1440x900 
0x37CA2318, 38092263920173512, 225880208, 225880216, 8, 1440x900 
0x37CA2318, 38092263920825976, 225880273, 225880281, 8, 1440x900 
0x37CA2318, 38092263921484576, 225880337, 225880344, 7, 1440x900 
0x37CA2318, 38092263922142800, 225880402, 225880409, 7, 1440x900 
0x37CA2318, 38092263922804416, 225880467, 225880474, 7, 1440x900 
0x37CA2318, 38092263923464160, 225880533, 225880540, 7, 1440x900 
0x37CA2318, 38092263924133184, 225880606, 225880614, 8, 1440x900 
0x37CA2318, 38092263924798456, 225880666, 225880674, 8, 1440x900 
0x37CA2318, 38092263925453016, 225880732, 225880739, 7, 1440x900 
0x37CA2318, 38092263926113288, 225880797, 225880805, 8, 1440x900 
0x37CA2318, 38092263926773400, 225880863, 225880871, 8, 1440x900 
0x37CA2318, 38092263927438648, 225880931, 225880939, 8, 1440x900 
0x37CA2318, 38092263928298576, 225881017, 225881025, 8, 1440x900 
0x37CA2318, 38092263928951248, 225881082, 225881090, 8, 1440x900 
0x37CA2318, 38092263929605376, 225881153, 225881161, 8, 1440x900 
0x37CA2318, 38092263930084744, 225881198, 225881206, 8, 1440x900 
0x37CA2318, 38092263930805664, 225881268, 225881276, 8, 1440x900 
0x37CA2318, 38092263931398056, 225881334, 225881342, 8, 1440x900 
0x37CA2318, 38092263932064968, 225881398, 225881406, 8, 1440x900 
0x37CA2318, 38092263932720288, 225881464, 225881472, 8, 1440x900 
0x37CA2318, 38092263933378432, 225881528, 225881536, 8, 1440x900 
0x37CA2318, 38092263934039000, 225881593, 225881601, 8, 1440x900 
0x37CA2318, 38092263934708040, 225881663, 225881671, 8, 1440x900 
0x37CA2318, 38092263935359968, 225881727, 225881735, 8, 1440x900 
0x37CA2318, 38092263936026704, 225881793, 225881801, 8, 1440x900 
0x37CA2318, 38092263936885104, 225881878, 225881886, 8, 1440x900 
0x37CA2318, 38092263937372512, 225881928, 225881936, 8, 1440x900 
0x37CA2318, 38092263938026272, 225881993, 225882001, 8, 1440x900 
0x37CA2318, 38092263938888360, 225882078, 225882086, 8, 1440x900 
0x37CA2318, 38092263939547576, 225882147, 225882155, 8, 1440x900 
0x37CA2318, 38092263940011440, 225882193, 225882201, 8, 1440x900 
0x37CA2318, 38092263940725280, 225882263, 225882271, 8, 1440x900 
0x37CA2318, 38092263941325352, 225882323, 225882331, 8, 1440x900 
0x37CA2318, 38092263941985784, 225882393, 225882401, 8, 1440x900 
0x37CA2318, 38092263942650864, 225882458, 225882466, 8, 1440x900 
0x37CA2318, 38092263943508920, 225882538, 225882546, 8, 1440x900 
0x37CA2318, 38092263944178104, 225882607, 225882615, 8, 1440x900 
0x37CA2318, 38092263944641184, 225882652, 225882660, 8, 1440x900 
0x37CA2318, 38092263945954200, 225882784, 225882792, 8, 1440x900 
0x37CA2318, 38092263946618448, 225882853, 225882861, 8, 1440x900 
0x37CA2318, 38092263947287320, 225882918, 225882926, 8, 1440x900 
0x37CA2318, 38092263947939448, 225882983, 225882991, 8, 1440x900 
0x37CA2318, 38092263948596816, 225883047, 225883055, 8, 1440x900 
0x37CA2318, 38092263949257216, 225883112, 225883120, 8, 1440x900 
0x37CA2318, 38092263949922864, 225883177, 225883185, 8, 1440x900 
0x37CA2318, 38092263950779272, 225883263, 225883271, 8, 1440x900 
0x37CA2318, 38092263951439600, 225883332, 225883340, 8, 1440x900 
0x37CA2318, 38092263951899040, 225883377, 225883386, 9, 1440x900 
0x37CA2318, 38092263952567848, 225883447, 225883455, 8, 1440x900 
0x37CA2318, 38092263953218400, 225883508, 225883516, 8, 1440x900 
0x37CA2318, 38092263953878504, 225883573, 225883582, 9, 1440x900 
0x37CA2318, 38092263954541888, 225883641, 225883649, 8, 1440x900 
0x37CA2318, 38092263955207040, 225883707, 225883714, 7, 1440x900 
0x37CA2318, 38092263955861840, 225883772, 225883780, 8, 1440x900 
0x37CA2318, 38092263956543576, 225883843, 225883852, 9, 1440x900 
0x37CA2318, 38092263957210848, 225883913, 225883921, 8, 1440x900 
0x37CA2318, 38092263958076856, 225883998, 225884006, 8, 1440x900 
0x37CA2318, 38092263958726544, 225884063, 225884071, 8, 1440x900 
0x37CA2318, 38092263959195392, 225884107, 225884114, 7, 1440x900 
0x37CA2318, 38092263959857696, 225884173, 225884180, 7, 1440x900 
0x37CA2318, 38092263960523696, 225884238, 225884246, 8, 1440x900 
0x37CA2318, 38092263961186736, 225884307, 225884315, 8, 1440x900 
0x37CA2318, 38092263961843320, 225884373, 225884380, 7, 1440x900 
0x37CA2318, 38092263962509016, 225884438, 225884445, 7, 1440x900 
0x37CA2318, 38092263963163304, 225884507, 225884514, 7, 1440x900 
0x37CA2318, 38092263963823200, 225884568, 225884576, 8, 1440x900 
0x37CA2318, 38092263964483112, 225884638, 225884646, 8, 1440x900 
0x37CA2318, 38092263965148984, 225884703, 225884711, 8, 1440x900 
0x37CA2318, 38092263965803344, 225884768, 225884775, 7, 1440x900 
0x37CA2318, 38092263966463568, 225884833, 225884840, 7, 1440x900 
0x37CA2318, 38092263967129952, 225884902, 225884911, 9, 1440x900 
0x37CA2318, 38092263967783704, 225884966, 225884974, 8, 1440x900 
0x37CA2318, 38092263968641472, 225885052, 225885060, 8, 1440x900 
0x37CA2318, 38092263969104000, 225885102, 225885110, 8, 1440x900 
0x37CA2318, 38092263969779672, 225885163, 225885172, 9, 1440x900 
0x37CA2318, 38092263970434096, 225885228, 225885236, 8, 1440x900 
0x37CA2318, 38092263971094464, 225885297, 225885305, 8, 1440x900 
0x37CA2318, 38092263971955664, 225885382, 225885390, 8, 1440x900 
0x37CA2318, 38092263972420640, 225885428, 225885436, 8, 1440x900 
0x37CA2318, 38092263973075200, 225885493, 225885501, 8, 1440x900 
0x37CA2318, 38092263973738256, 225885562, 225885570, 8, 1440x900 
0x37CA2318, 38092263974395472, 225885626, 225885634, 8, 1440x900 
0x37CA2318, 38092263975059256, 225885692, 225885700, 8, 1440x900 
0x37CA2318, 38092263975718176, 225885759, 225885766, 7, 1440x900 
0x37CA2318, 38092263976382432, 225885823, 225885831, 8, 1440x900 
0x37CA2318, 38092263977037120, 225885888, 225885896, 8, 1440x900 
0x37CA2318, 38092263977700968, 225885957, 225885964, 7, 1440x900 
0x37CA2318, 38092263978359192, 225886022, 225886029, 7, 1440x900 
0x37CA2318, 38092263979021848, 225886092, 225886099, 7, 1440x900 
0x37CA2318, 38092263979693248, 225886162, 225886170, 8, 1440x900 
0x37CA2318, 38092263980344528, 225886222, 225886231, 9, 1440x900 
0x37CA2318, 38092263981005240, 225886293, 225886301, 8, 1440x900 
0x37CA2318, 38092263981665368, 225886358, 225886366, 8, 1440x900 
0x37CA2318, 38092263982333320, 225886423, 225886431, 8, 1440x900 
0x37CA2318, 38092263983160704, 225886508, 225886517, 9, 1440x900 
0x37CA2318, 38092263983646016, 225886552, 225886559, 7, 1440x900 
0x37CA2318, 38092263984304056, 225886617, 225886625, 8, 1440x900 
0x37CA2318, 38092263984972480, 225886687, 225886695, 8, 1440x900 
0x37CA2318, 38092263985628136, 225886752, 225886760, 8, 1440x900 
0x37CA2318, 38092263986286656, 225886817, 225886825, 8, 1440x900 
0x37CA2318, 38092263986947136, 225886882, 225886889, 7, 1440x900 
0x37CA2318, 38092263987612032, 225886947, 225886955, 8, 1440x900 
0x37CA2318, 38092263988270048, 225887018, 225887026, 8, 1440x900 
0x37CA2318, 38092263988931568, 225887086, 225887093, 7, 1440x900 
0x37CA2318, 38092263989586008, 225887144, 225887152, 8, 1440x900 
0x37CA2318, 38092263990251232, 225887212, 225887219, 7, 1440x900 
0x37CA2318, 38092263990906648, 225887277, 225887284, 7, 1440x900 
0x37CA2318, 38092263991572424, 225887343, 225887350, 7, 1440x900 
0x37CA2318, 38092263992237520, 225887408, 225887416, 8, 1440x900 
0x37CA2318, 38092263992894464, 225887477, 225887485, 8, 1440x900 
0x37CA2318, 38092263993554384, 225887543, 225887550, 7, 1440x900 
0x37CA2318, 38092263994214424, 225887608, 225887615, 7, 1440x900 
0x37CA2318, 38092263994886088, 225887673, 225887682, 9, 1440x900 
0x37CA2318, 38092263995542240, 225887741, 225887748, 7, 1440x900 
0x37CA2318, 38092263996202224, 225887809, 225887817, 8, 1440x900 
0x37CA2318, 38092263996870424, 225887877, 225887885, 8, 1440x900 
0x37CA2318, 38092263997533752, 225887943, 225887951, 8, 1440x900 
0x37CA2318, 38092263998385544, 225888027, 225888035, 8, 1440x900 
0x37CA2318, 38092263998962376, 225888083, 225888092, 9, 1440x900 
0x37CA2318, 38092263999501848, 225888137, 225888144, 7, 1440x900 
0x37CA2318, 38092264000174872, 225888203, 225888210, 7, 1440x900 
0x37CA2318, 38092264000830656, 225888268, 225888276, 8, 1440x900 
0x37CA2318, 38092264001494272, 225888336, 225888343, 7, 1440x900 
0x37CA2318, 38092264002155704, 225888402, 225888409, 7, 1440x900 
0x37CA2318, 38092264002811056, 225888467, 225888474, 7, 1440x900 
0x37CA2318, 38092264003474016, 225888533, 225888541, 8, 1440x900 
0x37CA2318, 38092264004134792, 225888604, 225888612, 8, 1440x900 
0x37CA2318, 38092264004813776, 225888672, 225888680, 8, 1440x900 
0x37CA2318, 38092264005460512, 225888733, 225888740, 7, 1440x900 
0x37CA2318, 38092264006316496, 225888822, 225888829, 7, 1440x900 
0x37CA2318, 38092264006975008, 225888883, 225888891, 8, 1440x900 
0x37CA2318, 38092264007453616, 225888934, 225888942, 8, 1440x900 
0x37CA2318, 38092264008150576, 225889002, 225889010, 8, 1440x900 
0x37CA2318, 38092264008977096, 225889083, 225889090, 7, 1440x900 
0x37CA2318, 38092264009630456, 225889148, 225889156, 8, 1440x900 
0x37CA2318, 38092264010758304, 225889262, 225889270, 8, 1440x900 
0x37CA2318, 38092264011418504, 225889328, 225889336, 8, 1440x900 
0x37CA2318, 38092264012276176, 225889418, 225889426, 8, 1440x900 
0x37CA2318, 38092264012747384, 225889467, 225889475, 8, 1440x900 
0x37CA2318, 38092264013447320, 225889532, 225889541, 9, 1440x900 
0x37CA2318, 38092264014062880, 225889598, 225889606, 8, 1440x900 
0x37CA2318, 38092264014733624, 225889662, 225889670, 8, 1440x900 
0x37CA2318, 38092264015384312, 225889728, 225889737, 9, 1440x900 
0x37CA2318, 38092264016059224, 225889798, 225889806, 8, 1440x900 
0x37CA2318, 38092264016728128, 225889858, 225889868, 10, 1440x900 
0x37CA2318, 38092264017366392, 225889922, 225889930, 8, 1440x900 
0x37CA2318, 38092264018026520, 225889987, 225889995, 8, 1440x900 
0x37CA2318, 38092264018689088, 225890058, 225890067, 9, 1440x900 
0x37CA2318, 38092264019356680, 225890127, 225890135, 8, 1440x900 
0x37CA2318, 38092264020017848, 225890193, 225890202, 9, 1440x900 
0x37CA2318, 38092264020672208, 225890252, 225890260, 8, 1440x900 
0x37CA2318, 38092264021339056, 225890323, 225890331, 8, 1440x900 
0x37CA2318, 38092264021997280, 225890388, 225890397, 9, 1440x900 
0x37CA2318, 38092264022649368, 225890452, 225890461, 9, 1440x900 
0x37CA2318, 38092264023506144, 225890538, 225890545, 7, 1440x900 
0x37CA2318, 38092264024174848, 225890602, 225890609, 7, 1440x900 
0x37CA2318, 38092264024639680, 225890652, 225890659, 7, 1440x900 
0x37CA2318, 38092264025494416, 225890735, 225890742, 7, 1440x900 
0x37CA2318, 38092264026078032, 225890792, 225890800, 8, 1440x900 
0x37CA2318, 38092264026810680, 225890867, 225890874, 7, 1440x900 
0x37CA2318, 38092264027361768, 225890923, 225890931, 8, 1440x900 
0x37CA2318, 38092264027951160, 225890982, 225890989, 7, 1440x900 
0x37CA2318, 38092264028607080, 225891047, 225891054, 7, 1440x900 
0x37CA2318, 38092264029267024, 225891112, 225891120, 8, 1440x900 
0x37CA2318, 38092264029932032, 225891178, 225891186, 8, 1440x900 
0x37CA2318, 38092264030589904, 225891247, 225891255, 8, 1440x900 
0x37CA2318, 38092264031248304, 225891308, 225891316, 8, 1440x900 
0x37CA2318, 38092264031921376, 225891377, 225891384, 7, 1440x900 
0x37CA2318, 38092264032577048, 225891443, 225891453, 10, 1440x900 
0x37CA2318, 38092264033260048, 225891512, 225891519, 7, 1440x900 
0x37CA2318, 38092264033900880, 225891577, 225891585, 8, 1440x900 
0x37CA2318, 38092264034566672, 225891643, 225891651, 8, 1440x900 
0x37CA2318, 38092264035411424, 225891732, 225891740, 8, 1440x900 
0x37CA2318, 38092264036086400, 225891798, 225891806, 8, 1440x900 
0x37CA2318, 38092264036746488, 225891862, 225891870, 8, 1440x900 
0x37CA2318, 38092264037205880, 225891907, 225891914, 7, 1440x900 
0x37CA2318, 38092264038069840, 225891998, 225892006, 8, 1440x900 
0x37CA2318, 38092264038740464, 225892063, 225892071, 8, 1440x900 
0x37CA2318, 38092264039346936, 225892123, 225892131, 8, 1440x900 
0x37CA2318, 38092264040059792, 225892193, 225892202, 9, 1440x900 
0x37CA2318, 38092264040720632, 225892262, 225892270, 8, 1440x900 
0x37CA2318, 38092264041372656, 225892323, 225892331, 8, 1440x900 
0x37CA2318, 38092264041848328, 225892372, 225892379, 7, 1440x900 
0x37CA2318, 38092264042707952, 225892457, 225892464, 7, 1440x900 
0x37CA2318, 38092264043280488, 225892518, 225892526, 8, 1440x900 
0x37CA2318, 38092264043861640, 225892573, 225892581, 8, 1440x900 
0x37CA2318, 38092264044503016, 225892637, 225892645, 8, 1440x900 
0x37CA2318, 38092264045158736, 225892702, 225892710, 8, 1440x900 
0x37CA2318, 38092264045819376, 225892768, 225892775, 7, 1440x900 
0x37CA2318, 38092264046483424, 225892839, 225892847, 8, 1440x900 
0x37CA2318, 38092264047148360, 225892903, 225892911, 8, 1440x900 
0x37CA2318, 38092264047806648, 225892968, 225892977, 9, 1440x900 
0x37CA2318, 38092264048467320, 225893038, 225893046, 8, 1440x900 
0x37CA2318, 38092264049125016, 225893099, 225893107, 8, 1440x900 
0x37CA2318, 38092264049794128, 225893172, 225893180, 8, 1440x900 
0x37CA2318, 38092264050448904, 225893237, 225893246, 9, 1440x900 
0x37CA2318, 38092264051113160, 225893303, 225893311, 8, 1440x900 
0x37CA2318, 38092264051773712, 225893368, 225893376, 8, 1440x900 
0x37CA2318, 38092264052440928, 225893433, 225893441, 8, 1440x900 
0x37CA2318, 38092264053094680, 225893498, 225893506, 8, 1440x900 
0x37CA2318, 38092264053952824, 225893583, 225893591, 8, 1440x900 
0x37CA2318, 38092264054426088, 225893632, 225893640, 8, 1440x900 
0x37CA2318, 38092264055077888, 225893698, 225893706, 8, 1440x900 
0x37CA2318, 38092264055739552, 225893763, 225893772, 9, 1440x900 
0x37CA2318, 38092264056400064, 225893828, 225893837, 9, 1440x900 
0x37CA2318, 38092264057066288, 225893897, 225893905, 8, 1440x900 
0x37CA2318, 38092264057719272, 225893962, 225893970, 8, 1440x900 
0x37CA2318, 38092264058379768, 225894027, 225894035, 8, 1440x900 
0x37CA2318, 38092264059052592, 225894092, 225894101, 9, 1440x900 
0x37CA2318, 38092264059709400, 225894158, 225894167, 9, 1440x900 
0x37CA2318, 38092264060361360, 225894227, 225894234, 7, 1440x900 
0x37CA2318, 38092264061020808, 225894291, 225894299, 8, 1440x900 
0x37CA2318, 38092264061678992, 225894353, 225894361, 8, 1440x900 
0x37CA2318, 38092264062343176, 225894422, 225894429, 7, 1440x900 
0x37CA2318, 38092264062999232, 225894483, 225894493, 10, 1440x900 
0x37CA2318, 38092264063663280, 225894558, 225894566, 8, 1440x900 
0x37CA2318, 38092264064322856, 225894622, 225894630, 8, 1440x900 
0x37CA2318, 38092264064998224, 225894687, 225894695, 8, 1440x900 
0x37CA2318, 38092264065652184, 225894758, 225894766, 8, 1440x900 
0x37CA2318, 38092264066321224, 225894823, 225894831, 8, 1440x900 
0x37CA2318, 38092264066989712, 225894889, 225894897, 8, 1440x900 
0x37CA2318, 38092264067640592, 225894952, 225894961, 9, 1440x900 
0x37CA2318, 38092264068300800, 225895018, 225895026, 8, 1440x900 
0x37CA2318, 38092264068969440, 225895089, 225895097, 8, 1440x900 
0x37CA2318, 38092264069631032, 225895149, 225895156, 7, 1440x900 
0x37CA2318, 38092264070289640, 225895216, 225895223, 7, 1440x900 
0x37CA2318, 38092264070946576, 225895282, 225895289, 7, 1440x900 
0x37CA2318, 38092264071683840, 225895357, 225895364, 7, 1440x900 
0x37CA2318, 38092264072930752, 225895483, 225895491, 8, 1440x900 
0x37CA2318, 38092264073598960, 225895548, 225895556, 8, 1440x900 
0x37CA2318, 38092264074252640, 225895614, 225895622, 8, 1440x900 
0x37CA2318, 38092264074918696, 225895683, 225895691, 8, 1440x900 
0x37CA2318, 38092264075571968, 225895748, 225895757, 9, 1440x900 
0x37CA2318, 38092264076232248, 225895812, 225895820, 8, 1440x900 
0x37CA2318, 38092264076896696, 225895879, 225895887, 8, 1440x900 
0x37CA2318, 38092264077552104, 225895943, 225895952, 9, 1440x900 
0x37CA2318, 38092264078213184, 225896012, 225896020, 8, 1440x900 
0x37CA2318, 38092264078872560, 225896078, 225896090, 12, 1440x900 
0x37CA2318, 38092264079545504, 225896143, 225896151, 8, 1440x900 
0x37CA2318, 38092264080212312, 225896213, 225896221, 8, 1440x900 
0x37CA2318, 38092264080881448, 225896277, 225896285, 8, 1440x900 
0x37CA2318, 38092264081542008, 225896343, 225896352, 9, 1440x900 
0x37CA2318, 38092264082210624, 225896412, 225896420, 8, 1440x900 
0x37CA2318, 38092264082874944, 225896477, 225896485, 8, 1440x900 
0x37CA2318, 38092264083528048, 225896542, 225896550, 8, 1440x900 
0x37CA2318, 38092264084184720, 225896607, 225896615, 8, 1440x900 
0x37CA2318, 38092264084851352, 225896672, 225896681, 9, 1440x900 
0x37CA2318, 38092264085511088, 225896738, 225896747, 9, 1440x900 
0x37CA2318, 38092264086244192, 225896808, 225896816, 8, 1440x900 
0x37CA2318, 38092264086851144, 225896872, 225896879, 7, 1440x900 
0x37CA2318, 38092264087487440, 225896933, 225896941, 8, 1440x900 
0x37CA2318, 38092264088151264, 225897001, 225897008, 7, 1440x900 
0x37CA2318, 38092264089005840, 225897087, 225897094, 7, 1440x900 
0x37CA2318, 38092264089660392, 225897153, 225897161, 8, 1440x900 
0x37CA2318, 38092264090339960, 225897219, 225897228, 9, 1440x900 
0x37CA2318, 38092264090799296, 225897267, 225897275, 8, 1440x900 
0x37CA2318, 38092264091465960, 225897338, 225897346, 8, 1440x900 
0x37CA2318, 38092264092118872, 225897403, 225897411, 8, 1440x900 
0x37CA2318, 38092264092788008, 225897467, 225897475, 8, 1440x900 
0x37CA2318, 38092264093448368, 225897533, 225897541, 8, 1440x900 
0x37CA2318, 38092264094134720, 225897598, 225897607, 9, 1440x900 
0x37CA2318, 38092264094770224, 225897662, 225897670, 8, 1440x900 
0x37CA2318, 38092264095607808, 225897753, 225897761, 8, 1440x900 
0x37CA2318, 38092264096086128, 225897798, 225897806, 8, 1440x900 
0x37CA2318, 38092264096931040, 225897883, 225897891, 8, 1440x900 
0x37CA2318, 38092264097610024, 225897948, 225897955, 7, 1440x900 
0x37CA2318, 38092264098279440, 225898014, 225898021, 7, 1440x900 
0x37CA2318, 38092264098873944, 225898072, 225898080, 8, 1440x900 
0x37CA2318, 38092264099581416, 225898143, 225898150, 7, 1440x900 
0x37CA2318, 38092264100081096, 225898193, 225898202, 9, 1440x900 
0x37CA2318, 38092264100724736, 225898262, 225898271, 9, 1440x900 
0x37CA2318, 38092264101393152, 225898328, 225898337, 9, 1440x900 
0x37CA2318, 38092264102244672, 225898413, 225898421, 8, 1440x900 
0x37CA2318, 38092264102714336, 225898462, 225898470, 8, 1440x900 
0x37CA2318, 38092264103374072, 225898523, 225898531, 8, 1440x900 
0x37CA2318, 38092264104043136, 225898593, 225898601, 8, 1440x900 
0x37CA2318, 38092264104703064, 225898663, 225898671, 8, 1440x900 
0x37CA2318, 38092264105362592, 225898723, 225898733, 10, 1440x900 
0x37CA2318, 38092264106029952, 225898793, 225898802, 9, 1440x900 
0x37CA2318, 38092264106685040, 225898853, 225898862, 9, 1440x900 
0x37CA2318, 38092264107352832, 225898922, 225898929, 7, 1440x900 
0x37CA2318, 38092264108009048, 225898988, 225898994, 6, 1440x900 
0x37CA2318, 38092264108672600, 225899053, 225899060, 7, 1440x900 
0x37CA2318, 38092264109328984, 225899118, 225899126, 8, 1440x900 
0x37CA2318, 38092264109993632, 225899188, 225899196, 8, 1440x900 
0x37CA2318, 38092264110654320, 225899254, 225899262, 8, 1440x900 
0x37CA2318, 38092264111317704, 225899317, 225899325, 8, 1440x900 
0x37CA2318, 38092264111979472, 225899388, 225899396, 8, 1440x900 
0x37CA2318, 38092264112639288, 225899453, 225899462, 9, 1440x900 
0x37CA2318, 38092264113437432, 225899532, 225899540, 8, 1440x900 
0x37CA2318, 38092264114155320, 225899609, 225899618, 9, 1440x900 
0x37CA2318, 38092264114651352, 225899652, 225899659, 7, 1440x900 
0x37CA2318, 38092264115283072, 225899717, 225899725, 8, 1440x900 
0x37CA2318, 38092264115940176, 225899783, 225899793, 10, 1440x900 
0x37CA2318, 38092264116674456, 225899854, 225899864, 10, 1440x900 
0x37CA2318, 38092264117290008, 225899917, 225899925, 8, 1440x900 
0x37CA2318, 38092264117954752, 225899983, 225899990, 7, 1440x900 
0x37CA2318, 38092264118619344, 225900047, 225900056, 9, 1440x900 
0x37CA2318, 38092264119278080, 225900112, 225900120, 8, 1440x900 
0x37CA2318, 38092264119927024, 225900177, 225900185, 8, 1440x900 
0x37CA2318, 38092264120580248, 225900242, 225900250, 8, 1440x900 
0x37CA2318, 38092264121240504, 225900308, 225900317, 9, 1440x900 
0x37CA2318, 38092264121907848, 225900377, 225900384, 7, 1440x900 
0x37CA2318, 38092264122561120, 225900442, 225900449, 7, 1440x900 
0x37CA2318, 38092264123224704, 225900508, 225900517, 9, 1440x900 
0x37CA2318, 38092264123885232, 225900581, 225900589, 8, 1440x900 
0x37CA2318, 38092264124578408, 225900648, 225900656, 8, 1440x900 
0x37CA2318, 38092264125408216, 225900732, 225900740, 8, 1440x900 
0x37CA2318, 38092264126071512, 225900793, 225900800, 7, 1440x900 
0x37CA2318, 38092264126530384, 225900838, 225900846, 8, 1440x900 
0x37CA2318, 38092264127192112, 225900903, 225900911, 8, 1440x900 
0x37CA2318, 38092264127848712, 225900973, 225900980, 7, 1440x900 
0x37CA2318, 38092264128525408, 225901038, 225901046, 8, 1440x900 
0x37CA2318, 38092264129180432, 225901103, 225901112, 9, 1440x900 
0x37CA2318, 38092264129846928, 225901173, 225901180, 7, 1440x900 
0x37CA2318, 38092264130500880, 225901237, 225901245, 8, 1440x900 
0x37CA2318, 38092264131163760, 225901308, 225901315, 7, 1440x900 
0x37CA2318, 38092264131826592, 225901373, 225901380, 7, 1440x900 
0x37CA2318, 38092264132655968, 225901453, 225901460, 7, 1440x900 
0x37CA2318, 38092264133148912, 225901501, 225901508, 7, 1440x900 
0x37CA2318, 38092264133812032, 225901572, 225901580, 8, 1440x900 
0x37CA2318, 38092264134479888, 225901638, 225901646, 8, 1440x900 
0x37CA2318, 38092264135141096, 225901703, 225901711, 8, 1440x900 
0x37CA2318, 38092264135788792, 225901763, 225901771, 8, 1440x900 
0x37CA2318, 38092264136649400, 225901853, 225901862, 9, 1440x900 
0x37CA2318, 38092264137118792, 225901902, 225901910, 8, 1440x900 
0x37CA2318, 38092264137775616, 225901969, 225901977, 8, 1440x900 
0x37CA2318, 38092264138435776, 225902032, 225902039, 7, 1440x900 
0x37CA2318, 38092264139098288, 225902103, 225902111, 8, 1440x900 
0x37CA2318, 38092264139765368, 225902163, 225902172, 9, 1440x900 
0x37CA2318, 38092264140417080, 225902232, 225902240, 8, 1440x900 
0x37CA2318, 38092264141276432, 225902318, 225902326, 8, 1440x900 
0x37CA2318, 38092264141740256, 225902362, 225902370, 8, 1440x900 
0x37CA2318, 38092264142404968, 225902427, 225902436, 9, 1440x900 
0x37CA2318, 38092264143067912, 225902493, 225902501, 8, 1440x900 
0x37CA2318, 38092264143725384, 225902562, 225902569, 7, 1440x900 
0x37CA2318, 38092264144384256, 225902628, 225902636, 8, 1440x900 
0x37CA2318, 38092264145231088, 225902712, 225902720, 8, 1440x900 
0x37CA2318, 38092264145893544, 225902777, 225902785, 8, 1440x900 
0x37CA2318, 38092264146563680, 225902848, 225902856, 8, 1440x900 
0x37CA2318, 38092264147025768, 225902888, 225902896, 8, 1440x900 
0x37CA2318, 38092264147876568, 225902978, 225902985, 7, 1440x900 
0x37CA2318, 38092264148383088, 225903023, 225903032, 9, 1440x900 
0x37CA2318, 38092264149198688, 225903107, 225903115, 8, 1440x900 
0x37CA2318, 38092264149861976, 225903173, 225903182, 9, 1440x900 
0x37CA2318, 38092264150490256, 225903237, 225903245, 8, 1440x900 
0x37CA2318, 38092264151204688, 225903310, 225903318, 8, 1440x900 
0x37CA2318, 38092264151864376, 225903373, 225903381, 8, 1440x900 
0x37CA2318, 38092264152533144, 225903443, 225903451, 8, 1440x900 
0x37CA2318, 38092264153696728, 225903556, 225903564, 8, 1440x900 
0x37CA2318, 38092264154352552, 225903622, 225903630, 8, 1440x900 
0x37CA2318, 38092264154992432, 225903687, 225903694, 7, 1440x900 
0x37CA2318, 38092264155678320, 225903753, 225903761, 8, 1440x900 
0x37CA2318, 38092264156303776, 225903818, 225903825, 7, 1440x900 
0x37CA2318, 38092264156976664, 225903883, 225903891, 8, 1440x900 
0x37CA2318, 38092264157646808, 225903952, 225903960, 8, 1440x900 
0x37CA2318, 38092264158313536, 225904022, 225904030, 8, 1440x900 
0x37CA2318, 38092264158955464, 225904082, 225904090, 8, 1440x900 
0x37CA2318, 38092264159604080, 225904149, 225904159, 10, 1440x900 
0x37CA2318, 38092264160300528, 225904217, 225904225, 8, 1440x900 
0x37CA2318, 38092264160936728, 225904284, 225904292, 8, 1440x900 
0x37CA2318, 38092264161585880, 225904347, 225904356, 9, 1440x900 
0x37CA2318, 38092264162267192, 225904412, 225904421, 9, 1440x900 
0x37CA2318, 38092264162928384, 225904479, 225904488, 9, 1440x900 
0x37CA2318, 38092264163588248, 225904546, 225904554, 8, 1440x900 
0x37CA2318, 38092264164224824, 225904608, 225904616, 8, 1440x900 
0x37CA2318, 38092264164885984, 225904676, 225904684, 8, 1440x900 
0x37CA2318, 38092264165568584, 225904742, 225904751, 9, 1440x900 
0x37CA2318, 38092264166211192, 225904808, 225904815, 7, 1440x900 
0x37CA2318, 38092264166872880, 225904877, 225904885, 8, 1440x900 
0x37CA2318, 38092264167523680, 225904937, 225904947, 10, 1440x900 
0x37CA2318, 38092264168204408, 225905007, 225905013, 6, 1440x900 
0x37CA2318, 38092264168843928, 225905072, 225905079, 7, 1440x900 
0x37CA2318, 38092264169534440, 225905137, 225905145, 8, 1440x900 
0x37CA2318, 38092264170164464, 225905202, 225905210, 8, 1440x900 
0x37CA2318, 38092264170851280, 225905271, 225905279, 8, 1440x900 
0x37CA2318, 38092264171512320, 225905337, 225905344, 7, 1440x900 
0x37CA2318, 38092264172151176, 225905402, 225905409, 7, 1440x900 
0x37CA2318, 38092264172816624, 225905473, 225905482, 9, 1440x900 
0x37CA2318, 38092264173484904, 225905538, 225905546, 8, 1440x900 
0x37CA2318, 38092264174137576, 225905602, 225905610, 8, 1440x900 
0x37CA2318, 38092264174801216, 225905667, 225905676, 9, 1440x900 
0x37CA2318, 38092264175454104, 225905732, 225905740, 8, 1440x900 
0x37CA2318, 38092264176123808, 225905802, 225905810, 8, 1440x900 
0x37CA2318, 38092264176779576, 225905867, 225905875, 8, 1440x900 
0x37CA2318, 38092264177448168, 225905933, 225905941, 8, 1440x900 
0x37CA2318, 38092264178108248, 225906002, 225906010, 8, 1440x900 
0x37CA2318, 38092264178785072, 225906068, 225906076, 8, 1440x900 
0x37CA2318, 38092264179427736, 225906133, 225906141, 8, 1440x900 
0x37CA2318, 38092264180113472, 225906202, 225906210, 8, 1440x900 
0x37CA2318, 38092264180754104, 225906267, 225906275, 8, 1440x900 
0x37CA2318, 38092264181415224, 225906333, 225906341, 8, 1440x900 
0x37CA2318, 38092264182108584, 225906399, 225906407, 8, 1440x900 
0x37CA2318, 38092264182733464, 225906458, 225906466, 8, 1440x900 
0x37CA2318, 38092264183399288, 225906528, 225906535, 7, 1440x900 
0x37CA2318, 38092264184060720, 225906592, 225906600, 8, 1440x900 
0x37CA2318, 38092264184713176, 225906657, 225906665, 8, 1440x900 
0x37CA2318, 38092264185373632, 225906722, 225906730, 8, 1440x900 
0x37CA2318, 38092264186042216, 225906792, 225906802, 10, 1440x900 
0x37CA2318, 38092264186709880, 225906858, 225906867, 9, 1440x900 
0x37CA2318, 38092264187524424, 225906942, 225906950, 8, 1440x900 
0x37CA2318, 38092264188024064, 225906993, 225907001, 8, 1440x900 
0x37CA2318, 38092264188978128, 225907082, 225907090, 8, 1440x900 
0x37CA2318, 38092264189333072, 225907118, 225907126, 8, 1440x900 
0x37CA2318, 38092264189999760, 225907187, 225907194, 7, 1440x900 
0x37CA2318, 38092264190663312, 225907252, 225907259, 7, 1440x900 
0x37CA2318, 38092264191324920, 225907317, 225907325, 8, 1440x900 
0x37CA2318, 38092264191982400, 225907386, 225907393, 7, 1440x900 
0x37CA2318, 38092264192654536, 225907452, 225907459, 7, 1440x900 
0x37CA2318, 38092264193320128, 225907518, 225907526, 8, 1440x900 
0x37CA2318, 38092264193970624, 225907583, 225907591, 8, 1440x900 
0x37CA2318, 38092264194630384, 225907648, 225907656, 8, 1440x900 
0x37CA2318, 38092264195295760, 225907718, 225907725, 7, 1440x900 
0x37CA2318, 38092264195950848, 225907782, 225907789, 7, 1440x900 
0x37CA2318, 38092264196611344, 225907847, 225907854, 7, 1440x900 
0x37CA2318, 38092264197327768, 225907923, 225907931, 8, 1440x900 
0x37CA2318, 38092264198135456, 225907998, 225908006, 8, 1440x900 
0x37CA2318, 38092264198788520, 225908066, 225908074, 8, 1440x900 
0x37CA2318, 38092264199446512, 225908133, 225908140, 7, 1440x900 
0x37CA2318, 38092264199917544, 225908177, 225908185, 8, 1440x900 
0x37CA2318, 38092264200768344, 225908268, 225908276, 8, 1440x900 
0x37CA2318, 38092264201430648, 225908332, 225908340, 8, 1440x900 
0x37CA2318, 38092264201926328, 225908383, 225908392, 9, 1440x900 
0x37CA2318, 38092264202575696, 225908446, 225908453, 7, 1440x900 
0x37CA2318, 38092264203218304, 225908508, 225908515, 7, 1440x900 
0x37CA2318, 38092264203878384, 225908572, 225908580, 8, 1440x900 
0x37CA2318, 38092264204543088, 225908641, 225908649, 8, 1440x900 
0x37CA2318, 38092264205200352, 225908707, 225908715, 8, 1440x900 
0x37CA2318, 38092264205861440, 225908778, 225908786, 8, 1440x900 
0x37CA2318, 38092264206529592, 225908843, 225908852, 9, 1440x900 
0x37CA2318, 38092264207190872, 225908904, 225908912, 8, 1440x900 
0x37CA2318, 38092264208059848, 225908992, 225908999, 7, 1440x900 
0x37CA2318, 38092264208719592, 225909058, 225909065, 7, 1440x900 
0x37CA2318, 38092264209389256, 225909122, 225909129, 7, 1440x900 
0x37CA2318, 38092264209845192, 225909173, 225909179, 6, 1440x900 
0x37CA2318, 38092264210523520, 225909237, 225909245, 8, 1440x900 
0x37CA2318, 38092264211368216, 225909323, 225909330, 7, 1440x900 
0x37CA2318, 38092264212024360, 225909388, 225909395, 7, 1440x900 
0x37CA2318, 38092264212699840, 225909457, 225909465, 8, 1440x900 
0x37CA2318, 38092264213352000, 225909522, 225909529, 7, 1440x900 
0x37CA2318, 38092264213810960, 225909567, 225909574, 7, 1440x900 
0x37CA2318, 38092264214476832, 225909633, 225909648, 15, 1440x900 
0x37CA2318, 38092264215173728, 225909706, 225909716, 10, 1440x900 
0x37CA2318, 38092264215824288, 225909767, 225909775, 8, 1440x900 
0x37CA2318, 38092264216460136, 225909833, 225909840, 7, 1440x900 
0x37CA2318, 38092264217123712, 225909898, 225909908, 10, 1440x900 
0x37CA2318, 38092264217791584, 225909963, 225909971, 8, 1440x900 
0x37CA2318, 38092264218448128, 225910033, 225910042, 9, 1440x900 
0x37CA2318, 38092264219107752, 225910100, 225910109, 9, 1440x900 
0x37CA2318, 38092264219769232, 225910168, 225910176, 8, 1440x900 
0x37CA2318, 38092264220449136, 225910232, 225910241, 9, 1440x900 
0x37CA2318, 38092264221081104, 225910299, 225910308, 9, 1440x900 
0x37CA2318, 38092264221740928, 225910368, 225910376, 8, 1440x900 
0x37CA2318, 38092264222401264, 225910432, 225910440, 8, 1440x900 
0x37CA2318, 38092264223074200, 225910497, 225910506, 9, 1440x900 
0x37CA2318, 38092264223735896, 225910563, 225910571, 8, 1440x900 
0x37CA2318, 38092264224383032, 225910627, 225910635, 8, 1440x900 
0x37CA2318, 38092264225123488, 225910704, 225910712, 8, 1440x900 
0x37CA2318, 38092264225710320, 225910758, 225910767, 9, 1440x900 
0x37CA2318, 38092264226565496, 225910843, 225910851, 8, 1440x900 
0x37CA2318, 38092264227227400, 225910908, 225910916, 8, 1440x900 
0x37CA2318, 38092264227720048, 225910958, 225910966, 8, 1440x900 
0x37CA2318, 38092264228544968, 225911041, 225911049, 8, 1440x900 
0x37CA2318, 38092264229875712, 225911177, 225911185, 8, 1440x900 
0x37CA2318, 38092264230348520, 225911223, 225911231, 8, 1440x900 
0x37CA2318, 38092264231001648, 225911293, 225911301, 8, 1440x900 
0x37CA2318, 38092264231669528, 225911358, 225911367, 9, 1440x900 
0x37CA2318, 38092264232325576, 225911423, 225911431, 8, 1440x900 
0x37CA2318, 38092264232989040, 225911487, 225911495, 8, 1440x900 
0x37CA2318, 38092264233833920, 225911572, 225911580, 8, 1440x900 
0x37CA2318, 38092264234503936, 225911637, 225911646, 9, 1440x900 
0x37CA2318, 38092264235165728, 225911708, 225911716, 8, 1440x900 
0x37CA2318, 38092264235636432, 225911753, 225911761, 8, 1440x900 
0x37CA2318, 38092264236493808, 225911838, 225911846, 8, 1440x900 
0x37CA2318, 38092264237151976, 225911903, 225911911, 8, 1440x900 
0x37CA2318, 38092264237748504, 225911968, 225911976, 8, 1440x900 
0x37CA2318, 38092264238473584, 225912034, 225912043, 9, 1440x900 
0x37CA2318, 38092264239134848, 225912104, 225912112, 8, 1440x900 
0x37CA2318, 38092264239793240, 225912167, 225912176, 9, 1440x900 
0x37CA2318, 38092264240265920, 225912213, 225912222, 9, 1440x900 
0x37CA2318, 38092264241107984, 225912297, 225912306, 9, 1440x900 
0x37CA2318, 38092264241603872, 225912353, 225912361, 8, 1440x900 
0x37CA2318, 38092264242246968, 225912413, 225912421, 8, 1440x900 
0x37CA2318, 38092264242913312, 225912482, 225912490, 8, 1440x900 
0x37CA2318, 38092264243566600, 225912547, 225912555, 8, 1440x900 
0x37CA2318, 38092264244226104, 225912612, 225912620, 8, 1440x900 
0x37CA2318, 38092264244887600, 225912678, 225912686, 8, 1440x900 
0x37CA2318, 38092264245555216, 225912743, 225912751, 8, 1440x900 
0x37CA2318, 38092264246207136, 225912808, 225912817, 9, 1440x900 
0x37CA2318, 38092264246867224, 225912878, 225912886, 8, 1440x900 
0x37CA2318, 38092264247727424, 225912963, 225912972, 9, 1440x900 
0x37CA2318, 38092264248199008, 225913007, 225913014, 7, 1440x900 
0x37CA2318, 38092264248883304, 225913078, 225913086, 8, 1440x900 
0x37CA2318, 38092264249519904, 225913143, 225913152, 9, 1440x900 
0x37CA2318, 38092264250175584, 225913206, 225913215, 9, 1440x900 
0x37CA2318, 38092264250842272, 225913272, 225913280, 8, 1440x900 
0x37CA2318, 38092264251685464, 225913358, 225913366, 8, 1440x900 
0x37CA2318, 38092264252356536, 225913428, 225913436, 8, 1440x900 
0x37CA2318, 38092264252828792, 225913472, 225913480, 8, 1440x900 
0x37CA2318, 38092264253672160, 225913558, 225913566, 8, 1440x900 
0x37CA2318, 38092264254342624, 225913623, 225913631, 8, 1440x900 
0x37CA2318, 38092264255014056, 225913692, 225913700, 8, 1440x900 
0x37CA2318, 38092264255478536, 225913738, 225913746, 8, 1440x900 
0x37CA2318, 38092264256329464, 225913823, 225913831, 8, 1440x900 
0x37CA2318, 38092264256989768, 225913888, 225913896, 8, 1440x900 
0x37CA2318, 38092264257640752, 225913953, 225913963, 10, 1440x900 
0x37CA2318, 38092264258117520, 225914002, 225914010, 8, 1440x900 
0x37CA2318, 38092264258773448, 225914063, 225914070, 7, 1440x900 
0x37CA2318, 38092264259430704, 225914134, 225914141, 7, 1440x900 
0x37CA2318, 38092264260087224, 225914193, 225914201, 8, 1440x900 
0x37CA2318, 38092264260780952, 225914263, 225914271, 8, 1440x900 
0x37CA2318, 38092264261411480, 225914327, 225914334, 7, 1440x900 
0x37CA2318, 38092264262079208, 225914393, 225914400, 7, 1440x900 
0x37CA2318, 38092264262728296, 225914458, 225914466, 8, 1440x900 
0x37CA2318, 38092264263400224, 225914533, 225914542, 9, 1440x900 
0x37CA2318, 38092264264073176, 225914593, 225914602, 9, 1440x900 
0x37CA2318, 38092264264727512, 225914662, 225914670, 8, 1440x900 
0x37CA2318, 38092264265584360, 225914747, 225914755, 8, 1440x900 
0x37CA2318, 38092264266050184, 225914793, 225914801, 8, 1440x900 
0x37CA2318, 38092264266718176, 225914863, 225914871, 8, 1440x900 
0x37CA2318, 38092264267371520, 225914928, 225914936, 8, 1440x900 
0x37CA2318, 38092264268226456, 225915013, 225915021, 8, 1440x900 
0x37CA2318, 38092264268702344, 225915058, 225915067, 9, 1440x900 
0x37CA2318, 38092264269362240, 225915128, 225915136, 8, 1440x900 
0x37CA2318, 38092264270206344, 225915208, 225915217, 9, 1440x900 
0x37CA2318, 38092264270867944, 225915272, 225915279, 7, 1440x900 
0x37CA2318, 38092264271332752, 225915318, 225915326, 8, 1440x900 
0x37CA2318, 38092264272188120, 225915406, 225915413, 7, 1440x900 
0x37CA2318, 38092264272851648, 225915472, 225915481, 9, 1440x900 
0x37CA2318, 38092264273510064, 225915543, 225915551, 8, 1440x900 
0x37CA2318, 38092264273984232, 225915589, 225915597, 8, 1440x900 
0x37CA2318, 38092264274832480, 225915673, 225915681, 8, 1440x900 
0x37CA2318, 38092264275299328, 225915718, 225915727, 9, 1440x900 
0x37CA2318, 38092264275959024, 225915782, 225915791, 9, 1440x900 
0x37CA2318, 38092264276626152, 225915853, 225915861, 8, 1440x900 
0x37CA2318, 38092264277281832, 225915918, 225915926, 8, 1440x900 
0x37CA2318, 38092264278128544, 225916003, 225916011, 8, 1440x900 
0x37CA2318, 38092264278782912, 225916067, 225916075, 8, 1440x900 
0x37CA2318, 38092264279451936, 225916137, 225916146, 9, 1440x900 
0x37CA2318, 38092264279935344, 225916183, 225916191, 8, 1440x900 
0x37CA2318, 38092264280774936, 225916262, 225916269, 7, 1440x900 
0x37CA2318, 38092264281450528, 225916331, 225916339, 8, 1440x900 
0x37CA2318, 38092264281941504, 225916381, 225916389, 8, 1440x900 
0x37CA2318, 38092264282761792, 225916462, 225916469, 7, 1440x900 
0x37CA2318, 38092264283234424, 225916513, 225916522, 9, 1440x900 
0x37CA2318, 38092264283894160, 225916583, 225916591, 8, 1440x900 
0x37CA2318, 38092264284559824, 225916644, 225916652, 8, 1440x900 
0x37CA2318, 38092264285234960, 225916712, 225916720, 8, 1440x900 
0x37CA2318, 38092264286085280, 225916798, 225916806, 8, 1440x900 
0x37CA2318, 38092264286754472, 225916868, 225916876, 8, 1440x900 
0x37CA2318, 38092264287221256, 225916913, 225916921, 8, 1440x900 
0x37CA2318, 38092264288725928, 225917063, 225917071, 8, 1440x900 
0x37CA2318, 38092264289386600, 225917128, 225917136, 8, 1440x900 
0x37CA2318, 38092264289862112, 225917178, 225917186, 8, 1440x900 
0x37CA2318, 38092264290513912, 225917243, 225917252, 9, 1440x900 
0x37CA2318, 38092264291171656, 225917302, 225917310, 8, 1440x900 
0x37CA2318, 38092264291838736, 225917373, 225917382, 9, 1440x900 
0x37CA2318, 38092264292500072, 225917438, 225917446, 8, 1440x900 
0x37CA2318, 38092264293153720, 225917503, 225917511, 8, 1440x900 
0x37CA2318, 38092264293924552, 225917583, 225917591, 8, 1440x900 
0x37CA2318, 38092264294476312, 225917638, 225917647, 9, 1440x900 
0x37CA2318, 38092264295138264, 225917702, 225917710, 8, 1440x900 
0x37CA2318, 38092264295794936, 225917768, 225917776, 8, 1440x900 
0x37CA2318, 38092264296455088, 225917838, 225917846, 8, 1440x900 
0x37CA2318, 38092264297132696, 225917903, 225917911, 8, 1440x900 
0x37CA2318, 38092264297799144, 225917968, 225917976, 8, 1440x900 
0x37CA2318, 38092264298451920, 225918034, 225918042, 8, 1440x900 
0x37CA2318, 38092264299126088, 225918102, 225918110, 8, 1440x900 
0x37CA2318, 38092264299789200, 225918167, 225918175, 8, 1440x900 
0x37CA2318, 38092264300442984, 225918232, 225918241, 9, 1440x900 
0x37CA2318, 38092264301102208, 225918303, 225918311, 8, 1440x900 
0x37CA2318, 38092264301761080, 225918362, 225918370, 8, 1440x900 
0x37CA2318, 38092264302425256, 225918428, 225918436, 8, 1440x900 
0x37CA2318, 38092264303287568, 225918516, 225918523, 7, 1440x900 
0x37CA2318, 38092264303742408, 225918562, 225918570, 8, 1440x900 
0x37CA2318, 38092264304405312, 225918628, 225918636, 8, 1440x900 
0x37CA2318, 38092264305067200, 225918692, 225918699, 7, 1440x900 
0x37CA2318, 38092264305929320, 225918778, 225918786, 8, 1440x900 
0x37CA2318, 38092264306590328, 225918848, 225918856, 8, 1440x900 
0x37CA2318, 38092264307046400, 225918894, 225918902, 8, 1440x900 
0x37CA2318, 38092264307715424, 225918963, 225918971, 8, 1440x900 
0x37CA2318, 38092264308366368, 225919024, 225919032, 8, 1440x900 
0x37CA2318, 38092264309233224, 225919113, 225919121, 8, 1440x900 
0x37CA2318, 38092264309696400, 225919158, 225919166, 8, 1440x900 
0x37CA2318, 38092264310350616, 225919223, 225919232, 9, 1440x900 
0x37CA2318, 38092264311011552, 225919292, 225919300, 8, 1440x900 
0x37CA2318, 38092264311672016, 225919359, 225919368, 9, 1440x900 
0x37CA2318, 38092264312338096, 225919422, 225919430, 8, 1440x900 
0x37CA2318, 38092264312992616, 225919489, 225919497, 8, 1440x900 
0x37CA2318, 38092264313651792, 225919553, 225919562, 9, 1440x900 
0x37CA2318, 38092264314499984, 225919643, 225919651, 8, 1440x900 
0x37CA2318, 38092264314982528, 225919688, 225919697, 9, 1440x900 
0x37CA2318, 38092264315764232, 225919767, 225919775, 8, 1440x900 
0x37CA2318, 38092264316293632, 225919817, 225919825, 8, 1440x900 
0x37CA2318, 38092264316952520, 225919883, 225919891, 8, 1440x900 
0x37CA2318, 38092264317620664, 225919953, 225919961, 8, 1440x900 
0x37CA2318, 38092264318475280, 225920033, 225920041, 8, 1440x900 
0x37CA2318, 38092264319130280, 225920103, 225920111, 8, 1440x900 
0x37CA2318, 38092264319663424, 225920153, 225920162, 9, 1440x900 
0x37CA2318, 38092264320462576, 225920237, 225920245, 8, 1440x900 
0x37CA2318, 38092264321104008, 225920299, 225920307, 8, 1440x900 
0x37CA2318, 38092264321771664, 225920368, 225920376, 8, 1440x900 
0x37CA2318, 38092264322243024, 225920412, 225920420, 8, 1440x900 
0x37CA2318, 38092264323083768, 225920494, 225920501, 7, 1440x900 
0x37CA2318, 38092264323763296, 225920562, 225920570, 8, 1440x900 
0x37CA2318, 38092264324424528, 225920628, 225920635, 7, 1440x900 
0x37CA2318, 38092264324892976, 225920678, 225920685, 7, 1440x900 
0x37CA2318, 38092264325745704, 225920763, 225920771, 8, 1440x900 
0x37CA2318, 38092264326406512, 225920828, 225920837, 9, 1440x900 
0x37CA2318, 38092264327075120, 225920897, 225920904, 7, 1440x900 
0x37CA2318, 38092264327531688, 225920938, 225920945, 7, 1440x900 
0x37CA2318, 38092264328387064, 225921027, 225921035, 8, 1440x900 
0x37CA2318, 38092264329047016, 225921093, 225921101, 8, 1440x900 
0x37CA2318, 38092264329674624, 225921157, 225921165, 8, 1440x900 
0x37CA2318, 38092264330370040, 225921228, 225921236, 8, 1440x900 
0x37CA2318, 38092264331039632, 225921293, 225921301, 8, 1440x900 
0x37CA2318, 38092264331691592, 225921357, 225921365, 8, 1440x900 
0x37CA2318, 38092264332183176, 225921408, 225921416, 8, 1440x900 
0x37CA2318, 38092264333021936, 225921488, 225921495, 7, 1440x900 
0x37CA2318, 38092264333682912, 225921556, 225921563, 7, 1440x900 
0x37CA2318, 38092264334334152, 225921619, 225921627, 8, 1440x900 
0x37CA2318, 38092264334802888, 225921667, 225921674, 7, 1440x900 
0x37CA2318, 38092264335662312, 225921752, 225921760, 8, 1440x900 
0x37CA2318, 38092264336322544, 225921823, 225921831, 8, 1440x900 
0x37CA2318, 38092264336991008, 225921888, 225921896, 8, 1440x900 
0x37CA2318, 38092264337456064, 225921932, 225921939, 7, 1440x900 
0x37CA2318, 38092264338301888, 225922017, 225922025, 8, 1440x900 
0x37CA2318, 38092264338968936, 225922083, 225922091, 8, 1440x900 
0x37CA2318, 38092264339508000, 225922137, 225922144, 7, 1440x900 
0x37CA2318, 38092264340294920, 225922216, 225922224, 8, 1440x900 
0x37CA2318, 38092264340948696, 225922282, 225922289, 7, 1440x900 
0x37CA2318, 38092264341611280, 225922347, 225922356, 9, 1440x900 
0x37CA2318, 38092264342088448, 225922398, 225922406, 8, 1440x900 
0x37CA2318, 38092264342747864, 225922467, 225922475, 8, 1440x900 
0x37CA2318, 38092264343599552, 225922548, 225922556, 8, 1440x900 
0x37CA2318, 38092264344254600, 225922615, 225922624, 9, 1440x900 
0x37CA2318, 38092264345580264, 225922743, 225922751, 8, 1440x900 
0x37CA2318, 38092264346234912, 225922813, 225922821, 8, 1440x900 
0x37CA2318, 38092264346905928, 225922878, 225922887, 9, 1440x900 
0x37CA2318, 38092264347381088, 225922927, 225922935, 8, 1440x900 
0x37CA2318, 38092264348236488, 225923012, 225923020, 8, 1440x900 
0x37CA2318, 38092264348905728, 225923082, 225923090, 8, 1440x900 
0x37CA2318, 38092264349555288, 225923143, 225923151, 8, 1440x900 
0x37CA2318, 38092264350029976, 225923192, 225923200, 8, 1440x900 
0x37CA2318, 38092264350869864, 225923273, 225923282, 9, 1440x900 
0x37CA2318, 38092264351539992, 225923343, 225923351, 8, 1440x900 
0x37CA2318, 38092264352199480, 225923412, 225923420, 8, 1440x900 
0x37CA2318, 38092264352862016, 225923473, 225923482, 9, 1440x900 
0x37CA2318, 38092264353519472, 225923538, 225923547, 9, 1440x900 
0x37CA2318, 38092264354180160, 225923607, 225923615, 8, 1440x900 
0x37CA2318, 38092264354655552, 225923657, 225923665, 8, 1440x900 
0x37CA2318, 38092264355495504, 225923738, 225923746, 8, 1440x900 
0x37CA2318, 38092264356173360, 225923803, 225923812, 9, 1440x900 
0x37CA2318, 38092264356824488, 225923872, 225923880, 8, 1440x900 
0x37CA2318, 38092264357300408, 225923922, 225923930, 8, 1440x900 
0x37CA2318, 38092264358154968, 225924004, 225924012, 8, 1440x900 
0x37CA2318, 38092264358817760, 225924068, 225924076, 8, 1440x900 
0x37CA2318, 38092264359486704, 225924142, 225924150, 8, 1440x900 
0x37CA2318, 38092264359953104, 225924183, 225924191, 8, 1440x900 
0x37CA2318, 38092264360791408, 225924268, 225924276, 8, 1440x900 
0x37CA2318, 38092264361462408, 225924334, 225924342, 8, 1440x900 
0x37CA2318, 38092264362123712, 225924402, 225924410, 8, 1440x900 
0x37CA2318, 38092264362597064, 225924448, 225924456, 8, 1440x900 
0x37CA2318, 38092264363452768, 225924533, 225924541, 8, 1440x900 
0x37CA2318, 38092264364103048, 225924597, 225924606, 9, 1440x900 
0x37CA2318, 38092264364716776, 225924659, 225924667, 8, 1440x900 
0x37CA2318, 38092264365419688, 225924728, 225924736, 8, 1440x900 
0x37CA2318, 38092264366084496, 225924794, 225924802, 8, 1440x900 
0x37CA2318, 38092264366742768, 225924861, 225924869, 8, 1440x900 
0x37CA2318, 38092264367211960, 225924908, 225924915, 7, 1440x900 
0x37CA2318, 38092264368063960, 225924993, 225925001, 8, 1440x900 
0x37CA2318, 38092264368723912, 225925058, 225925067, 9, 1440x900 
0x37CA2318, 38092264369383504, 225925128, 225925136, 8, 1440x900 
0x37CA2318, 38092264369865600, 225925177, 225925185, 8, 1440x900 
0x37CA2318, 38092264370716032, 225925263, 225925271, 8, 1440x900 
0x37CA2318, 38092264371367120, 225925327, 225925335, 8, 1440x900 
0x37CA2318, 38092264372040320, 225925392, 225925401, 9, 1440x900 
0x37CA2318, 38092264372509056, 225925437, 225925446, 9, 1440x900 
0x37CA2318, 38092264373354408, 225925522, 225925530, 8, 1440x900 
0x37CA2318, 38092264374015312, 225925593, 225925601, 8, 1440x900 
0x37CA2318, 38092264374674560, 225925659, 225925666, 7, 1440x900 
0x37CA2318, 38092264375143176, 225925701, 225925709, 8, 1440x900 
0x37CA2318, 38092264375991952, 225925787, 225925795, 8, 1440x900 
0x37CA2318, 38092264376663288, 225925853, 225925862, 9, 1440x900 
0x37CA2318, 38092264377137368, 225925903, 225925911, 8, 1440x900 
0x37CA2318, 38092264377983520, 225925988, 225925996, 8, 1440x900 
0x37CA2318, 38092264378644928, 225926053, 225926061, 8, 1440x900 
0x37CA2318, 38092264379312928, 225926120, 225926129, 9, 1440x900 
0x37CA2318, 38092264379784144, 225926163, 225926171, 8, 1440x900 
0x37CA2318, 38092264380644704, 225926253, 225926261, 8, 1440x900 
0x37CA2318, 38092264381298048, 225926318, 225926326, 8, 1440x900 
0x37CA2318, 38092264381958640, 225926384, 225926393, 9, 1440x900 
0x37CA2318, 38092264382431344, 225926432, 225926444, 12, 1440x900 
0x37CA2318, 38092264383280768, 225926512, 225926520, 8, 1440x900 
0x37CA2318, 38092264383940888, 225926578, 225926586, 8, 1440x900 
0x37CA2318, 38092264384555224, 225926641, 225926649, 8, 1440x900 
0x37CA2318, 38092264385255360, 225926717, 225926725, 8, 1440x900 
0x37CA2318, 38092264385918872, 225926783, 225926791, 8, 1440x900 
0x37CA2318, 38092264386589024, 225926846, 225926854, 8, 1440x900 
0x37CA2318, 38092264387058896, 225926892, 225926900, 8, 1440x900 
0x37CA2318, 38092264387910792, 225926977, 225926985, 8, 1440x900 
0x37CA2318, 38092264388563136, 225927042, 225927049, 7, 1440x900 
0x37CA2318, 38092264389234480, 225927109, 225927117, 8, 1440x900 
0x37CA2318, 38092264389727896, 225927157, 225927165, 8, 1440x900 
0x37CA2318, 38092264390554600, 225927243, 225927250, 7, 1440x900 
0x37CA2318, 38092264391222624, 225927308, 225927315, 7, 1440x900 
0x37CA2318, 38092264391885776, 225927378, 225927386, 8, 1440x900 
0x37CA2318, 38092264392351744, 225927427, 225927435, 8, 1440x900 
0x37CA2318, 38092264393199632, 225927508, 225927516, 8, 1440x900 
0x37CA2318, 38092264393862304, 225927578, 225927586, 8, 1440x900 
0x37CA2318, 38092264394516944, 225927643, 225927651, 8, 1440x900 
0x37CA2318, 38092264394995112, 225927688, 225927696, 8, 1440x900 
0x37CA2318, 38092264395848344, 225927777, 225927785, 8, 1440x900 
0x37CA2318, 38092264396509352, 225927838, 225927845, 7, 1440x900 
0x37CA2318, 38092264397070568, 225927892, 225927900, 8, 1440x900 
0x37CA2318, 38092264397831160, 225927972, 225927980, 8, 1440x900 
0x37CA2318, 38092264398485416, 225928039, 225928047, 8, 1440x900 
0x37CA2318, 38092264399145216, 225928102, 225928109, 7, 1440x900 
0x37CA2318, 38092264399618512, 225928148, 225928156, 8, 1440x900 
0x37CA2318, 38092264400473112, 225928233, 225928242, 9, 1440x900 
0x37CA2318, 38092264401132952, 225928302, 225928310, 8, 1440x900 
0x37CA2318, 38092264401803328, 225928369, 225928377, 8, 1440x900 
0x37CA2318, 38092264402264920, 225928413, 225928422, 9, 1440x900 
0x37CA2318, 38092264403108456, 225928497, 225928506, 9, 1440x900 
0x37CA2318, 38092264403777984, 225928568, 225928576, 8, 1440x900 
0x37CA2318, 38092264404438200, 225928633, 225928641, 8, 1440x900 
0x37CA2318, 38092264405751840, 225928762, 225928771, 9, 1440x900 
0x37CA2318, 38092264406416896, 225928833, 225928841, 8, 1440x900 
0x37CA2318, 38092264407099976, 225928897, 225928906, 9, 1440x900 
0x37CA2318, 38092264407737672, 225928963, 225928971, 8, 1440x900 
0x37CA2318, 38092264408408616, 225929027, 225929036, 9, 1440x900 
0x37CA2318, 38092264409058856, 225929093, 225929100, 7, 1440x900 
0x37CA2318, 38092264409584472, 225929148, 225929156, 8, 1440x900 
0x37CA2318, 38092264410397912, 225929228, 225929236, 8, 1440x900 
0x37CA2318, 38092264411041256, 225929292, 225929300, 8, 1440x900 
0x37CA2318, 38092264411702200, 225929357, 225929366, 9, 1440x900 
0x37CA2318, 38092264412172704, 225929404, 225929412, 8, 1440x900 
0x37CA2318, 38092264413018640, 225929492, 225929500, 8, 1440x900 
0x37CA2318, 38092264413679552, 225929558, 225929566, 8, 1440x900 
0x37CA2318, 38092264414337408, 225929623, 225929631, 8, 1440x900 
0x37CA2318, 38092264414812912, 225929668, 225929677, 9, 1440x900 
0x37CA2318, 38092264415667320, 225929753, 225929762, 9, 1440x900 
0x37CA2318, 38092264416318880, 225929823, 225929831, 8, 1440x900 
0x37CA2318, 38092264416978296, 225929888, 225929896, 8, 1440x900 
0x37CA2318, 38092264417447952, 225929932, 225929939, 7, 1440x900 
0x37CA2318, 38092264418310960, 225930017, 225930026, 9, 1440x900 
0x37CA2318, 38092264418962456, 225930088, 225930097, 9, 1440x900 
0x37CA2318, 38092264419608576, 225930148, 225930156, 8, 1440x900 
0x37CA2318, 38092264420284088, 225930217, 225930225, 8, 1440x900 
0x37CA2318, 38092264420938352, 225930287, 225930295, 8, 1440x900 
0x37CA2318, 38092264421608568, 225930347, 225930356, 9, 1440x900 
0x37CA2318, 38092264422101416, 225930397, 225930404, 7, 1440x900 
0x37CA2318, 38092264422922440, 225930478, 225930485, 7, 1440x900 
0x37CA2318, 38092264423593944, 225930547, 225930555, 8, 1440x900 
0x37CA2318, 38092264424264104, 225930613, 225930622, 9, 1440x900 
0x37CA2318, 38092264424794136, 225930670, 225930678, 8, 1440x900 
0x37CA2318, 38092264425573256, 225930742, 225930750, 8, 1440x900 
0x37CA2318, 38092264426244080, 225930811, 225930819, 8, 1440x900 
0x37CA2318, 38092264426895616, 225930878, 225930885, 7, 1440x900 
0x37CA2318, 38092264427363456, 225930923, 225930930, 7, 1440x900 
0x37CA2318, 38092264428218240, 225931012, 225931020, 8, 1440x900 
0x37CA2318, 38092264428887936, 225931077, 225931085, 8, 1440x900 
0x37CA2318, 38092264429541376, 225931143, 225931151, 8, 1440x900 
0x37CA2318, 38092264430012320, 225931190, 225931198, 8, 1440x900 
0x37CA2318, 38092264430862496, 225931273, 225931281, 8, 1440x900 
0x37CA2318, 38092264431514384, 225931339, 225931347, 8, 1440x900 
0x37CA2318, 38092264432124976, 225931403, 225931411, 8, 1440x900 
0x37CA2318, 38092264432845568, 225931472, 225931481, 9, 1440x900 
0x37CA2318, 38092264433505592, 225931542, 225931550, 8, 1440x900 
0x37CA2318, 38092264434166144, 225931603, 225931612, 9, 1440x900 
0x37CA2318, 38092264434640128, 225931652, 225931660, 8, 1440x900 
0x37CA2318, 38092264435487592, 225931737, 225931745, 8, 1440x900 
0x37CA2318, 38092264436149992, 225931807, 225931815, 8, 1440x900 
0x37CA2318, 38092264436812568, 225931872, 225931880, 8, 1440x900 
0x37CA2318, 38092264437300928, 225931918, 225931927, 9, 1440x900 
0x37CA2318, 38092264438130280, 225932002, 225932010, 8, 1440x900 
0x37CA2318, 38092264438797904, 225932072, 225932080, 8, 1440x900 
0x37CA2318, 38092264439450560, 225932133, 225932142, 9, 1440x900 
0x37CA2318, 38092264439935376, 225932183, 225932191, 8, 1440x900 
0x37CA2318, 38092264440784312, 225932268, 225932276, 8, 1440x900 
0x37CA2318, 38092264441435208, 225932333, 225932341, 8, 1440x900 
0x37CA2318, 38092264442096136, 225932397, 225932406, 9, 1440x900 
0x37CA2318, 38092264442573888, 225932447, 225932455, 8, 1440x900 
0x37CA2318, 38092264443421472, 225932532, 225932541, 9, 1440x900 
0x37CA2318, 38092264444078304, 225932598, 225932606, 8, 1440x900 
0x37CA2318, 38092264444755344, 225932663, 225932672, 9, 1440x900 
0x37CA2318, 38092264445220496, 225932713, 225932721, 8, 1440x900 
0x37CA2318, 38092264446067736, 225932797, 225932805, 8, 1440x900 
0x37CA2318, 38092264446730712, 225932863, 225932871, 8, 1440x900 
0x37CA2318, 38092264447307160, 225932918, 225932927, 9, 1440x900 
0x37CA2318, 38092264448050392, 225932992, 225933000, 8, 1440x900 
0x37CA2318, 38092264448710920, 225933063, 225933071, 8, 1440x900 
0x37CA2318, 38092264449373208, 225933127, 225933135, 8, 1440x900 
0x37CA2318, 38092264449844504, 225933172, 225933180, 8, 1440x900 
0x37CA2318, 38092264450687192, 225933257, 225933266, 9, 1440x900 
0x37CA2318, 38092264451348960, 225933323, 225933332, 9, 1440x900 
0x37CA2318, 38092264452019552, 225933393, 225933401, 8, 1440x900 
0x37CA2318, 38092264452480160, 225933433, 225933441, 8, 1440x900 
0x37CA2318, 38092264453342520, 225933521, 225933529, 8, 1440x900 
0x37CA2318, 38092264454002824, 225933587, 225933595, 8, 1440x900 
0x37CA2318, 38092264454665016, 225933654, 225933662, 8, 1440x900 
0x37CA2318, 38092264455138080, 225933703, 225933710, 7, 1440x900 
0x37CA2318, 38092264455984224, 225933787, 225933795, 8, 1440x900 
0x37CA2318, 38092264456656208, 225933858, 225933866, 8, 1440x900 
0x37CA2318, 38092264457319280, 225933923, 225933931, 8, 1440x900 
0x37CA2318, 38092264457966888, 225933982, 225933990, 8, 1440x900 
0x37CA2318, 38092264458635256, 225934051, 225934059, 8, 1440x900 
0x37CA2318, 38092264459295632, 225934117, 225934125, 8, 1440x900 
0x37CA2318, 38092264459811888, 225934167, 225934175, 8, 1440x900 
0x37CA2318, 38092264460608424, 225934247, 225934255, 8, 1440x900 
0x37CA2318, 38092264461260896, 225934313, 225934320, 7, 1440x900 
0x37CA2318, 38092264461940968, 225934381, 225934389, 8, 1440x900 
0x37CA2318, 38092264463252480, 225934513, 225934521, 8, 1440x900 
0x37CA2318, 38092264463923000, 225934582, 225934590, 8, 1440x900 
0x37CA2318, 38092264464572920, 225934648, 225934656, 8, 1440x900 
0x37CA2318, 38092264465045824, 225934697, 225934705, 8, 1440x900 
0x37CA2318, 38092264465893032, 225934778, 225934786, 8, 1440x900 
0x37CA2318, 38092264466553808, 225934847, 225934855, 8, 1440x900 
0x37CA2318, 38092264467214360, 225934913, 225934921, 8, 1440x900 
0x37CA2318, 38092264467687488, 225934957, 225934965, 8, 1440x900 
0x37CA2318, 38092264468538816, 225935043, 225935051, 8, 1440x900 
0x37CA2318, 38092264469198096, 225935111, 225935118, 7, 1440x900 
0x37CA2318, 38092264469818576, 225935168, 225935175, 7, 1440x900 
0x37CA2318, 38092264470522368, 225935238, 225935246, 8, 1440x900 
0x37CA2318, 38092264471184592, 225935308, 225935316, 8, 1440x900 
0x37CA2318, 38092264471846768, 225935372, 225935381, 9, 1440x900 
0x37CA2318, 38092264472341600, 225935422, 225935430, 8, 1440x900 
0x37CA2318, 38092264473177008, 225935506, 225935514, 8, 1440x900 
0x37CA2318, 38092264473829024, 225935568, 225935576, 8, 1440x900 
0x37CA2318, 38092264474490512, 225935637, 225935645, 8, 1440x900 
0x37CA2318, 38092264474959040, 225935682, 225935690, 8, 1440x900 
0x37CA2318, 38092264475815728, 225935768, 225935775, 7, 1440x900 
0x37CA2318, 38092264476478896, 225935838, 225935846, 8, 1440x900 
0x37CA2318, 38092264477141456, 225935907, 225935915, 8, 1440x900 
0x37CA2318, 38092264477607936, 225935947, 225935956, 9, 1440x900 
0x37CA2318, 38092264478464160, 225936033, 225936042, 9, 1440x900 
0x37CA2318, 38092264479133568, 225936103, 225936112, 9, 1440x900 
0x37CA2318, 38092264479674648, 225936153, 225936160, 7, 1440x900 
0x37CA2318, 38092264480252544, 225936213, 225936220, 7, 1440x900 
0x37CA2318, 38092264480913160, 225936277, 225936284, 7, 1440x900 
0x37CA2318, 38092264481767312, 225936363, 225936370, 7, 1440x900 
0x37CA2318, 38092264482339720, 225936422, 225936429, 7, 1440x900 
0x37CA2318, 38092264483088016, 225936497, 225936505, 8, 1440x900 
0x37CA2318, 38092264483740688, 225936558, 225936566, 8, 1440x900 
0x37CA2318, 38092264484413080, 225936627, 225936635, 8, 1440x900 
0x37CA2318, 38092264484881168, 225936677, 225936685, 8, 1440x900 
0x37CA2318, 38092264485743728, 225936762, 225936770, 8, 1440x900 
0x37CA2318, 38092264486397136, 225936827, 225936836, 9, 1440x900 
0x37CA2318, 38092264487057624, 225936892, 225936901, 9, 1440x900 
0x37CA2318, 38092264487529752, 225936942, 225936951, 9, 1440x900 
0x37CA2318, 38092264488387184, 225937028, 225937036, 8, 1440x900 
0x37CA2318, 38092264489040168, 225937092, 225937100, 8, 1440x900 
0x37CA2318, 38092264489716184, 225937159, 225937168, 9, 1440x900 
0x37CA2318, 38092264490164344, 225937202, 225937209, 7, 1440x900 
0x37CA2318, 38092264491021944, 225937288, 225937295, 7, 1440x900 
0x37CA2318, 38092264491678624, 225937356, 225937364, 8, 1440x900 
0x37CA2318, 38092264492357456, 225937427, 225937435, 8, 1440x900 
0x37CA2318, 38092264493010120, 225937488, 225937496, 8, 1440x900 
0x37CA2318, 38092264493670208, 225937559, 225937567, 8, 1440x900 
0x37CA2318, 38092264494328400, 225937621, 225937629, 8, 1440x900 
0x37CA2318, 38092264494792216, 225937668, 225937676, 8, 1440x900 
0x37CA2318, 38092264495644144, 225937753, 225937762, 9, 1440x900 
0x37CA2318, 38092264496297480, 225937823, 225937831, 8, 1440x900 
0x37CA2318, 38092264496967080, 225937884, 225937893, 9, 1440x900 
0x37CA2318, 38092264497440552, 225937932, 225937940, 8, 1440x900 
0x37CA2318, 38092264498280960, 225938013, 225938021, 8, 1440x900 
0x37CA2318, 38092264498950480, 225938083, 225938091, 8, 1440x900 
0x37CA2318, 38092264499613800, 225938153, 225938161, 8, 1440x900 
0x37CA2318, 38092264500085784, 225938198, 225938206, 8, 1440x900 
0x37CA2318, 38092264500934448, 225938283, 225938291, 8, 1440x900 
0x37CA2318, 38092264501596008, 225938348, 225938356, 8, 1440x900 
0x37CA2318, 38092264502202944, 225938407, 225938416, 9, 1440x900 
0x37CA2318, 38092264502920736, 225938483, 225938491, 8, 1440x900 
0x37CA2318, 38092264503590416, 225938547, 225938555, 8, 1440x900 
0x37CA2318, 38092264504240888, 225938612, 225938620, 8, 1440x900 
0x37CA2318, 38092264504894632, 225938678, 225938686, 8, 1440x900 
0x37CA2318, 38092264505369536, 225938723, 225938731, 8, 1440x900 
0x37CA2318, 38092264506040096, 225938789, 225938797, 8, 1440x900 
0x37CA2318, 38092264506884672, 225938878, 225938886, 8, 1440x900 
0x37CA2318, 38092264507380296, 225938928, 225938936, 8, 1440x900 
0x37CA2318, 38092264508215808, 225939011, 225939020, 9, 1440x900 
0x37CA2318, 38092264508869640, 225939072, 225939079, 7, 1440x900 
0x37CA2318, 38092264509524840, 225939139, 225939146, 7, 1440x900 
0x37CA2318, 38092264510003936, 225939187, 225939194, 7, 1440x900 
0x37CA2318, 38092264510859288, 225939277, 225939285, 8, 1440x900 
0x37CA2318, 38092264511531832, 225939341, 225939349, 8, 1440x900 
0x37CA2318, 38092264512190240, 225939412, 225939420, 8, 1440x900 
0x37CA2318, 38092264512652752, 225939453, 225939461, 8, 1440x900 
0x37CA2318, 38092264513494016, 225939538, 225939546, 8, 1440x900 
0x37CA2318, 38092264514157936, 225939603, 225939611, 8, 1440x900 
0x37CA2318, 38092264514819888, 225939673, 225939681, 8, 1440x900 
0x37CA2318, 38092264515302624, 225939723, 225939731, 8, 1440x900 
0x37CA2318, 38092264516169280, 225939807, 225939815, 8, 1440x900 
0x37CA2318, 38092264516821664, 225939873, 225939881, 8, 1440x900 
0x37CA2318, 38092264517386432, 225939928, 225939936, 8, 1440x900 
0x37CA2318, 38092264518144272, 225940002, 225940010, 8, 1440x900 
0x37CA2318, 38092264518810304, 225940068, 225940075, 7, 1440x900 
0x37CA2318, 38092264519474680, 225940136, 225940144, 8, 1440x900 
0x37CA2318, 38092264519935288, 225940181, 225940189, 8, 1440x900 
0x37CA2318, 38092264520790248, 225940268, 225940276, 8, 1440x900 
0x37CA2318, 38092264521455928, 225940334, 225940342, 8, 1440x900 
0x37CA2318, 38092264522107736, 225940398, 225940407, 9, 1440x900 
0x37CA2318, 38092264523431728, 225940533, 225940541, 8, 1440x900 
0x37CA2318, 38092264524094296, 225940597, 225940606, 9, 1440x900 
0x37CA2318, 38092264524746296, 225940663, 225940671, 8, 1440x900 
0x37CA2318, 38092264525229216, 225940713, 225940720, 7, 1440x900 
0x37CA2318, 38092264526085552, 225940799, 225940807, 8, 1440x900 
0x37CA2318, 38092264526744704, 225940862, 225940870, 8, 1440x900 
0x37CA2318, 38092264527219768, 225940908, 225940916, 8, 1440x900 
0x37CA2318, 38092264528084440, 225940996, 225941004, 8, 1440x900 
0x37CA2318, 38092264528737632, 225941062, 225941071, 9, 1440x900 
0x37CA2318, 38092264529407632, 225941133, 225941141, 8, 1440x900 
0x37CA2318, 38092264529864048, 225941178, 225941186, 8, 1440x900 
0x37CA2318, 38092264530530744, 225941242, 225941250, 8, 1440x900 
0x37CA2318, 38092264531184432, 225941313, 225941321, 8, 1440x900 
0x37CA2318, 38092264531845488, 225941372, 225941381, 9, 1440x900 
0x37CA2318, 38092264532511736, 225941443, 225941451, 8, 1440x900 
0x37CA2318, 38092264533164400, 225941508, 225941516, 8, 1440x900 
0x37CA2318, 38092264533826808, 225941572, 225941580, 8, 1440x900 
0x37CA2318, 38092264534494400, 225941638, 225941646, 8, 1440x900 
0x37CA2318, 38092264535153768, 225941702, 225941711, 9, 1440x900 
0x37CA2318, 38092264536012568, 225941793, 225941801, 8, 1440x900 
0x37CA2318, 38092264536480832, 225941838, 225941847, 9, 1440x900 
0x37CA2318, 38092264537331328, 225941918, 225941925, 7, 1440x900 
0x37CA2318, 38092264537974896, 225941983, 225941991, 8, 1440x900 
0x37CA2318, 38092264538566320, 225942043, 225942050, 7, 1440x900 
0x37CA2318, 38092264539306392, 225942118, 225942127, 9, 1440x900 
0x37CA2318, 38092264539966296, 225942188, 225942196, 8, 1440x900 
0x37CA2318, 38092264540635768, 225942252, 225942261, 9, 1440x900 
0x37CA2318, 38092264541092976, 225942298, 225942306, 8, 1440x900 
0x37CA2318, 38092264541760512, 225942368, 225942376, 8, 1440x900 
0x37CA2318, 38092264542423920, 225942433, 225942441, 8, 1440x900 
0x37CA2318, 38092264543090776, 225942498, 225942506, 8, 1440x900 
0x37CA2318, 38092264543760320, 225942563, 225942572, 9, 1440x900 
0x37CA2318, 38092264544410360, 225942633, 225942641, 8, 1440x900 
0x37CA2318, 38092264545071216, 225942698, 225942706, 8, 1440x900 
0x37CA2318, 38092264545730704, 225942762, 225942770, 8, 1440x900 
0x37CA2318, 38092264546407928, 225942832, 225942840, 8, 1440x900 
0x37CA2318, 38092264547058288, 225942892, 225942900, 8, 1440x900 
0x37CA2318, 38092264547718136, 225942958, 225942965, 7, 1440x900 
0x37CA2318, 38092264548376720, 225943026, 225943034, 8, 1440x900 
0x37CA2318, 38092264549044256, 225943091, 225943099, 8, 1440x900 
0x37CA2318, 38092264549699160, 225943158, 225943167, 9, 1440x900 
0x37CA2318, 38092264550361776, 225943227, 225943235, 8, 1440x900 
0x37CA2318, 38092264551022224, 225943292, 225943300, 8, 1440x900 
0x37CA2318, 38092264551690912, 225943357, 225943365, 8, 1440x900 
0x37CA2318, 38092264552533624, 225943442, 225943450, 8, 1440x900 
0x37CA2318, 38092264553009576, 225943488, 225943496, 8, 1440x900 
0x37CA2318, 38092264553678232, 225943558, 225943566, 8, 1440x900 
0x37CA2318, 38092264554336904, 225943622, 225943630, 8, 1440x900 
0x37CA2318, 38092264554991024, 225943689, 225943697, 8, 1440x900 
0x37CA2318, 38092264555649744, 225943753, 225943761, 8, 1440x900 
0x37CA2318, 38092264556321496, 225943823, 225943831, 8, 1440x900 
0x37CA2318, 38092264556969472, 225943883, 225943891, 8, 1440x900 
0x37CA2318, 38092264557631616, 225943953, 225943961, 8, 1440x900 
0x37CA2318, 38092264558302496, 225944018, 225944025, 7, 1440x900 
0x37CA2318, 38092264559153832, 225944099, 225944107, 8, 1440x900 
0x37CA2318, 38092264559819776, 225944167, 225944174, 7, 1440x900 
0x37CA2318, 38092264560278336, 225944217, 225944224, 7, 1440x900 
0x37CA2318, 38092264560955760, 225944282, 225944290, 8, 1440x900 
0x37CA2318, 38092264561610344, 225944348, 225944357, 9, 1440x900 
0x37CA2318, 38092264562270136, 225944417, 225944425, 8, 1440x900 
0x37CA2318, 38092264562930448, 225944483, 225944492, 9, 1440x900 
0x37CA2318, 38092264563603024, 225944548, 225944557, 9, 1440x900 
0x37CA2318, 38092264564323520, 225944623, 225944631, 8, 1440x900 
0x37CA2318, 38092264564926824, 225944682, 225944690, 8, 1440x900 
0x37CA2318, 38092264565588992, 225944748, 225944756, 8, 1440x900 
0x37CA2318, 38092264566253936, 225944813, 225944821, 8, 1440x900 
0x37CA2318, 38092264567112672, 225944902, 225944910, 8, 1440x900 
0x37CA2318, 38092264567771920, 225944968, 225944976, 8, 1440x900 
0x37CA2318, 38092264568235320, 225945013, 225945022, 9, 1440x900 
0x37CA2318, 38092264568884816, 225945073, 225945081, 8, 1440x900 
0x37CA2318, 38092264569553336, 225945147, 225945155, 8, 1440x900 
0x37CA2318, 38092264570210744, 225945208, 225945217, 9, 1440x900 
0x37CA2318, 38092264570880848, 225945278, 225945286, 8, 1440x900 
0x37CA2318, 38092264571733264, 225945363, 225945371, 8, 1440x900 
0x37CA2318, 38092264572299512, 225945418, 225945426, 8, 1440x900 
0x37CA2318, 38092264573057504, 225945492, 225945501, 9, 1440x900 
0x37CA2318, 38092264573522168, 225945542, 225945550, 8, 1440x900 
0x37CA2318, 38092264574182712, 225945608, 225945616, 8, 1440x900 
0x37CA2318, 38092264574857416, 225945674, 225945683, 9, 1440x900 
0x37CA2318, 38092264575535536, 225945741, 225945748, 7, 1440x900 
0x37CA2318, 38092264576203592, 225945808, 225945816, 8, 1440x900 
0x37CA2318, 38092264576829720, 225945869, 225945877, 8, 1440x900 
0x37CA2318, 38092264577489744, 225945933, 225945942, 9, 1440x900 
0x37CA2318, 38092264578153032, 225946003, 225946011, 8, 1440x900 
0x37CA2318, 38092264578809288, 225946073, 225946082, 9, 1440x900 
0x37CA2318, 38092264579482120, 225946137, 225946145, 8, 1440x900 
0x37CA2318, 38092264580162848, 225946207, 225946215, 8, 1440x900 
0x37CA2318, 38092264580804608, 225946272, 225946281, 9, 1440x900 
0x37CA2318, 38092264581460888, 225946332, 225946339, 7, 1440x900 
0x37CA2318, 38092264582121416, 225946398, 225946404, 6, 1440x900 
0x37CA2318, 38092264582788152, 225946467, 225946475, 8, 1440x900 
0x37CA2318, 38092264583441856, 225946532, 225946539, 7, 1440x900 
0x37CA2318, 38092264584242272, 225946613, 225946621, 8, 1440x900 
0x37CA2318, 38092264584799280, 225946668, 225946676, 8, 1440x900 
0x37CA2318, 38092264585474808, 225946738, 225946746, 8, 1440x900 
0x37CA2318, 38092264586278664, 225946818, 225946826, 8, 1440x900 
0x37CA2318, 38092264586947704, 225946884, 225946893, 9, 1440x900 
0x37CA2318, 38092264588260080, 225947013, 225947022, 9, 1440x900 
0x37CA2318, 38092264588922560, 225947082, 225947090, 8, 1440x900 
0x37CA2318, 38092264589573424, 225947147, 225947155, 8, 1440x900 
0x37CA2318, 38092264590044936, 225947188, 225947196, 8, 1440x900 
0x37CA2318, 38092264590701616, 225947256, 225947263, 7, 1440x900 
0x37CA2318, 38092264591553704, 225947342, 225947349, 7, 1440x900 
0x37CA2318, 38092264592216944, 225947408, 225947415, 7, 1440x900 
0x37CA2318, 38092264592684328, 225947453, 225947461, 8, 1440x900 
0x37CA2318, 38092264593340696, 225947521, 225947528, 7, 1440x900 
0x37CA2318, 38092264594005248, 225947587, 225947594, 7, 1440x900 
0x37CA2318, 38092264594663016, 225947653, 225947660, 7, 1440x900 
0x37CA2318, 38092264595330048, 225947722, 225947729, 7, 1440x900 
0x37CA2318, 38092264596185480, 225947806, 225947814, 8, 1440x900 
0x37CA2318, 38092264596845528, 225947872, 225947879, 7, 1440x900 
0x37CA2318, 38092264597308056, 225947918, 225947925, 7, 1440x900 
0x37CA2318, 38092264598158536, 225948003, 225948011, 8, 1440x900 
0x37CA2318, 38092264598821080, 225948072, 225948080, 8, 1440x900 
0x37CA2318, 38092264599473888, 225948138, 225948146, 8, 1440x900 
0x37CA2318, 38092264599955224, 225948188, 225948196, 8, 1440x900 
0x37CA2318, 38092264600602656, 225948247, 225948254, 7, 1440x900 
0x37CA2318, 38092264601271376, 225948313, 225948322, 9, 1440x900 
0x37CA2318, 38092264602131432, 225948403, 225948412, 9, 1440x900 
0x37CA2318, 38092264602601480, 225948448, 225948456, 8, 1440x900 
0x37CA2318, 38092264603459344, 225948533, 225948542, 9, 1440x900 
0x37CA2318, 38092264604128960, 225948603, 225948611, 8, 1440x900 
0x37CA2318, 38092264604777512, 225948667, 225948675, 8, 1440x900 
0x37CA2318, 38092264605251360, 225948713, 225948721, 8, 1440x900 
0x37CA2318, 38092264606108152, 225948802, 225948810, 8, 1440x900 
0x37CA2318, 38092264606769648, 225948867, 225948875, 8, 1440x900 
0x37CA2318, 38092264607320360, 225948923, 225948931, 8, 1440x900 
0x37CA2318, 38092264608090104, 225948997, 225949005, 8, 1440x900 
0x37CA2318, 38092264608750456, 225949062, 225949071, 9, 1440x900 
0x37CA2318, 38092264609403168, 225949129, 225949138, 9, 1440x900 
0x37CA2318, 38092264609882176, 225949179, 225949186, 7, 1440x900 
0x37CA2318, 38092264610728112, 225949257, 225949265, 8, 1440x900 
0x37CA2318, 38092264611407552, 225949327, 225949335, 8, 1440x900 
0x37CA2318, 38092264612062456, 225949398, 225949406, 8, 1440x900 
0x37CA2318, 38092264612532384, 225949444, 225949452, 8, 1440x900 
0x37CA2318, 38092264613185560, 225949509, 225949516, 7, 1440x900 
0x37CA2318, 38092264613845552, 225949575, 225949583, 8, 1440x900 
0x37CA2318, 38092264614509280, 225949642, 225949650, 8, 1440x900 
0x37CA2318, 38092264615178112, 225949708, 225949716, 8, 1440x900 
0x37CA2318, 38092264615829896, 225949774, 225949782, 8, 1440x900 
0x37CA2318, 38092264616490032, 225949838, 225949847, 9, 1440x900 
0x37CA2318, 38092264617337008, 225949924, 225949932, 8, 1440x900 
0x37CA2318, 38092264618003856, 225949988, 225949996, 8, 1440x900 
0x37CA2318, 38092264618482080, 225950038, 225950046, 8, 1440x900 
0x37CA2318, 38092264619131016, 225950103, 225950111, 8, 1440x900 
0x37CA2318, 38092264619790880, 225950168, 225950175, 7, 1440x900 
0x37CA2318, 38092264620463312, 225950238, 225950246, 8, 1440x900 
0x37CA2318, 38092264621320544, 225950323, 225950330, 7, 1440x900 
0x37CA2318, 38092264621980160, 225950388, 225950396, 8, 1440x900 
0x37CA2318, 38092264622442632, 225950433, 225950442, 9, 1440x900 
0x37CA2318, 38092264623284576, 225950519, 225950527, 8, 1440x900 
0x37CA2318, 38092264623956720, 225950583, 225950593, 10, 1440x900 
0x37CA2318, 38092264624611712, 225950652, 225950660, 8, 1440x900 
0x37CA2318, 38092264625087656, 225950697, 225950705, 8, 1440x900 
0x37CA2318, 38092264625935608, 225950783, 225950791, 8, 1440x900 
0x37CA2318, 38092264626602592, 225950848, 225950856, 8, 1440x900 
0x37CA2318, 38092264627261704, 225950918, 225950926, 8, 1440x900 
0x37CA2318, 38092264627735040, 225950962, 225950970, 8, 1440x900 
0x37CA2318, 38092264628583904, 225951047, 225951055, 8, 1440x900 
0x37CA2318, 38092264629253520, 225951112, 225951121, 9, 1440x900 
0x37CA2318, 38092264629847832, 225951173, 225951181, 8, 1440x900 
0x37CA2318, 38092264630557264, 225951244, 225951252, 8, 1440x900 
0x37CA2318, 38092264631237168, 225951312, 225951321, 9, 1440x900 
0x37CA2318, 38092264631886944, 225951377, 225951385, 8, 1440x900 
0x37CA2318, 38092264632354816, 225951422, 225951430, 8, 1440x900 
0x37CA2318, 38092264633202160, 225951507, 225951516, 9, 1440x900 
0x37CA2318, 38092264633872048, 225951577, 225951585, 8, 1440x900 
0x37CA2318, 38092264634481016, 225951638, 225951646, 8, 1440x900 
0x37CA2318, 38092264635005016, 225951687, 225951696, 9, 1440x900 
0x37CA2318, 38092264635660120, 225951758, 225951766, 8, 1440x900 
0x37CA2318, 38092264636326272, 225951822, 225951830, 8, 1440x900 
0x37CA2318, 38092264636980752, 225951887, 225951895, 8, 1440x900 
0x37CA2318, 38092264637651480, 225951957, 225951965, 8, 1440x900 
0x37CA2318, 38092264638492744, 225952037, 225952046, 9, 1440x900 
0x37CA2318, 38092264639163688, 225952108, 225952116, 8, 1440x900 
0x37CA2318, 38092264639692112, 225952158, 225952166, 8, 1440x900 
0x37CA2318, 38092264640476384, 225952243, 225952251, 8, 1440x900 
0x37CA2318, 38092264640980832, 225952286, 225952294, 8, 1440x900 
0x37CA2318, 38092264641800872, 225952367, 225952374, 7, 1440x900 
0x37CA2318, 38092264642471048, 225952437, 225952445, 8, 1440x900 
0x37CA2318, 38092264642928920, 225952484, 225952494, 10, 1440x900 
0x37CA2318, 38092264643594216, 225952549, 225952558, 9, 1440x900 
0x37CA2318, 38092264644907512, 225952683, 225952691, 8, 1440x900 
0x37CA2318, 38092264645574128, 225952747, 225952755, 8, 1440x900 
0x37CA2318, 38092264646227752, 225952814, 225952822, 8, 1440x900 
0x37CA2318, 38092264646888600, 225952878, 225952886, 8, 1440x900 
0x37CA2318, 38092264647553360, 225952942, 225952951, 9, 1440x900 
0x37CA2318, 38092264648259184, 225953012, 225953020, 8, 1440x900 
0x37CA2318, 38092264649069432, 225953092, 225953099, 7, 1440x900 
0x37CA2318, 38092264649677464, 225953152, 225953160, 8, 1440x900 
0x37CA2318, 38092264650186192, 225953206, 225953213, 7, 1440x900 
0x37CA2318, 38092264650856352, 225953277, 225953285, 8, 1440x900 
0x37CA2318, 38092264651518032, 225953337, 225953344, 7, 1440x900 
0x37CA2318, 38092264652373392, 225953423, 225953430, 7, 1440x900 
0x37CA2318, 38092264652870704, 225953472, 225953481, 9, 1440x900 
0x37CA2318, 38092264653698872, 225953556, 225953564, 8, 1440x900 
0x37CA2318, 38092264654352672, 225953622, 225953630, 8, 1440x900 
0x37CA2318, 38092264654827432, 225953668, 225953677, 9, 1440x900 
0x37CA2318, 38092264655488520, 225953737, 225953745, 8, 1440x900 
0x37CA2318, 38092264656149384, 225953802, 225953809, 7, 1440x900 
0x37CA2318, 38092264656811984, 225953872, 225953880, 8, 1440x900 
0x37CA2318, 38092264657501552, 225953938, 225953947, 9, 1440x900 
0x37CA2318, 38092264658163088, 225954004, 225954016, 12, 1440x900 
0x37CA2318, 38092264658825840, 225954069, 225954079, 10, 1440x900 
0x37CA2318, 38092264659485616, 225954135, 225954144, 9, 1440x900 
0x37CA2318, 38092264660149568, 225954204, 225954212, 8, 1440x900 
0x37CA2318, 38092264660785344, 225954269, 225954277, 8, 1440x900 
0x37CA2318, 38092264661456816, 225954337, 225954345, 8, 1440x900 
0x37CA2318, 38092264662102472, 225954397, 225954405, 8, 1440x900 
0x37CA2318, 38092264662770312, 225954468, 225954476, 8, 1440x900 
0x37CA2318, 38092264663514464, 225954537, 225954545, 8, 1440x900 
0x37CA2318, 38092264664286200, 225954613, 225954621, 8, 1440x900 
0x37CA2318, 38092264664745640, 225954662, 225954669, 7, 1440x900 
0x37CA2318, 38092264665403536, 225954726, 225954733, 7, 1440x900 
0x37CA2318, 38092264666063664, 225954792, 225954801, 9, 1440x900 
0x37CA2318, 38092264666731104, 225954863, 225954871, 8, 1440x900 
0x37CA2318, 38092264667393720, 225954927, 225954936, 9, 1440x900 
0x37CA2318, 38092264668253040, 225955013, 225955023, 10, 1440x900 
0x37CA2318, 38092264668760136, 225955063, 225955072, 9, 1440x900 
0x37CA2318, 38092264669368592, 225955121, 225955129, 8, 1440x900 
0x37CA2318, 38092264670025392, 225955188, 225955196, 8, 1440x900 
0x37CA2318, 38092264670685392, 225955257, 225955264, 7, 1440x900 
0x37CA2318, 38092264671349384, 225955322, 225955329, 7, 1440x900 
0x37CA2318, 38092264672008888, 225955388, 225955396, 8, 1440x900 
0x37CA2318, 38092264672668000, 225955453, 225955461, 8, 1440x900 
0x37CA2318, 38092264673330512, 225955523, 225955531, 8, 1440x900 
0x37CA2318, 38092264673999112, 225955586, 225955594, 8, 1440x900 
0x37CA2318, 38092264674658184, 225955657, 225955665, 8, 1440x900 
0x37CA2318, 38092264675315576, 225955718, 225955726, 8, 1440x900 
0x37CA2318, 38092264675987600, 225955788, 225955796, 8, 1440x900 
0x37CA2318, 38092264676640784, 225955853, 225955861, 8, 1440x900 
0x37CA2318, 38092264677308480, 225955923, 225955931, 8, 1440x900 
0x37CA2318, 38092264678155344, 225956003, 225956011, 8, 1440x900 
0x37CA2318, 38092264678623624, 225956048, 225956056, 8, 1440x900 
0x37CA2318, 38092264679473328, 225956137, 225956144, 7, 1440x900 
0x37CA2318, 38092264680146616, 225956202, 225956210, 8, 1440x900 
0x37CA2318, 38092264680806336, 225956271, 225956278, 7, 1440x900 
0x37CA2318, 38092264681261728, 225956312, 225956319, 7, 1440x900 
0x37CA2318, 38092264682118328, 225956398, 225956404, 6, 1440x900 
0x37CA2318, 38092264682774160, 225956463, 225956470, 7, 1440x900 
0x37CA2318, 38092264683393232, 225956527, 225956534, 7, 1440x900 
0x37CA2318, 38092264683901488, 225956577, 225956584, 7, 1440x900 
0x37CA2318, 38092264684563136, 225956649, 225956657, 8, 1440x900 
0x37CA2318, 38092264685219880, 225956707, 225956715, 8, 1440x900 
0x37CA2318, 38092264685884528, 225956778, 225956786, 8, 1440x900 
0x37CA2318, 38092264686553552, 225956844, 225956852, 8, 1440x900 
0x37CA2318, 38092264687401184, 225956928, 225956936, 8, 1440x900 
0x37CA2318, 38092264688063056, 225956993, 225957002, 9, 1440x900 
0x37CA2318, 38092264688536960, 225957044, 225957051, 7, 1440x900 
0x37CA2318, 38092264689190928, 225957108, 225957115, 7, 1440x900 
0x37CA2318, 38092264689930752, 225957183, 225957192, 9, 1440x900 
0x37CA2318, 38092264690700896, 225957262, 225957270, 8, 1440x900 
0x37CA2318, 38092264691184520, 225957307, 225957315, 8, 1440x900 
0x37CA2318, 38092264692042008, 225957393, 225957403, 10, 1440x900 
0x37CA2318, 38092264692527920, 225957438, 225957446, 8, 1440x900 
0x37CA2318, 38092264693276328, 225957513, 225957521, 8, 1440x900 
0x37CA2318, 38092264693814624, 225957568, 225957575, 7, 1440x900 
0x37CA2318, 38092264694482968, 225957639, 225957646, 7, 1440x900 
0x37CA2318, 38092264695153344, 225957702, 225957710, 8, 1440x900 
0x37CA2318, 38092264695811256, 225957773, 225957781, 8, 1440x900 
0x37CA2318, 38092264696463504, 225957832, 225957840, 8, 1440x900 
0x37CA2318, 38092264697132880, 225957898, 225957906, 8, 1440x900 
0x37CA2318, 38092264697813088, 225957967, 225957974, 7, 1440x900 
0x37CA2318, 38092264698436256, 225958032, 225958039, 7, 1440x900 
0x37CA2318, 38092264699096904, 225958098, 225958106, 8, 1440x900 
0x37CA2318, 38092264699778304, 225958168, 225958176, 8, 1440x900 
0x37CA2318, 38092264700421576, 225958232, 225958240, 8, 1440x900 
0x37CA2318, 38092264701082224, 225958298, 225958306, 8, 1440x900 
0x37CA2318, 38092264701741024, 225958363, 225958371, 8, 1440x900 
0x37CA2318, 38092264702408936, 225958428, 225958437, 9, 1440x900 
0x37CA2318, 38092264703076192, 225958498, 225958505, 7, 1440x900 
0x37CA2318, 38092264703744800, 225958561, 225958569, 8, 1440x900 
0x37CA2318, 38092264705056216, 225958693, 225958702, 9, 1440x900 
0x37CA2318, 38092264705909368, 225958782, 225958790, 8, 1440x900 
0x37CA2318, 38092264706560584, 225958848, 225958856, 8, 1440x900 
0x37CA2318, 38092264707106808, 225958898, 225958906, 8, 1440x900 
0x37CA2318, 38092264707874536, 225958978, 225958987, 9, 1440x900 
0x37CA2318, 38092264708552816, 225959042, 225959051, 9, 1440x900 
0x37CA2318, 38092264709211768, 225959108, 225959115, 7, 1440x900 
0x37CA2318, 38092264709678088, 225959153, 225959161, 8, 1440x900 
0x37CA2318, 38092264710335008, 225959217, 225959225, 8, 1440x900 
0x37CA2318, 38092264711190248, 225959307, 225959314, 7, 1440x900 
0x37CA2318, 38092264711859160, 225959373, 225959381, 8, 1440x900 
0x37CA2318, 38092264712327152, 225959423, 225959430, 7, 1440x900 
0x37CA2318, 38092264712976256, 225959483, 225959490, 7, 1440x900 
0x37CA2318, 38092264713644816, 225959548, 225959556, 8, 1440x900 
0x37CA2318, 38092264714304704, 225959617, 225959625, 8, 1440x900 
0x37CA2318, 38092264714971456, 225959683, 225959690, 7, 1440x900 
0x37CA2318, 38092264715631584, 225959752, 225959760, 8, 1440x900 
0x37CA2318, 38092264716299472, 225959823, 225959831, 8, 1440x900 
0x37CA2318, 38092264716957360, 225959881, 225959889, 8, 1440x900 
0x37CA2318, 38092264717626488, 225959950, 225959959, 9, 1440x900 
0x37CA2318, 38092264718280712, 225960018, 225960026, 8, 1440x900 
0x37CA2318, 38092264718940536, 225960087, 225960095, 8, 1440x900 
0x37CA2318, 38092264719604856, 225960148, 225960157, 9, 1440x900 
0x37CA2318, 38092264720267408, 225960218, 225960227, 9, 1440x900 
0x37CA2318, 38092264720919200, 225960278, 225960285, 7, 1440x900 
0x37CA2318, 38092264721580264, 225960342, 225960350, 8, 1440x900 
0x37CA2318, 38092264722241632, 225960412, 225960419, 7, 1440x900 
0x37CA2318, 38092264722897640, 225960476, 225960483, 7, 1440x900 
0x37CA2318, 38092264723557616, 225960542, 225960549, 7, 1440x900 
0x37CA2318, 38092264724226952, 225960608, 225960616, 8, 1440x900 
0x37CA2318, 38092264724890552, 225960676, 225960683, 7, 1440x900 
0x37CA2318, 38092264725550328, 225960742, 225960750, 8, 1440x900 
0x37CA2318, 38092264726210976, 225960807, 225960815, 8, 1440x900 
0x37CA2318, 38092264726873680, 225960878, 225960887, 9, 1440x900 
0x37CA2318, 38092264727535504, 225960938, 225960946, 8, 1440x900 
0x37CA2318, 38092264728235584, 225961015, 225961023, 8, 1440x900 
0x37CA2318, 38092264728867552, 225961073, 225961080, 7, 1440x900 
0x37CA2318, 38092264729681176, 225961157, 225961165, 8, 1440x900 
0x37CA2318, 38092264730175424, 225961202, 225961210, 8, 1440x900 
0x37CA2318, 38092264730839736, 225961271, 225961279, 8, 1440x900 
0x37CA2318, 38092264731494592, 225961341, 225961349, 8, 1440x900 
0x37CA2318, 38092264732163072, 225961402, 225961410, 8, 1440x900 
0x37CA2318, 38092264732823528, 225961468, 225961476, 8, 1440x900 
0x37CA2318, 38092264733488512, 225961537, 225961545, 8, 1440x900 
0x37CA2318, 38092264734143232, 225961602, 225961610, 8, 1440x900 
0x37CA2318, 38092264734803272, 225961668, 225961675, 7, 1440x900 
0x37CA2318, 38092264735471760, 225961732, 225961741, 9, 1440x900 
0x37CA2318, 38092264736313304, 225961817, 225961825, 8, 1440x900 
0x37CA2318, 38092264736975288, 225961883, 225961891, 8, 1440x900 
0x37CA2318, 38092264737551376, 225961942, 225961954, 12, 1440x900 
0x37CA2318, 38092264738135280, 225962002, 225962010, 8, 1440x900 
0x37CA2318, 38092264738781200, 225962068, 225962075, 7, 1440x900 
0x37CA2318, 38092264739434784, 225962128, 225962136, 8, 1440x900 
0x37CA2318, 38092264740094568, 225962197, 225962205, 8, 1440x900 
0x37CA2318, 38092264740777400, 225962262, 225962270, 8, 1440x900 
0x37CA2318, 38092264741430896, 225962328, 225962336, 8, 1440x900 
0x37CA2318, 38092264742090752, 225962393, 225962402, 9, 1440x900 
0x37CA2318, 38092264742764968, 225962462, 225962470, 8, 1440x900 
0x37CA2318, 38092264743409856, 225962527, 225962535, 8, 1440x900 
0x37CA2318, 38092264744070000, 225962592, 225962600, 8, 1440x900 
0x37CA2318, 38092264744735016, 225962663, 225962671, 8, 1440x900 
0x37CA2318, 38092264745394984, 225962727, 225962735, 8, 1440x900 
0x37CA2318, 38092264746051272, 225962792, 225962799, 7, 1440x900 
0x37CA2318, 38092264746714976, 225962858, 225962865, 7, 1440x900 
0x37CA2318, 38092264747373440, 225962922, 225962930, 8, 1440x900 
0x37CA2318, 38092264748036984, 225962992, 225962999, 7, 1440x900 
0x37CA2318, 38092264748707032, 225963058, 225963066, 8, 1440x900 
0x37CA2318, 38092264749369488, 225963127, 225963135, 8, 1440x900 
0x37CA2318, 38092264750035376, 225963193, 225963202, 9, 1440x900 
0x37CA2318, 38092264750708080, 225963257, 225963265, 8, 1440x900 
0x37CA2318, 38092264751356104, 225963323, 225963331, 8, 1440x900 
0x37CA2318, 38092264752025792, 225963393, 225963401, 8, 1440x900 
0x37CA2318, 38092264752679888, 225963459, 225963469, 10, 1440x900 
0x37CA2318, 38092264753340696, 225963518, 225963526, 8, 1440x900 
0x37CA2318, 38092264754001200, 225963587, 225963594, 7, 1440x900 
0x37CA2318, 38092264754668504, 225963653, 225963660, 7, 1440x900 
0x37CA2318, 38092264755345136, 225963722, 225963730, 8, 1440x900 
0x37CA2318, 38092264755995376, 225963787, 225963794, 7, 1440x900 
0x37CA2318, 38092264756665200, 225963852, 225963860, 8, 1440x900 
0x37CA2318, 38092264757325080, 225963917, 225963926, 9, 1440x900 
0x37CA2318, 38092264757985328, 225963983, 225963991, 8, 1440x900 
0x37CA2318, 38092264758665048, 225964058, 225964067, 9, 1440x900 
0x37CA2318, 38092264759316600, 225964122, 225964131, 9, 1440x900 
0x37CA2318, 38092264759966136, 225964186, 225964193, 7, 1440x900 
0x37CA2318, 38092264760646912, 225964252, 225964260, 8, 1440x900 
0x37CA2318, 38092264761291120, 225964318, 225964324, 6, 1440x900 
0x37CA2318, 38092264761959408, 225964389, 225964398, 9, 1440x900 
0x37CA2318, 38092264762635848, 225964448, 225964456, 8, 1440x900 
0x37CA2318, 38092264763274368, 225964513, 225964521, 8, 1440x900 
0x37CA2318, 38092264763940080, 225964581, 225964589, 8, 1440x900 
0x37CA2318, 38092264764599872, 225964647, 225964654, 7, 1440x900 
0x37CA2318, 38092264765280384, 225964718, 225964726, 8, 1440x900 
0x37CA2318, 38092264765924176, 225964777, 225964786, 9, 1440x900 
0x37CA2318, 38092264766586576, 225964847, 225964855, 8, 1440x900 
0x37CA2318, 38092264767902184, 225964978, 225964986, 8, 1440x900 
0x37CA2318, 38092264768590704, 225965048, 225965058, 10, 1440x900 
0x37CA2318, 38092264769243088, 225965113, 225965120, 7, 1440x900 
0x37CA2318, 38092264769874512, 225965177, 225965185, 8, 1440x900 
0x37CA2318, 38092264770545112, 225965242, 225965251, 9, 1440x900 
0x37CA2318, 38092264771200192, 225965308, 225965316, 8, 1440x900 
0x37CA2318, 38092264771868616, 225965378, 225965387, 9, 1440x900 
0x37CA2318, 38092264772529992, 225965443, 225965451, 8, 1440x900 
0x37CA2318, 38092264773243096, 225965513, 225965523, 10, 1440x900 
0x37CA2318, 38092264773848176, 225965572, 225965579, 7, 1440x900 
0x37CA2318, 38092264774509256, 225965637, 225965645, 8, 1440x900 
0x37CA2318, 38092264775168536, 225965702, 225965709, 7, 1440x900 
0x37CA2318, 38092264775836240, 225965771, 225965778, 7, 1440x900 
0x37CA2318, 38092264776496528, 225965838, 225965846, 8, 1440x900 
0x37CA2318, 38092264777148608, 225965902, 225965910, 8, 1440x900 
0x37CA2318, 38092264777823808, 225965967, 225965975, 8, 1440x900 
0x37CA2318, 38092264778484432, 225966033, 225966041, 8, 1440x900 
0x37CA2318, 38092264779154168, 225966102, 225966110, 8, 1440x900 
0x37CA2318, 38092264779809672, 225966168, 225966175, 7, 1440x900 
0x37CA2318, 38092264780475000, 225966234, 225966240, 6, 1440x900 
0x37CA2318, 38092264781133864, 225966298, 225966306, 8, 1440x900 
0x37CA2318, 38092264781790728, 225966367, 225966373, 6, 1440x900 
0x37CA2318, 38092264782445760, 225966428, 225966436, 8, 1440x900 
0x37CA2318, 38092264783129872, 225966503, 225966511, 8, 1440x900 
0x37CA2318, 38092264783982968, 225966588, 225966596, 8, 1440x900 
0x37CA2318, 38092264784642816, 225966652, 225966660, 8, 1440x900 
0x37CA2318, 38092264785193304, 225966708, 225966716, 8, 1440x900 
0x37CA2318, 38092264785766488, 225966762, 225966769, 7, 1440x900 
0x37CA2318, 38092264786624216, 225966848, 225966855, 7, 1440x900 
0x37CA2318, 38092264787086320, 225966897, 225966904, 7, 1440x900 
0x37CA2318, 38092264787760400, 225966962, 225966970, 8, 1440x900 
0x37CA2318, 38092264788406384, 225967027, 225967034, 7, 1440x900 
0x37CA2318, 38092264789067056, 225967092, 225967100, 8, 1440x900 
0x37CA2318, 38092264789732392, 225967163, 225967171, 8, 1440x900 
0x37CA2318, 38092264790396688, 225967228, 225967235, 7, 1440x900 
0x37CA2318, 38092264791051096, 225967292, 225967300, 8, 1440x900 
0x37CA2318, 38092264791711392, 225967357, 225967365, 8, 1440x900 
0x37CA2318, 38092264792559272, 225967443, 225967452, 9, 1440x900 
0x37CA2318, 38092264793038512, 225967488, 225967497, 9, 1440x900 
0x37CA2318, 38092264793692448, 225967556, 225967563, 7, 1440x900 
0x37CA2318, 38092264794355616, 225967627, 225967636, 9, 1440x900 
0x37CA2318, 38092264795015904, 225967694, 225967702, 8, 1440x900 
0x37CA2318, 38092264795701400, 225967758, 225967765, 7, 1440x900 
0x37CA2318, 38092264796332664, 225967822, 225967829, 7, 1440x900 
0x37CA2318, 38092264797001448, 225967887, 225967894, 7, 1440x900 
0x37CA2318, 38092264797665152, 225967952, 225967960, 8, 1440x900 
0x37CA2318, 38092264798322896, 225968023, 225968031, 8, 1440x900 
0x37CA2318, 38092264799184464, 225968108, 225968116, 8, 1440x900 
0x37CA2318, 38092264799850040, 225968173, 225968181, 8, 1440x900 
0x37CA2318, 38092264800347648, 225968223, 225968232, 9, 1440x900 
0x37CA2318, 38092264801163264, 225968302, 225968310, 8, 1440x900 
0x37CA2318, 38092264801816512, 225968371, 225968378, 7, 1440x900 
0x37CA2318, 38092264802318544, 225968419, 225968427, 8, 1440x900 
0x37CA2318, 38092264802954800, 225968482, 225968489, 7, 1440x900 
0x37CA2318, 38092264803611224, 225968547, 225968555, 8, 1440x900 
0x37CA2318, 38092264804271168, 225968613, 225968620, 7, 1440x900 
0x37CA2318, 38092264804936224, 225968678, 225968686, 8, 1440x900 
0x37CA2318, 38092264805781776, 225968763, 225968771, 8, 1440x900 
0x37CA2318, 38092264806451856, 225968832, 225968839, 7, 1440x900 
0x37CA2318, 38092264806915112, 225968877, 225968885, 8, 1440x900 
0x37CA2318, 38092264807578288, 225968942, 225968950, 8, 1440x900 
0x37CA2318, 38092264808237224, 225969008, 225969016, 8, 1440x900 
0x37CA2318, 38092264808898248, 225969077, 225969084, 7, 1440x900 
0x37CA2318, 38092264809760408, 225969162, 225969169, 7, 1440x900 
0x37CA2318, 38092264810429992, 225969227, 225969235, 8, 1440x900 
0x37CA2318, 38092264810886232, 225969272, 225969280, 8, 1440x900 
0x37CA2318, 38092264811542208, 225969338, 225969346, 8, 1440x900 
0x37CA2318, 38092264812409480, 225969427, 225969435, 8, 1440x900 
0x37CA2318, 38092264813069064, 225969493, 225969500, 7, 1440x900 
0x37CA2318, 38092264813534128, 225969538, 225969546, 8, 1440x900 
0x37CA2318, 38092264814382112, 225969623, 225969631, 8, 1440x900 
0x37CA2318, 38092264814852200, 225969672, 225969679, 7, 1440x900 
0x37CA2318, 38092264815513232, 225969737, 225969745, 8, 1440x900 
0x37CA2318, 38092264816185336, 225969806, 225969813, 7, 1440x900 
0x37CA2318, 38092264816843152, 225969873, 225969881, 8, 1440x900 
0x37CA2318, 38092264817503384, 225969942, 225969950, 8, 1440x900 
0x37CA2318, 38092264818165848, 225970007, 225970015, 8, 1440x900 
0x37CA2318, 38092264818829600, 225970073, 225970080, 7, 1440x900 
0x37CA2318, 38092264819678232, 225970158, 225970166, 8, 1440x900 
0x37CA2318, 38092264820345096, 225970228, 225970236, 8, 1440x900 
0x37CA2318, 38092264820838224, 225970273, 225970281, 8, 1440x900 
0x37CA2318, 38092264821478336, 225970332, 225970340, 8, 1440x900 
0x37CA2318, 38092264822321864, 225970418, 225970425, 7, 1440x900 
0x37CA2318, 38092264822982800, 225970483, 225970493, 10, 1440x900 
0x37CA2318, 38092264823449392, 225970531, 225970538, 7, 1440x900 
0x37CA2318, 38092264824306736, 225970622, 225970630, 8, 1440x900 
0x37CA2318, 38092264824778416, 225970668, 225970677, 9, 1440x900 
0x37CA2318, 38092264825433760, 225970733, 225970743, 10, 1440x900 
0x37CA2318, 38092264826099528, 225970798, 225970806, 8, 1440x900 
0x37CA2318, 38092264826752192, 225970867, 225970875, 8, 1440x900 
0x37CA2318, 38092264827417104, 225970933, 225970941, 8, 1440x900 
0x37CA2318, 38092264828082416, 225970998, 225971006, 8, 1440x900 
0x37CA2318, 38092264828732456, 225971063, 225971071, 8, 1440x900 
0x37CA2318, 38092264829390864, 225971127, 225971135, 8, 1440x900 
0x37CA2318, 38092264830050592, 225971193, 225971200, 7, 1440x900 
0x37CA2318, 38092264830719208, 225971257, 225971265, 8, 1440x900 
0x37CA2318, 38092264831371152, 225971327, 225971335, 8, 1440x900 
0x37CA2318, 38092264832031064, 225971388, 225971396, 8, 1440x900 
0x37CA2318, 38092264832705632, 225971461, 225971469, 8, 1440x900 
0x37CA2318, 38092264833365408, 225971523, 225971531, 8, 1440x900 
0x37CA2318, 38092264834021504, 225971588, 225971597, 9, 1440x900 
0x37CA2318, 38092264834679552, 225971652, 225971661, 9, 1440x900 
0x37CA2318, 38092264835341160, 225971722, 225971730, 8, 1440x900 
0x37CA2318, 38092264836007304, 225971787, 225971794, 7, 1440x900 
0x37CA2318, 38092264836662744, 225971853, 225971860, 7, 1440x900 
0x37CA2318, 38092264837326568, 225971923, 225971931, 8, 1440x900 
0x37CA2318, 38092264837986784, 225971989, 225971997, 8, 1440x900 
0x37CA2318, 38092264838653648, 225972053, 225972062, 9, 1440x900 
0x37CA2318, 38092264839502160, 225972138, 225972146, 8, 1440x900 
0x37CA2318, 38092264840643328, 225972252, 225972261, 9, 1440x900 
0x37CA2318, 38092264841297424, 225972318, 225972327, 9, 1440x900 
0x37CA2318, 38092264841962632, 225972383, 225972392, 9, 1440x900 
0x37CA2318, 38092264842622032, 225972452, 225972460, 8, 1440x900 
0x37CA2318, 38092264843288496, 225972517, 225972525, 8, 1440x900 
0x37CA2318, 38092264843942200, 225972583, 225972591, 8, 1440x900 
0x37CA2318, 38092264844812264, 225972668, 225972676, 8, 1440x900 
0x37CA2318, 38092264845462800, 225972732, 225972740, 8, 1440x900 
0x37CA2318, 38092264845935264, 225972782, 225972790, 8, 1440x900 
0x37CA2318, 38092264846778952, 225972868, 225972876, 8, 1440x900 
0x37CA2318, 38092264847248920, 225972912, 225972920, 8, 1440x900 
0x37CA2318, 38092264847917152, 225972978, 225972987, 9, 1440x900 
0x37CA2318, 38092264848593384, 225973048, 225973056, 8, 1440x900 
0x37CA2318, 38092264849435600, 225973134, 225973142, 8, 1440x900 
0x37CA2318, 38092264850101352, 225973198, 225973207, 9, 1440x900 
0x37CA2318, 38092264850561448, 225973248, 225973256, 8, 1440x900 
0x37CA2318, 38092264851234504, 225973312, 225973320, 8, 1440x900 
0x37CA2318, 38092264851892088, 225973378, 225973387, 9, 1440x900 
0x37CA2318, 38092264852546112, 225973447, 225973455, 8, 1440x900 
0x37CA2318, 38092264853212280, 225973513, 225973521, 8, 1440x900 
0x37CA2318, 38092264853867128, 225973573, 225973582, 9, 1440x900 
0x37CA2318, 38092264854528216, 225973643, 225973651, 8, 1440x900 
0x37CA2318, 38092264855184096, 225973703, 225973711, 8, 1440x900 
0x37CA2318, 38092264855853824, 225973772, 225973781, 9, 1440x900 
0x37CA2318, 38092264856642200, 225973852, 225973861, 9, 1440x900 
0x37CA2318, 38092264857167496, 225973908, 225973916, 8, 1440x900 
0x37CA2318, 38092264857827768, 225973973, 225973981, 8, 1440x900 
0x37CA2318, 38092264858494960, 225974039, 225974047, 8, 1440x900 
0x37CA2318, 38092264859341656, 225974123, 225974131, 8, 1440x900 
0x37CA2318, 38092264860002360, 225974189, 225974197, 8, 1440x900 
0x37CA2318, 38092264860468272, 225974233, 225974242, 9, 1440x900 
0x37CA2318, 38092264861136144, 225974303, 225974311, 8, 1440x900 
0x37CA2318, 38092264861796032, 225974368, 225974376, 8, 1440x900 
0x37CA2318, 38092264862458768, 225974433, 225974442, 9, 1440x900 
0x37CA2318, 38092264863134056, 225974502, 225974510, 8, 1440x900 
0x37CA2318, 38092264863779616, 225974568, 225974576, 8, 1440x900 
0x37CA2318, 38092264864439376, 225974633, 225974642, 9, 1440x900 
0x37CA2318, 38092264865104176, 225974697, 225974705, 8, 1440x900 
0x37CA2318, 38092264865762424, 225974762, 225974770, 8, 1440x900 
0x37CA2318, 38092264866418640, 225974831, 225974839, 8, 1440x900 
0x37CA2318, 38092264867078344, 225974896, 225974904, 8, 1440x900 
0x37CA2318, 38092264868150576, 225975003, 225975055, 52, 1440x900 
0x37CA2318, 38092264868834344, 225975068, 225975076, 8, 1440x900 
0x37CA2318, 38092264869193640, 225975107, 225975114, 7, 1440x900 
0x37CA2318, 38092264869718120, 225975157, 225975164, 7, 1440x900 
0x37CA2318, 38092264870380024, 225975227, 225975235, 8, 1440x900 
0x37CA2318, 38092264871048000, 225975293, 225975300, 7, 1440x900 
0x37CA2318, 38092264871700280, 225975358, 225975365, 7, 1440x900 
0x37CA2318, 38092264872568768, 225975443, 225975450, 7, 1440x900 
0x37CA2318, 38092264873111480, 225975497, 225975505, 8, 1440x900 
0x37CA2318, 38092264873838040, 225975571, 225975579, 8, 1440x900 
0x37CA2318, 38092264874343608, 225975623, 225975630, 7, 1440x900 
0x37CA2318, 38092264875003624, 225975687, 225975695, 8, 1440x900 
0x37CA2318, 38092264875666728, 225975752, 225975759, 7, 1440x900 
0x37CA2318, 38092264876395632, 225975826, 225975833, 7, 1440x900 
0x37CA2318, 38092264876988056, 225975887, 225975895, 8, 1440x900 
0x37CA2318, 38092264877648640, 225975957, 225975965, 8, 1440x900 
0x37CA2318, 38092264878315752, 225976022, 225976030, 8, 1440x900 
0x37CA2318, 38092264878972040, 225976084, 225976092, 8, 1440x900 
0x37CA2318, 38092264879630776, 225976154, 225976162, 8, 1440x900 
0x37CA2318, 38092264880291608, 225976217, 225976225, 8, 1440x900 
0x37CA2318, 38092264880958184, 225976287, 225976295, 8, 1440x900 
0x37CA2318, 38092264881808488, 225976372, 225976380, 8, 1440x900 
0x37CA2318, 38092264882459024, 225976437, 225976445, 8, 1440x900 
0x37CA2318, 38092264883133680, 225976502, 225976510, 8, 1440x900 
0x37CA2318, 38092264883783984, 225976567, 225976575, 8, 1440x900 
0x37CA2318, 38092264884452744, 225976637, 225976645, 8, 1440x900 
0x37CA2318, 38092264885113056, 225976702, 225976710, 8, 1440x900 
0x37CA2318, 38092264885626800, 225976747, 225976755, 8, 1440x900 
0x37CA2318, 38092264886435256, 225976832, 225976840, 8, 1440x900 
0x37CA2318, 38092264887095048, 225976898, 225976906, 8, 1440x900 
0x37CA2318, 38092264887746456, 225976962, 225976970, 8, 1440x900 
0x37CA2318, 38092264888230904, 225977014, 225977022, 8, 1440x900 
0x37CA2318, 38092264889068200, 225977098, 225977106, 8, 1440x900 
0x37CA2318, 38092264889738240, 225977162, 225977170, 8, 1440x900 
0x37CA2318, 38092264890400080, 225977232, 225977240, 8, 1440x900 
0x37CA2318, 38092264890877080, 225977278, 225977286, 8, 1440x900 
0x37CA2318, 38092264891721272, 225977363, 225977371, 8, 1440x900 
0x37CA2318, 38092264892390048, 225977428, 225977436, 8, 1440x900 
0x37CA2318, 38092264892988792, 225977488, 225977496, 8, 1440x900 
0x37CA2318, 38092264893516056, 225977543, 225977551, 8, 1440x900 
0x37CA2318, 38092264894363832, 225977623, 225977632, 9, 1440x900 
0x37CA2318, 38092264895024288, 225977693, 225977702, 9, 1440x900 
0x37CA2318, 38092264896151888, 225977803, 225977811, 8, 1440x900 
0x37CA2318, 38092264897002280, 225977888, 225977896, 8, 1440x900 
0x37CA2318, 38092264897664376, 225977953, 225977963, 10, 1440x900 
0x37CA2318, 38092264898131024, 225977998, 225978006, 8, 1440x900 
0x37CA2318, 38092264898994368, 225978089, 225978097, 8, 1440x900 
0x37CA2318, 38092264899655824, 225978157, 225978165, 8, 1440x900 
0x37CA2318, 38092264900304824, 225978217, 225978224, 7, 1440x900 
0x37CA2318, 38092264900774496, 225978263, 225978272, 9, 1440x900 
0x37CA2318, 38092264901626288, 225978348, 225978356, 8, 1440x900 
0x37CA2318, 38092264902279272, 225978418, 225978426, 8, 1440x900 
0x37CA2318, 38092264902939912, 225978482, 225978491, 9, 1440x900 
0x37CA2318, 38092264903419632, 225978532, 225978540, 8, 1440x900 
0x37CA2318, 38092264904273272, 225978618, 225978626, 8, 1440x900 
0x37CA2318, 38092264904945056, 225978689, 225978697, 8, 1440x900 
0x37CA2318, 38092264905520368, 225978742, 225978751, 9, 1440x900 
0x37CA2318, 38092264906063312, 225978792, 225978800, 8, 1440x900 
0x37CA2318, 38092264906924256, 225978883, 225978891, 8, 1440x900 
0x37CA2318, 38092264907594624, 225978947, 225978956, 9, 1440x900 
0x37CA2318, 38092264908063440, 225978998, 225979006, 8, 1440x900 
0x37CA2318, 38092264908917744, 225979082, 225979089, 7, 1440x900 
0x37CA2318, 38092264909570456, 225979143, 225979151, 8, 1440x900 
0x37CA2318, 38092264910230592, 225979213, 225979220, 7, 1440x900 
0x37CA2318, 38092264910701592, 225979257, 225979266, 9, 1440x900 
0x37CA2318, 38092264911549080, 225979342, 225979351, 9, 1440x900 
0x37CA2318, 38092264912202904, 225979407, 225979416, 9, 1440x900 
0x37CA2318, 38092264912873392, 225979478, 225979486, 8, 1440x900 
0x37CA2318, 38092264913346240, 225979523, 225979531, 8, 1440x900 
0x37CA2318, 38092264914188320, 225979608, 225979616, 8, 1440x900 
0x37CA2318, 38092264914858544, 225979672, 225979681, 9, 1440x900 
0x37CA2318, 38092264915504784, 225979739, 225979747, 8, 1440x900 
0x37CA2318, 38092264916169992, 225979808, 225979816, 8, 1440x900 
0x37CA2318, 38092264916832040, 225979873, 225979881, 8, 1440x900 
0x37CA2318, 38092264917493680, 225979937, 225979946, 9, 1440x900 
0x37CA2318, 38092264918008176, 225979992, 225980000, 8, 1440x900 
0x37CA2318, 38092264918826312, 225980072, 225980080, 8, 1440x900 
0x37CA2318, 38092264919487584, 225980136, 225980144, 8, 1440x900 
0x37CA2318, 38092264920149720, 225980201, 225980209, 8, 1440x900 
0x37CA2318, 38092264920619408, 225980248, 225980256, 8, 1440x900 
0x37CA2318, 38092264921475664, 225980333, 225980341, 8, 1440x900 
0x37CA2318, 38092264922139312, 225980402, 225980410, 8, 1440x900 
0x37CA2318, 38092264922792864, 225980468, 225980476, 8, 1440x900 
0x37CA2318, 38092264923263376, 225980518, 225980526, 8, 1440x900 
0x37CA2318, 38092264924107280, 225980598, 225980607, 9, 1440x900 
0x37CA2318, 38092264924777176, 225980668, 225980676, 8, 1440x900 
0x37CA2318, 38092264925438632, 225980733, 225980741, 8, 1440x900 
0x37CA2318, 38092264925911088, 225980782, 225980790, 8, 1440x900 
0x37CA2318, 38092264926750488, 225980862, 225980871, 9, 1440x900 
0x37CA2318, 38092264927420848, 225980933, 225980941, 8, 1440x900 
0x37CA2318, 38092264928017248, 225980993, 225981001, 8, 1440x900 
0x37CA2318, 38092264928722120, 225981058, 225981067, 9, 1440x900 
0x37CA2318, 38092264929218368, 225981112, 225981120, 8, 1440x900 
0x37CA2318, 38092264929880480, 225981178, 225981187, 9, 1440x900 
0x37CA2318, 38092264930556496, 225981248, 225981256, 8, 1440x900 
0x37CA2318, 38092264931218752, 225981313, 225981321, 8, 1440x900 
0x37CA2318, 38092264931868472, 225981373, 225981383, 10, 1440x900 
0x37CA2318, 38092264932528528, 225981443, 225981451, 8, 1440x900 
0x37CA2318, 38092264933200592, 225981507, 225981515, 8, 1440x900 
0x37CA2318, 38092264934052104, 225981592, 225981600, 8, 1440x900 
0x37CA2318, 38092264934721456, 225981663, 225981671, 8, 1440x900 
0x37CA2318, 38092264935179192, 225981707, 225981716, 9, 1440x900 
0x37CA2318, 38092264935853616, 225981774, 225981782, 8, 1440x900 
0x37CA2318, 38092264936512672, 225981841, 225981849, 8, 1440x900 
0x37CA2318, 38092264937164656, 225981903, 225981910, 7, 1440x900 
0x37CA2318, 38092264937824544, 225981968, 225981976, 8, 1440x900 
0x37CA2318, 38092264938488800, 225982036, 225982044, 8, 1440x900 
0x37CA2318, 38092264939148256, 225982103, 225982111, 8, 1440x900 
0x37CA2318, 38092264939808560, 225982172, 225982180, 8, 1440x900 
0x37CA2318, 38092264940479632, 225982238, 225982246, 8, 1440x900 
0x37CA2318, 38092264941327480, 225982317, 225982326, 9, 1440x900 
0x37CA2318, 38092264941958288, 225982383, 225982395, 12, 1440x900 
0x37CA2318, 38092264942473632, 225982438, 225982446, 8, 1440x900 
0x37CA2318, 38092264943322328, 225982523, 225982531, 8, 1440x900 
0x37CA2318, 38092264943977752, 225982588, 225982596, 8, 1440x900 
0x37CA2318, 38092264944529360, 225982639, 225982646, 7, 1440x900 
0x37CA2318, 38092264945298688, 225982716, 225982724, 8, 1440x900 
0x37CA2318, 38092264945762584, 225982762, 225982770, 8, 1440x900 
0x37CA2318, 38092264946422600, 225982828, 225982837, 9, 1440x900 
0x37CA2318, 38092264947087584, 225982893, 225982901, 8, 1440x900 
0x37CA2318, 38092264947746168, 225982963, 225982970, 7, 1440x900 
0x37CA2318, 38092264948405904, 225983027, 225983035, 8, 1440x900 
0x37CA2318, 38092264949066216, 225983093, 225983101, 8, 1440x900 
0x37CA2318, 38092264949731856, 225983158, 225983166, 8, 1440x900 
0x37CA2318, 38092264950386376, 225983227, 225983234, 7, 1440x900 
0x37CA2318, 38092264951046456, 225983292, 225983300, 8, 1440x900 
0x37CA2318, 38092264951706008, 225983358, 225983366, 8, 1440x900 
0x37CA2318, 38092264952370760, 225983422, 225983431, 9, 1440x900 
0x37CA2318, 38092264953028048, 225983487, 225983495, 8, 1440x900 
0x37CA2318, 38092264953687736, 225983553, 225983561, 8, 1440x900 
0x37CA2318, 38092264954361056, 225983622, 225983630, 8, 1440x900 
0x37CA2318, 38092264955024024, 225983693, 225983701, 8, 1440x900 
0x37CA2318, 38092264955672128, 225983758, 225983766, 8, 1440x900 
0x37CA2318, 38092264956335992, 225983823, 225983831, 8, 1440x900 
0x37CA2318, 38092264957657648, 225983952, 225983959, 7, 1440x900 
0x37CA2318, 38092264958332464, 225984022, 225984030, 8, 1440x900 
0x37CA2318, 38092264958982424, 225984088, 225984096, 8, 1440x900 
0x37CA2318, 38092264959649224, 225984157, 225984165, 8, 1440x900 
0x37CA2318, 38092264960498184, 225984243, 225984251, 8, 1440x900 
0x37CA2318, 38092264961161272, 225984303, 225984312, 9, 1440x900 
0x37CA2318, 38092264961812376, 225984368, 225984377, 9, 1440x900 
0x37CA2318, 38092264962291552, 225984418, 225984426, 8, 1440x900 
0x37CA2318, 38092264963136080, 225984502, 225984510, 8, 1440x900 
0x37CA2318, 38092264963798424, 225984568, 225984576, 8, 1440x900 
0x37CA2318, 38092264964401464, 225984628, 225984636, 8, 1440x900 
0x37CA2318, 38092264964932344, 225984682, 225984691, 9, 1440x900 
0x37CA2318, 38092264965782768, 225984768, 225984776, 8, 1440x900 
0x37CA2318, 38092264966452408, 225984832, 225984841, 9, 1440x900 
0x37CA2318, 38092264967076960, 225984898, 225984907, 9, 1440x900 
0x37CA2318, 38092264967576416, 225984943, 225984950, 7, 1440x900 
0x37CA2318, 38092264968236744, 225985009, 225985017, 8, 1440x900 
0x37CA2318, 38092264968896592, 225985077, 225985084, 7, 1440x900 
0x37CA2318, 38092264969560848, 225985143, 225985150, 7, 1440x900 
0x37CA2318, 38092264970218968, 225985208, 225985215, 7, 1440x900 
0x37CA2318, 38092264970878728, 225985273, 225985281, 8, 1440x900 
0x37CA2318, 38092264971542544, 225985343, 225985351, 8, 1440x900 
0x37CA2318, 38092264972213336, 225985412, 225985420, 8, 1440x900 
0x37CA2318, 38092264973054568, 225985493, 225985500, 7, 1440x900 
0x37CA2318, 38092264973727576, 225985562, 225985570, 8, 1440x900 
0x37CA2318, 38092264974378608, 225985628, 225985637, 9, 1440x900 
0x37CA2318, 38092264974845208, 225985672, 225985679, 7, 1440x900 
0x37CA2318, 38092264975693208, 225985758, 225985766, 8, 1440x900 
0x37CA2318, 38092264976354712, 225985824, 225985832, 8, 1440x900 
0x37CA2318, 38092264977024544, 225985892, 225985900, 8, 1440x900 
0x37CA2318, 38092264977496904, 225985938, 225985947, 9, 1440x900 
0x37CA2318, 38092264978340464, 225986022, 225986030, 8, 1440x900 
0x37CA2318, 38092264979007840, 225986089, 225986097, 8, 1440x900 
0x37CA2318, 38092264979478240, 225986137, 225986145, 8, 1440x900 
0x37CA2318, 38092264980328344, 225986218, 225986226, 8, 1440x900 
0x37CA2318, 38092264980990728, 225986286, 225986294, 8, 1440x900 
0x37CA2318, 38092264981452392, 225986332, 225986340, 8, 1440x900 
0x37CA2318, 38092264982118024, 225986397, 225986405, 8, 1440x900 
0x37CA2318, 38092264982971576, 225986483, 225986490, 7, 1440x900 
0x37CA2318, 38092264983433328, 225986528, 225986536, 8, 1440x900 
0x37CA2318, 38092264984095872, 225986597, 225986604, 7, 1440x900 
0x37CA2318, 38092264984760976, 225986663, 225986670, 7, 1440x900 
0x37CA2318, 38092264985614400, 225986748, 225986754, 6, 1440x900 
0x37CA2318, 38092264986265696, 225986813, 225986822, 9, 1440x900 
0x37CA2318, 38092264986919192, 225986881, 225986890, 9, 1440x900 
0x37CA2318, 38092264987590248, 225986948, 225986956, 8, 1440x900 
0x37CA2318, 38092264988059024, 225986993, 225987001, 8, 1440x900 
0x37CA2318, 38092264988722048, 225987063, 225987071, 8, 1440x900 
0x37CA2318, 38092264989378912, 225987128, 225987136, 8, 1440x900 
0x37CA2318, 38092264990045576, 225987193, 225987201, 8, 1440x900 
0x37CA2318, 38092264990699176, 225987258, 225987266, 8, 1440x900 
0x37CA2318, 38092264991551632, 225987343, 225987351, 8, 1440x900 
0x37CA2318, 38092264992109712, 225987397, 225987406, 9, 1440x900 
0x37CA2318, 38092264992882000, 225987477, 225987485, 8, 1440x900 
0x37CA2318, 38092264993360976, 225987523, 225987532, 9, 1440x900 
0x37CA2318, 38092264994029192, 225987590, 225987599, 9, 1440x900 
0x37CA2318, 38092264994694208, 225987662, 225987670, 8, 1440x900 
0x37CA2318, 38092264995347328, 225987723, 225987732, 9, 1440x900 
0x37CA2318, 38092264996007480, 225987788, 225987796, 8, 1440x900 
0x37CA2318, 38092264996669936, 225987856, 225987864, 8, 1440x900 
0x37CA2318, 38092264997331536, 225987922, 225987929, 7, 1440x900 
0x37CA2318, 38092264997996040, 225987988, 225987995, 7, 1440x900 
0x37CA2318, 38092264998655768, 225988052, 225988060, 8, 1440x900 
0x37CA2318, 38092264999317808, 225988123, 225988131, 8, 1440x900 
0x37CA2318, 38092264999984960, 225988187, 225988195, 8, 1440x900 
0x37CA2318, 38092265000827600, 225988272, 225988280, 8, 1440x900 
0x37CA2318, 38092265001502176, 225988342, 225988350, 8, 1440x900 
0x37CA2318, 38092265001975696, 225988387, 225988395, 8, 1440x900 
0x37CA2318, 38092265002625912, 225988454, 225988462, 8, 1440x900 
0x37CA2318, 38092265003285840, 225988517, 225988525, 8, 1440x900 
0x37CA2318, 38092265004151712, 225988604, 225988612, 8, 1440x900 
0x37CA2318, 38092265004626336, 225988652, 225988660, 8, 1440x900 
0x37CA2318, 38092265005476152, 225988737, 225988746, 9, 1440x900 
0x37CA2318, 38092265006136216, 225988803, 225988811, 8, 1440x900 
0x37CA2318, 38092265006789608, 225988868, 225988876, 8, 1440x900 
0x37CA2318, 38092265007273864, 225988918, 225988926, 8, 1440x900 
0x37CA2318, 38092265008119592, 225988998, 225989005, 7, 1440x900 
0x37CA2318, 38092265008780456, 225989067, 225989075, 8, 1440x900 
0x37CA2318, 38092265009449272, 225989133, 225989141, 8, 1440x900 
0x37CA2318, 38092265009913968, 225989182, 225989190, 8, 1440x900 
0x37CA2318, 38092265010761712, 225989268, 225989276, 8, 1440x900 
0x37CA2318, 38092265011422112, 225989332, 225989340, 8, 1440x900 
0x37CA2318, 38092265011935208, 225989381, 225989389, 8, 1440x900 
0x37CA2318, 38092265012750752, 225989462, 225989470, 8, 1440x900 
0x37CA2318, 38092265013402440, 225989533, 225989541, 8, 1440x900 
0x37CA2318, 38092265014064176, 225989594, 225989603, 9, 1440x900 
0x37CA2318, 38092265014529976, 225989639, 225989646, 7, 1440x900 
0x37CA2318, 38092265015385976, 225989728, 225989736, 8, 1440x900 
0x37CA2318, 38092265016037272, 225989792, 225989801, 9, 1440x900 
0x37CA2318, 38092265016715904, 225989861, 225989868, 7, 1440x900 
0x37CA2318, 38092265017175920, 225989903, 225989910, 7, 1440x900 
0x37CA2318, 38092265018028448, 225989988, 225989996, 8, 1440x900 
0x37CA2318, 38092265018688504, 225990056, 225990063, 7, 1440x900 
0x37CA2318, 38092265019351984, 225990123, 225990132, 9, 1440x900 
0x37CA2318, 38092265020682200, 225990258, 225990266, 8, 1440x900 
0x37CA2318, 38092265021339040, 225990323, 225990332, 9, 1440x900 
0x37CA2318, 38092265021960392, 225990388, 225990397, 9, 1440x900 
0x37CA2318, 38092265022654440, 225990452, 225990462, 10, 1440x900 
0x37CA2318, 38092265023315056, 225990518, 225990527, 9, 1440x900 
0x37CA2318, 38092265023984624, 225990588, 225990596, 8, 1440x900 
0x37CA2318, 38092265024462312, 225990637, 225990645, 8, 1440x900 
0x37CA2318, 38092265025298112, 225990718, 225990726, 8, 1440x900 
0x37CA2318, 38092265025967296, 225990788, 225990796, 8, 1440x900 
0x37CA2318, 38092265026628680, 225990853, 225990861, 8, 1440x900 
0x37CA2318, 38092265027100792, 225990897, 225990906, 9, 1440x900 
0x37CA2318, 38092265027949296, 225990987, 225990995, 8, 1440x900 
0x37CA2318, 38092265028618384, 225991048, 225991055, 7, 1440x900 
0x37CA2318, 38092265029280680, 225991117, 225991125, 8, 1440x900 
0x37CA2318, 38092265029739000, 225991161, 225991169, 8, 1440x900 
0x37CA2318, 38092265030594192, 225991248, 225991256, 8, 1440x900 
0x37CA2318, 38092265031246272, 225991312, 225991321, 9, 1440x900 
0x37CA2318, 38092265031918000, 225991378, 225991386, 8, 1440x900 
0x37CA2318, 38092265032392352, 225991428, 225991437, 9, 1440x900 
0x37CA2318, 38092265033243632, 225991512, 225991521, 9, 1440x900 
0x37CA2318, 38092265033896896, 225991577, 225991586, 9, 1440x900 
0x37CA2318, 38092265034474160, 225991637, 225991645, 8, 1440x900 
0x37CA2318, 38092265035222280, 225991713, 225991721, 8, 1440x900 
0x37CA2318, 38092265035881144, 225991777, 225991785, 8, 1440x900 
0x37CA2318, 38092265036532560, 225991843, 225991852, 9, 1440x900 
0x37CA2318, 38092265037016632, 225991893, 225991901, 8, 1440x900 
0x37CA2318, 38092265037871768, 225991978, 225991986, 8, 1440x900 
0x37CA2318, 38092265038541600, 225992043, 225992051, 8, 1440x900 
0x37CA2318, 38092265039195024, 225992108, 225992116, 8, 1440x900 
0x37CA2318, 38092265039665880, 225992158, 225992167, 9, 1440x900 
0x37CA2318, 38092265040506976, 225992237, 225992244, 7, 1440x900 
0x37CA2318, 38092265041168208, 225992308, 225992316, 8, 1440x900 
0x37CA2318, 38092265041831552, 225992372, 225992380, 8, 1440x900 
0x37CA2318, 38092265042306392, 225992418, 225992426, 8, 1440x900 
0x37CA2318, 38092265043170752, 225992507, 225992515, 8, 1440x900 
0x37CA2318, 38092265043821704, 225992573, 225992581, 8, 1440x900 
0x37CA2318, 38092265044475704, 225992632, 225992640, 8, 1440x900 
0x37CA2318, 38092265044947664, 225992681, 225992688, 7, 1440x900 
0x37CA2318, 38092265045809584, 225992768, 225992775, 7, 1440x900 
0x37CA2318, 38092265046271968, 225992812, 225992820, 8, 1440x900 
0x37CA2318, 38092265046931496, 225992878, 225992886, 8, 1440x900 
0x37CA2318, 38092265047595088, 225992946, 225992953, 7, 1440x900 
0x37CA2318, 38092265048254056, 225993012, 225993019, 7, 1440x900 
0x37CA2318, 38092265049111472, 225993097, 225993105, 8, 1440x900 
0x37CA2318, 38092265049579544, 225993148, 225993155, 7, 1440x900 
0x37CA2318, 38092265050432264, 225993231, 225993239, 8, 1440x900 
0x37CA2318, 38092265051092608, 225993298, 225993305, 7, 1440x900 
0x37CA2318, 38092265051677560, 225993356, 225993364, 8, 1440x900 
0x37CA2318, 38092265052220032, 225993408, 225993416, 8, 1440x900 
0x37CA2318, 38092265052881520, 225993473, 225993481, 8, 1440x900 
0x37CA2318, 38092265053544336, 225993538, 225993547, 9, 1440x900 
0x37CA2318, 38092265054206640, 225993607, 225993615, 8, 1440x900 
0x37CA2318, 38092265054867120, 225993675, 225993686, 11, 1440x900 
0x37CA2318, 38092265055524552, 225993737, 225993745, 8, 1440x900 
0x37CA2318, 38092265056184440, 225993802, 225993810, 8, 1440x900 
0x37CA2318, 38092265056845024, 225993871, 225993878, 7, 1440x900 
0x37CA2318, 38092265057505040, 225993936, 225993943, 7, 1440x900 
0x37CA2318, 38092265058165080, 225994002, 225994009, 7, 1440x900 
0x37CA2318, 38092265058834280, 225994073, 225994080, 7, 1440x900 
0x37CA2318, 38092265059488624, 225994137, 225994144, 7, 1440x900 
0x37CA2318, 38092265060147344, 225994201, 225994208, 7, 1440x900 
0x37CA2318, 38092265060809296, 225994267, 225994275, 8, 1440x900 
0x37CA2318, 38092265061469544, 225994332, 225994340, 8, 1440x900 
0x37CA2318, 38092265062131960, 225994404, 225994413, 9, 1440x900 
0x37CA2318, 38092265062866744, 225994472, 225994482, 10, 1440x900 
0x37CA2318, 38092265063447056, 225994529, 225994538, 9, 1440x900 
0x37CA2318, 38092265064352632, 225994624, 225994635, 11, 1440x900 
0x37CA2318, 38092265064773352, 225994663, 225994696, 33, 1440x900 
0x37CA2318, 38092265065755384, 225994770, 225994789, 19, 1440x900 
0x37CA2318, 38092265066201848, 225994806, 225994816, 10, 1440x900 
0x37CA2318, 38092265066820544, 225994871, 225994885, 14, 1440x900 
0x37CA2318, 38092265067481216, 225994933, 225994941, 8, 1440x900 
0x37CA2318, 38092265068133032, 225994998, 225995006, 8, 1440x900 
0x37CA2318, 38092265068803248, 225995067, 225995075, 8, 1440x900 
0x37CA2318, 38092265069466288, 225995132, 225995140, 8, 1440x900 
0x37CA2318, 38092265070137192, 225995201, 225995209, 8, 1440x900 
0x37CA2318, 38092265070799808, 225995267, 225995274, 7, 1440x900 
0x37CA2318, 38092265071461304, 225995333, 225995341, 8, 1440x900 
0x37CA2318, 38092265072115744, 225995397, 225995405, 8, 1440x900 
0x37CA2318, 38092265072775504, 225995463, 225995470, 7, 1440x900 
0x37CA2318, 38092265073439792, 225995532, 225995539, 7, 1440x900 
0x37CA2318, 38092265074099848, 225995597, 225995604, 7, 1440x900 
0x37CA2318, 38092265074760408, 225995663, 225995670, 7, 1440x900 
0x37CA2318, 38092265075424336, 225995732, 225995740, 8, 1440x900 
0x37CA2318, 38092265076081056, 225995792, 225995800, 8, 1440x900 
0x37CA2318, 38092265076740928, 225995857, 225995865, 8, 1440x900 
0x37CA2318, 38092265077404664, 225995928, 225995940, 12, 1440x900 
0x37CA2318, 38092265078067208, 225995993, 225996002, 9, 1440x900 
0x37CA2318, 38092265078730944, 225996058, 225996067, 9, 1440x900 
0x37CA2318, 38092265079387184, 225996123, 225996132, 9, 1440x900 
0x37CA2318, 38092265080047576, 225996193, 225996201, 8, 1440x900 
0x37CA2318, 38092265080707544, 225996257, 225996265, 8, 1440x900 
0x37CA2318, 38092265081372872, 225996324, 225996332, 8, 1440x900 
0x37CA2318, 38092265082031456, 225996388, 225996396, 8, 1440x900 
0x37CA2318, 38092265082691392, 225996453, 225996461, 8, 1440x900 
0x37CA2318, 38092265083352872, 225996521, 225996528, 7, 1440x900 
0x37CA2318, 38092265084024120, 225996588, 225996596, 8, 1440x900 
0x37CA2318, 38092265085337824, 225996722, 225996729, 7, 1440x900 
0x37CA2318, 38092265085995376, 225996787, 225996795, 8, 1440x900 
0x37CA2318, 38092265086659552, 225996853, 225996860, 7, 1440x900 
0x37CA2318, 38092265087325136, 225996923, 225996931, 8, 1440x900 
0x37CA2318, 38092265087984144, 225996988, 225996996, 8, 1440x900 
0x37CA2318, 38092265088647544, 225997054, 225997062, 8, 1440x900 
0x37CA2318, 38092265089301272, 225997116, 225997123, 7, 1440x900 
0x37CA2318, 38092265089973736, 225997183, 225997190, 7, 1440x900 
0x37CA2318, 38092265090658936, 225997252, 225997259, 7, 1440x900 
0x37CA2318, 38092265091290536, 225997316, 225997324, 8, 1440x900 
0x37CA2318, 38092265092281272, 225997417, 225997425, 8, 1440x900 
0x37CA2318, 38092265092810432, 225997467, 225997474, 7, 1440x900 
0x37CA2318, 38092265093477720, 225997538, 225997546, 8, 1440x900 
0x37CA2318, 38092265094129912, 225997603, 225997611, 8, 1440x900 
0x37CA2318, 38092265094791352, 225997668, 225997678, 10, 1440x900 
0x37CA2318, 38092265095284480, 225997713, 225997721, 8, 1440x900 
0x37CA2318, 38092265095920464, 225997777, 225997785, 8, 1440x900 
0x37CA2318, 38092265096590344, 225997848, 225997855, 7, 1440x900 
0x37CA2318, 38092265097250136, 225997911, 225997919, 8, 1440x900 
0x37CA2318, 38092265097915120, 225997983, 225997991, 8, 1440x900 
0x37CA2318, 38092265098578744, 225998047, 225998056, 9, 1440x900 
0x37CA2318, 38092265099238200, 225998112, 225998121, 9, 1440x900 
0x37CA2318, 38092265099903832, 225998178, 225998186, 8, 1440x900 
0x37CA2318, 38092265100569168, 225998248, 225998258, 10, 1440x900 
0x37CA2318, 38092265101237112, 225998313, 225998322, 9, 1440x900 
0x37CA2318, 38092265101890048, 225998378, 225998385, 7, 1440x900 
0x37CA2318, 38092265102544584, 225998441, 225998449, 8, 1440x900 
0x37CA2318, 38092265103211392, 225998507, 225998515, 8, 1440x900 
0x37CA2318, 38092265103877504, 225998577, 225998585, 8, 1440x900 
0x37CA2318, 38092265104531992, 225998638, 225998646, 8, 1440x900 
0x37CA2318, 38092265105376808, 225998727, 225998735, 8, 1440x900 
0x37CA2318, 38092265106041568, 225998792, 225998800, 8, 1440x900 
0x37CA2318, 38092265106711856, 225998863, 225998876, 13, 1440x900 
0x37CA2318, 38092265107169904, 225998903, 225998911, 8, 1440x900 
0x37CA2318, 38092265107864744, 225998972, 225998982, 10, 1440x900 
0x37CA2318, 38092265108687072, 225999058, 225999069, 11, 1440x900 
0x37CA2318, 38092265115779360, 225999765, 225999772, 7, 1440x900 
0x37CA2318, 38092265116434472, 225999828, 225999839, 11, 1440x900 
0x37CA2318, 38092265118440912, 226000028, 226000039, 11, 1440x900 
0x37CA2318, 38092265121089528, 226000304, 226000318, 14, 1440x900 
0x37CA2318, 38092265123709880, 226000557, 226000567, 10, 1440x900 
0x37CA2318, 38092265124360856, 226000623, 226000633, 10, 1440x900 
0x37CA2318, 38092265126342232, 226000823, 226000829, 6, 1440x900 
0x37CA2318, 38092265127002240, 226000888, 226000895, 7, 1440x900 
0x37CA2318, 38092265127666176, 226000955, 226000962, 7, 1440x900 
0x37CA2318, 38092265128335800, 226001022, 226001030, 8, 1440x900 
0x37CA2318, 38092265129000544, 226001087, 226001094, 7, 1440x900 
0x37CA2318, 38092265129658400, 226001153, 226001160, 7, 1440x900 
0x37CA2318, 38092265130320416, 226001221, 226001229, 8, 1440x900 
0x37CA2318, 38092265130979072, 226001284, 226001292, 8, 1440x900 
0x37CA2318, 38092265131636072, 226001348, 226001356, 8, 1440x900 
0x37CA2318, 38092265132334000, 226001417, 226001425, 8, 1440x900 
0x37CA2318, 38092265132984760, 226001488, 226001498, 10, 1440x900 
0x37CA2318, 38092265133718248, 226001555, 226001576, 21, 1440x900 
0x37CA2318, 38092265134298880, 226001613, 226001622, 9, 1440x900 
0x37CA2318, 38092265135794592, 226001769, 226001777, 8, 1440x900 
0x37CA2318, 38092265136269184, 226001817, 226001825, 8, 1440x900 
0x37CA2318, 38092265137120632, 226001903, 226001911, 8, 1440x900 
0x37CA2318, 38092265137779952, 226001968, 226001976, 8, 1440x900 
0x37CA2318, 38092265138430160, 226002033, 226002041, 8, 1440x900 
0x37CA2318, 38092265138950784, 226002087, 226002095, 8, 1440x900 
0x37CA2318, 38092265139802288, 226002168, 226002176, 8, 1440x900 
0x37CA2318, 38092265140454912, 226002233, 226002241, 8, 1440x900 
0x37CA2318, 38092265141109136, 226002298, 226002306, 8, 1440x900 
0x37CA2318, 38092265141588256, 226002348, 226002356, 8, 1440x900 
0x37CA2318, 38092265142434416, 226002434, 226002442, 8, 1440x900 
0x37CA2318, 38092265143097192, 226002498, 226002506, 8, 1440x900 
0x37CA2318, 38092265143761152, 226002563, 226002572, 9, 1440x900 
0x37CA2318, 38092265144421280, 226002633, 226002641, 8, 1440x900 
0x37CA2318, 38092265145073416, 226002692, 226002700, 8, 1440x900 
0x37CA2318, 38092265145744480, 226002764, 226002772, 8, 1440x900 
0x37CA2318, 38092265146217400, 226002812, 226002820, 8, 1440x900 
0x37CA2318, 38092265147066680, 226002897, 226002905, 8, 1440x900 
0x37CA2318, 38092265147728112, 226002963, 226002971, 8, 1440x900 
0x37CA2318, 38092265148388120, 226003028, 226003036, 8, 1440x900 
0x37CA2318, 38092265148860792, 226003073, 226003083, 10, 1440x900 
0x37CA2318, 38092265149710672, 226003158, 226003167, 9, 1440x900 
0x37CA2318, 38092265150241416, 226003213, 226003221, 8, 1440x900 
0x37CA2318, 38092265150834664, 226003272, 226003280, 8, 1440x900 
0x37CA2318, 38092265151502544, 226003343, 226003351, 8, 1440x900 
0x37CA2318, 38092265152160312, 226003402, 226003412, 10, 1440x900 
0x37CA2318, 38092265152818088, 226003473, 226003481, 8, 1440x900 
0x37CA2318, 38092265153478120, 226003538, 226003547, 9, 1440x900 
0x37CA2318, 38092265154145648, 226003603, 226003612, 9, 1440x900 
0x37CA2318, 38092265154806720, 226003668, 226003677, 9, 1440x900 
0x37CA2318, 38092265155465024, 226003733, 226003741, 8, 1440x900 
0x37CA2318, 38092265156129472, 226003798, 226003806, 8, 1440x900 
0x37CA2318, 38092265156785040, 226003866, 226003874, 8, 1440x900 
0x37CA2318, 38092265157446504, 226003932, 226003940, 8, 1440x900 
0x37CA2318, 38092265158302344, 226004018, 226004027, 9, 1440x900 
0x37CA2318, 38092265158775984, 226004068, 226004076, 8, 1440x900 
0x37CA2318, 38092265159433832, 226004132, 226004140, 8, 1440x900 
0x37CA2318, 38092265160089008, 226004198, 226004206, 8, 1440x900 
0x37CA2318, 38092265160751992, 226004267, 226004275, 8, 1440x900 
0x37CA2318, 38092265161415664, 226004332, 226004340, 8, 1440x900 
0x37CA2318, 38092265162271296, 226004418, 226004427, 9, 1440x900 
0x37CA2318, 38092265162744472, 226004463, 226004471, 8, 1440x900 
0x37CA2318, 38092265163395256, 226004527, 226004536, 9, 1440x900 
0x37CA2318, 38092265164066600, 226004598, 226004606, 8, 1440x900 
0x37CA2318, 38092265164723280, 226004662, 226004670, 8, 1440x900 
0x37CA2318, 38092265165379664, 226004728, 226004736, 8, 1440x900 
0x37CA2318, 38092265166039792, 226004793, 226004802, 9, 1440x900 
0x37CA2318, 38092265166702080, 226004858, 226004866, 8, 1440x900 
0x37CA2318, 38092265167360136, 226004928, 226004936, 8, 1440x900 
0x37CA2318, 38092265168023216, 226004992, 226005000, 8, 1440x900 
0x37CA2318, 38092265168690360, 226005058, 226005066, 8, 1440x900 
0x37CA2318, 38092265169346584, 226005123, 226005132, 9, 1440x900 
0x37CA2318, 38092265170007648, 226005188, 226005197, 9, 1440x900 
0x37CA2318, 38092265170667872, 226005253, 226005262, 9, 1440x900 
0x37CA2318, 38092265171329576, 226005318, 226005327, 9, 1440x900 
0x37CA2318, 38092265171984896, 226005384, 226005392, 8, 1440x900 
0x37CA2318, 38092265172653352, 226005451, 226005459, 8, 1440x900 
0x37CA2318, 38092265173314056, 226005517, 226005525, 8, 1440x900 
0x37CA2318, 38092265173985352, 226005588, 226005596, 8, 1440x900 
0x37CA2318, 38092265174638400, 226005654, 226005661, 7, 1440x900 
0x37CA2318, 38092265175298760, 226005717, 226005725, 8, 1440x900 
0x37CA2318, 38092265175962392, 226005787, 226005795, 8, 1440x900 
0x37CA2318, 38092265176643496, 226005853, 226005860, 7, 1440x900 
0x37CA2318, 38092265177285720, 226005913, 226005921, 8, 1440x900 
0x37CA2318, 38092265177949952, 226005982, 226005990, 8, 1440x900 
0x37CA2318, 38092265178621840, 226006052, 226006061, 9, 1440x900 
0x37CA2318, 38092265179281568, 226006118, 226006126, 8, 1440x900 
0x37CA2318, 38092265179938768, 226006183, 226006190, 7, 1440x900 
0x37CA2318, 38092265180598272, 226006247, 226006254, 7, 1440x900 
0x37CA2318, 38092265181257360, 226006312, 226006319, 7, 1440x900 
0x37CA2318, 38092265181916544, 226006377, 226006385, 8, 1440x900 
0x37CA2318, 38092265182576864, 226006443, 226006451, 8, 1440x900 
0x37CA2318, 38092265183246736, 226006514, 226006523, 9, 1440x900 
0x37CA2318, 38092265183902440, 226006577, 226006585, 8, 1440x900 
0x37CA2318, 38092265184568480, 226006647, 226006656, 9, 1440x900 
0x37CA2318, 38092265185226848, 226006713, 226006721, 8, 1440x900 
0x37CA2318, 38092265185886056, 226006777, 226006786, 9, 1440x900 
0x37CA2318, 38092265186551104, 226006848, 226006856, 8, 1440x900 
0x37CA2318, 38092265187212080, 226006913, 226006921, 8, 1440x900 
0x37CA2318, 38092265187879064, 226006977, 226006985, 8, 1440x900 
0x37CA2318, 38092265188538088, 226007043, 226007050, 7, 1440x900 
0x37CA2318, 38092265189198000, 226007107, 226007116, 9, 1440x900 
0x37CA2318, 38092265189866784, 226007172, 226007181, 9, 1440x900 
0x37CA2318, 38092265190533056, 226007253, 226007261, 8, 1440x900 
0x37CA2318, 38092265191240120, 226007308, 226007317, 9, 1440x900 
0x37CA2318, 38092265191846648, 226007372, 226007379, 7, 1440x900 
0x37CA2318, 38092265192538000, 226007442, 226007451, 9, 1440x900 
0x37CA2318, 38092265193170664, 226007502, 226007510, 8, 1440x900 
0x37CA2318, 38092265193838480, 226007573, 226007581, 8, 1440x900 
0x37CA2318, 38092265194495024, 226007638, 226007646, 8, 1440x900 
0x37CA2318, 38092265195154992, 226007703, 226007711, 8, 1440x900 
0x37CA2318, 38092265196477280, 226007838, 226007847, 9, 1440x900 
0x37CA2318, 38092265197134352, 226007902, 226007910, 8, 1440x900 
0x37CA2318, 38092265197792984, 226007966, 226007973, 7, 1440x900 
0x37CA2318, 38092265198450440, 226008032, 226008040, 8, 1440x900 
0x37CA2318, 38092265199110608, 226008099, 226008106, 7, 1440x900 
0x37CA2318, 38092265199773384, 226008162, 226008170, 8, 1440x900 
0x37CA2318, 38092265200484152, 226008233, 226008242, 9, 1440x900 
0x37CA2318, 38092265201194424, 226008340, 226008354, 14, 1440x900 
0x37CA2318, 38092265202141416, 226008402, 226008419, 17, 1440x900 
0x37CA2318, 38092265202496288, 226008436, 226008446, 10, 1440x900 
0x37CA2318, 38092265203200392, 226008507, 226008515, 8, 1440x900 
0x37CA2318, 38092265203802464, 226008568, 226008574, 6, 1440x900 
0x37CA2318, 38092265204432192, 226008627, 226008635, 8, 1440x900 
0x37CA2318, 38092265205092992, 226008693, 226008701, 8, 1440x900 
0x37CA2318, 38092265205753408, 226008763, 226008770, 7, 1440x900 
0x37CA2318, 38092265206422928, 226008828, 226008835, 7, 1440x900 
0x37CA2318, 38092265207083256, 226008892, 226008901, 9, 1440x900 
0x37CA2318, 38092265207784224, 226008963, 226008971, 8, 1440x900 
0x37CA2318, 38092265208411592, 226009027, 226009035, 8, 1440x900 
0x37CA2318, 38092265209264048, 226009113, 226009121, 8, 1440x900 
0x37CA2318, 38092265209738688, 226009163, 226009172, 9, 1440x900 
0x37CA2318, 38092265210397016, 226009227, 226009234, 7, 1440x900 
0x37CA2318, 38092265211114912, 226009297, 226009305, 8, 1440x900 
0x37CA2318, 38092265211717024, 226009358, 226009365, 7, 1440x900 
0x37CA2318, 38092265212377096, 226009423, 226009431, 8, 1440x900 
0x37CA2318, 38092265213037128, 226009488, 226009496, 8, 1440x900 
0x37CA2318, 38092265213697272, 226009557, 226009564, 7, 1440x900 
0x37CA2318, 38092265214364352, 226009622, 226009629, 7, 1440x900 
0x37CA2318, 38092265215024368, 226009688, 226009696, 8, 1440x900 
0x37CA2318, 38092265215688280, 226009758, 226009766, 8, 1440x900 
0x37CA2318, 38092265216347560, 226009823, 226009832, 9, 1440x900 
0x37CA2318, 38092265217008328, 226009893, 226009902, 9, 1440x900 
0x37CA2318, 38092265217672024, 226009957, 226009965, 8, 1440x900 
0x37CA2318, 38092265218339792, 226010023, 226010031, 8, 1440x900 
0x37CA2318, 38092265219003640, 226010088, 226010097, 9, 1440x900 
0x37CA2318, 38092265219862928, 226010174, 226010182, 8, 1440x900 
0x37CA2318, 38092265220514936, 226010238, 226010247, 9, 1440x900 
0x37CA2318, 38092265221175880, 226010307, 226010315, 8, 1440x900 
0x37CA2318, 38092265221835488, 226010372, 226010380, 8, 1440x900 
0x37CA2318, 38092265222495864, 226010438, 226010446, 8, 1440x900 
0x37CA2318, 38092265223166624, 226010508, 226010516, 8, 1440x900 
0x37CA2318, 38092265223818168, 226010573, 226010581, 8, 1440x900 
0x37CA2318, 38092265224477160, 226010638, 226010646, 8, 1440x900 
0x37CA2318, 38092265225137072, 226010702, 226010710, 8, 1440x900 
0x37CA2318, 38092265225602464, 226010752, 226010760, 8, 1440x900 
0x37CA2318, 38092265226263648, 226010813, 226010822, 9, 1440x900 
0x37CA2318, 38092265226924352, 226010882, 226010890, 8, 1440x900 
0x37CA2318, 38092265227757168, 226010967, 226010975, 8, 1440x900 
0x37CA2318, 38092265228248688, 226011013, 226011022, 9, 1440x900 
0x37CA2318, 38092265228908520, 226011078, 226011087, 9, 1440x900 
0x37CA2318, 38092265229568880, 226011149, 226011157, 8, 1440x900 
0x37CA2318, 38092265230225632, 226011208, 226011215, 7, 1440x900 
0x37CA2318, 38092265230885576, 226011276, 226011283, 7, 1440x900 
0x37CA2318, 38092265231546504, 226011342, 226011350, 8, 1440x900 
0x37CA2318, 38092265232206744, 226011408, 226011415, 7, 1440x900 
0x37CA2318, 38092265232866792, 226011472, 226011480, 8, 1440x900 
0x37CA2318, 38092265233529312, 226011538, 226011547, 9, 1440x900 
0x37CA2318, 38092265234222152, 226011608, 226011616, 8, 1440x900 
0x37CA2318, 38092265234855776, 226011677, 226011685, 8, 1440x900 
0x37CA2318, 38092265235518040, 226011742, 226011751, 9, 1440x900 
0x37CA2318, 38092265236187616, 226011806, 226011814, 8, 1440x900 
0x37CA2318, 38092265236836200, 226011878, 226011886, 8, 1440x900 
0x37CA2318, 38092265237492464, 226011940, 226011963, 23, 1440x900 
0x37CA2318, 38092265238187192, 226012007, 226012013, 6, 1440x900 
0x37CA2318, 38092265238815456, 226012067, 226012074, 7, 1440x900 
0x37CA2318, 38092265239696344, 226012153, 226012164, 11, 1440x900 
0x37CA2318, 38092265240797784, 226012266, 226012273, 7, 1440x900 
0x37CA2318, 38092265241634576, 226012349, 226012359, 10, 1440x900 
0x37CA2318, 38092265242169984, 226012410, 226012424, 14, 1440x900 
0x37CA2318, 38092265242850264, 226012476, 226012486, 10, 1440x900 
0x37CA2318, 38092265243509032, 226012538, 226012545, 7, 1440x900 
0x37CA2318, 38092265244132120, 226012598, 226012607, 9, 1440x900 
0x37CA2318, 38092265244802176, 226012667, 226012674, 7, 1440x900 
0x37CA2318, 38092265245465552, 226012732, 226012741, 9, 1440x900 
0x37CA2318, 38092265246128392, 226012798, 226012806, 8, 1440x900 
0x37CA2318, 38092265246788384, 226012863, 226012872, 9, 1440x900 
0x37CA2318, 38092265247513864, 226012942, 226012966, 24, 1440x900 
0x37CA2318, 38092265248200680, 226013006, 226013017, 11, 1440x900 
0x37CA2318, 38092265248790424, 226013068, 226013076, 8, 1440x900 
0x37CA2318, 38092265249455384, 226013133, 226013143, 10, 1440x900 
0x37CA2318, 38092265250116256, 226013198, 226013205, 7, 1440x900 
0x37CA2318, 38092265250771120, 226013262, 226013270, 8, 1440x900 
0x37CA2318, 38092265251434160, 226013328, 226013336, 8, 1440x900 
0x37CA2318, 38092265252097696, 226013397, 226013405, 8, 1440x900 
0x37CA2318, 38092265252757640, 226013462, 226013469, 7, 1440x900 
0x37CA2318, 38092265253416304, 226013528, 226013535, 7, 1440x900 
0x37CA2318, 38092265254073792, 226013593, 226013600, 7, 1440x900 
0x37CA2318, 38092265254733832, 226013658, 226013666, 8, 1440x900 
0x37CA2318, 38092265255401808, 226013727, 226013734, 7, 1440x900 
0x37CA2318, 38092265256071784, 226013793, 226013799, 6, 1440x900 
0x37CA2318, 38092265257013408, 226013885, 226013893, 8, 1440x900 
0x37CA2318, 38092265257405696, 226013928, 226013934, 6, 1440x900 
0x37CA2318, 38092265258063816, 226013993, 226014001, 8, 1440x900 
0x37CA2318, 38092265258921264, 226014078, 226014085, 7, 1440x900 
0x37CA2318, 38092265259558064, 226014143, 226014150, 7, 1440x900 
0x37CA2318, 38092265260049824, 226014193, 226014200, 7, 1440x900 
0x37CA2318, 38092265260913376, 226014279, 226014287, 8, 1440x900 
0x37CA2318, 38092265261376512, 226014323, 226014334, 11, 1440x900 
0x37CA2318, 38092265262219928, 226014422, 226014431, 9, 1440x900 
0x37CA2318, 38092265262808928, 226014466, 226014474, 8, 1440x900 
0x37CA2318, 38092265263416600, 226014527, 226014534, 7, 1440x900 
0x37CA2318, 38092265264053120, 226014591, 226014599, 8, 1440x900 
0x37CA2318, 38092265264707656, 226014657, 226014664, 7, 1440x900 
0x37CA2318, 38092265265369288, 226014723, 226014731, 8, 1440x900 
0x37CA2318, 38092265266027912, 226014788, 226014796, 8, 1440x900 
0x37CA2318, 38092265266689584, 226014858, 226014866, 8, 1440x900 
0x37CA2318, 38092265267359864, 226014928, 226014936, 8, 1440x900 
0x37CA2318, 38092265268027944, 226014993, 226015001, 8, 1440x900 
0x37CA2318, 38092265268698512, 226015062, 226015070, 8, 1440x900 
0x37CA2318, 38092265269358416, 226015128, 226015136, 8, 1440x900 
0x37CA2318, 38092265270017456, 226015193, 226015201, 8, 1440x900 
0x37CA2318, 38092265270679872, 226015259, 226015269, 10, 1440x900 
0x37CA2318, 38092265271333216, 226015322, 226015329, 7, 1440x900 
0x37CA2318, 38092265271998624, 226015387, 226015395, 8, 1440x900 
0x37CA2318, 38092265272653992, 226015451, 226015460, 9, 1440x900 
0x37CA2318, 38092265273315280, 226015518, 226015527, 9, 1440x900 
0x37CA2318, 38092265273975104, 226015583, 226015592, 9, 1440x900 
0x37CA2318, 38092265274649040, 226015653, 226015663, 10, 1440x900 
0x37CA2318, 38092265275303288, 226015717, 226015726, 9, 1440x900 
0x37CA2318, 38092265275964360, 226015784, 226015794, 10, 1440x900 
0x37CA2318, 38092265276623528, 226015848, 226015857, 9, 1440x900 
0x37CA2318, 38092265277283920, 226015916, 226015924, 8, 1440x900 
0x37CA2318, 38092265277941376, 226015981, 226015988, 7, 1440x900 
0x37CA2318, 38092265278601608, 226016046, 226016054, 8, 1440x900 
0x37CA2318, 38092265279265840, 226016120, 226016128, 8, 1440x900 
0x37CA2318, 38092265279921696, 226016182, 226016190, 8, 1440x900 
0x37CA2318, 38092265280694472, 226016257, 226016264, 7, 1440x900 
0x37CA2318, 38092265281596984, 226016348, 226016357, 9, 1440x900 
0x37CA2318, 38092265282332224, 226016418, 226016426, 8, 1440x900 
0x37CA2318, 38092265283398528, 226016524, 226016533, 9, 1440x900 
0x37CA2318, 38092265283701816, 226016560, 226016570, 10, 1440x900 
0x37CA2318, 38092265284150664, 226016602, 226016642, 40, 1440x900 
0x37CA2318, 38092265284831808, 226016667, 226016675, 8, 1440x900 
0x37CA2318, 38092265285457704, 226016731, 226016739, 8, 1440x900 
0x37CA2318, 38092265286117624, 226016799, 226016807, 8, 1440x900 
0x37CA2318, 38092265286787472, 226016863, 226016871, 8, 1440x900 
0x37CA2318, 38092265287584464, 226016943, 226016950, 7, 1440x900 
0x37CA2318, 38092265288130952, 226016997, 226017006, 9, 1440x900 
0x37CA2318, 38092265288792352, 226017063, 226017072, 9, 1440x900 
0x37CA2318, 38092265289440792, 226017132, 226017141, 9, 1440x900 
0x37CA2318, 38092265290134112, 226017201, 226017208, 7, 1440x900 
0x37CA2318, 38092265290749032, 226017262, 226017271, 9, 1440x900 
0x37CA2318, 38092265291409216, 226017328, 226017337, 9, 1440x900 
0x37CA2318, 38092265292357056, 226017419, 226017430, 11, 1440x900 
0x37CA2318, 38092265293398248, 226017527, 226017534, 7, 1440x900 
0x37CA2318, 38092265294058032, 226017592, 226017599, 7, 1440x900 
0x37CA2318, 38092265294720744, 226017658, 226017667, 9, 1440x900 
0x37CA2318, 38092265295481792, 226017741, 226017777, 36, 1440x900 
0x37CA2318, 38092265296507472, 226017838, 226017848, 10, 1440x900 
0x37CA2318, 38092265296868872, 226017882, 226017893, 11, 1440x900 
0x37CA2318, 38092265297755400, 226017960, 226017992, 32, 1440x900 
0x37CA2318, 38092265298159584, 226018002, 226018012, 10, 1440x900 
0x37CA2318, 38092265298968696, 226018083, 226018090, 7, 1440x900 
0x37CA2318, 38092265299460176, 226018133, 226018141, 8, 1440x900 
0x37CA2318, 38092265300121104, 226018198, 226018205, 7, 1440x900 
0x37CA2318, 38092265300806760, 226018266, 226018273, 7, 1440x900 
0x37CA2318, 38092265301432264, 226018328, 226018335, 7, 1440x900 
0x37CA2318, 38092265302212072, 226018407, 226018414, 7, 1440x900 
0x37CA2318, 38092265302753776, 226018463, 226018470, 7, 1440x900 
0x37CA2318, 38092265303414784, 226018527, 226018535, 8, 1440x900 
0x37CA2318, 38092265304077896, 226018598, 226018605, 7, 1440x900 
0x37CA2318, 38092265304733968, 226018663, 226018670, 7, 1440x900 
0x37CA2318, 38092265305394432, 226018728, 226018735, 7, 1440x900 
0x37CA2318, 38092265306055512, 226018798, 226018805, 7, 1440x900 
0x37CA2318, 38092265306748752, 226018862, 226018870, 8, 1440x900 
0x37CA2318, 38092265307377504, 226018925, 226018935, 10, 1440x900 
0x37CA2318, 38092265308493896, 226019044, 226019058, 14, 1440x900 
0x37CA2318, 38092265308805296, 226019073, 226019087, 14, 1440x900 
0x37CA2318, 38092265309488832, 226019136, 226019161, 25, 1440x900 
0x37CA2318, 38092265310262952, 226019221, 226019244, 23, 1440x900 
0x37CA2318, 38092265310881520, 226019273, 226019311, 38, 1440x900 
0x37CA2318, 38092265311387672, 226019328, 226019337, 9, 1440x900 
0x37CA2318, 38092265312060560, 226019402, 226019411, 9, 1440x900 
0x37CA2318, 38092265312678032, 226019453, 226019463, 10, 1440x900 
0x37CA2318, 38092265313335072, 226019517, 226019525, 8, 1440x900 
0x37CA2318, 38092265313987592, 226019582, 226019590, 8, 1440x900 
0x37CA2318, 38092265314850992, 226019673, 226019679, 6, 1440x900 
0x37CA2318, 38092265315315352, 226019718, 226019724, 6, 1440x900 
0x37CA2318, 38092265316172608, 226019802, 226019810, 8, 1440x900 
0x37CA2318, 38092265316842216, 226019873, 226019880, 7, 1440x900 
0x37CA2318, 38092265317491928, 226019933, 226019940, 7, 1440x900 
0x37CA2318, 38092265318152640, 226020001, 226020009, 8, 1440x900 
0x37CA2318, 38092265318814712, 226020069, 226020076, 7, 1440x900 
0x37CA2318, 38092265319473816, 226020133, 226020142, 9, 1440x900 
0x37CA2318, 38092265320132744, 226020198, 226020207, 9, 1440x900 
0x37CA2318, 38092265320802512, 226020267, 226020274, 7, 1440x900 
0x37CA2318, 38092265321464160, 226020333, 226020340, 7, 1440x900 
0x37CA2318, 38092265322122840, 226020397, 226020405, 8, 1440x900 
0x37CA2318, 38092265322778608, 226020463, 226020471, 8, 1440x900 
0x37CA2318, 38092265323447864, 226020533, 226020540, 7, 1440x900 
0x37CA2318, 38092265323902856, 226020578, 226020585, 7, 1440x900 
0x37CA2318, 38092265324767248, 226020663, 226020670, 7, 1440x900 
0x37CA2318, 38092265325433776, 226020729, 226020736, 7, 1440x900 
0x37CA2318, 38092265326087552, 226020797, 226020804, 7, 1440x900 
0x37CA2318, 38092265326748376, 226020862, 226020869, 7, 1440x900 
0x37CA2318, 38092265327409352, 226020927, 226020935, 8, 1440x900 
0x37CA2318, 38092265328074872, 226020993, 226021001, 8, 1440x900 
0x37CA2318, 38092265328739200, 226021061, 226021068, 7, 1440x900 
0x37CA2318, 38092265329389104, 226021126, 226021133, 7, 1440x900 
0x37CA2318, 38092265330049456, 226021188, 226021196, 8, 1440x900 
0x37CA2318, 38092265330711416, 226021256, 226021264, 8, 1440x900 
0x37CA2318, 38092265331379016, 226021323, 226021331, 8, 1440x900 
0x37CA2318, 38092265332032272, 226021388, 226021396, 8, 1440x900 
0x37CA2318, 38092265332690736, 226021453, 226021461, 8, 1440x900 
0x37CA2318, 38092265333352784, 226021521, 226021529, 8, 1440x900 
0x37CA2318, 38092265334013856, 226021587, 226021594, 7, 1440x900 
0x37CA2318, 38092265334665360, 226021652, 226021659, 7, 1440x900 
0x37CA2318, 38092265335336024, 226021722, 226021729, 7, 1440x900 
0x37CA2318, 38092265335988760, 226021787, 226021794, 7, 1440x900 
0x37CA2318, 38092265336649608, 226021853, 226021861, 8, 1440x900 
0x37CA2318, 38092265337319824, 226021918, 226021927, 9, 1440x900 
0x37CA2318, 38092265337981384, 226021988, 226021996, 8, 1440x900 
0x37CA2318, 38092265338638464, 226022053, 226022060, 7, 1440x900 
0x37CA2318, 38092265339308856, 226022122, 226022130, 8, 1440x900 
0x37CA2318, 38092265339977608, 226022186, 226022194, 8, 1440x900 
0x37CA2318, 38092265340629208, 226022252, 226022260, 8, 1440x900 
0x37CA2318, 38092265341295296, 226022317, 226022324, 7, 1440x900 
0x37CA2318, 38092265341951512, 226022382, 226022390, 8, 1440x900 
0x37CA2318, 38092265343278888, 226022516, 226022523, 7, 1440x900 
0x37CA2318, 38092265343944528, 226022582, 226022590, 8, 1440x900 
0x37CA2318, 38092265344595584, 226022648, 226022655, 7, 1440x900 
0x37CA2318, 38092265345272496, 226022718, 226022726, 8, 1440x900 
0x37CA2318, 38092265345739376, 226022763, 226022771, 8, 1440x900 
0x37CA2318, 38092265346841616, 226022897, 226022907, 10, 1440x900 
0x37CA2318, 38092265347488448, 226022941, 226022963, 22, 1440x900 
0x37CA2318, 38092265348860600, 226023094, 226023141, 47, 1440x900 
0x37CA2318, 38092265349626648, 226023167, 226023179, 12, 1440x900 
0x37CA2318, 38092265350074800, 226023193, 226023203, 10, 1440x900 
0x37CA2318, 38092265350293520, 226023222, 226023228, 6, 1440x900 
0x37CA2318, 38092265350970272, 226023288, 226023297, 9, 1440x900 
0x37CA2318, 38092265352272672, 226023412, 226023420, 8, 1440x900 
0x37CA2318, 38092265352968992, 226023482, 226023490, 8, 1440x900 
0x37CA2318, 38092265353610288, 226023547, 226023555, 8, 1440x900 
0x37CA2318, 38092265354257448, 226023612, 226023619, 7, 1440x900 
0x37CA2318, 38092265354942192, 226023689, 226023699, 10, 1440x900 
0x37CA2318, 38092265355593432, 226023748, 226023754, 6, 1440x900 
0x37CA2318, 38092265356254368, 226023814, 226023821, 7, 1440x900 
0x37CA2318, 38092265356919600, 226023879, 226023886, 7, 1440x900 
0x37CA2318, 38092265357579800, 226023943, 226023950, 7, 1440x900 
0x37CA2318, 38092265358235128, 226024008, 226024016, 8, 1440x900 
0x37CA2318, 38092265358904912, 226024078, 226024086, 8, 1440x900 
0x37CA2318, 38092265359560888, 226024142, 226024149, 7, 1440x900 
0x37CA2318, 38092265360214104, 226024207, 226024214, 7, 1440x900 
0x37CA2318, 38092265360873848, 226024273, 226024280, 7, 1440x900 
0x37CA2318, 38092265361532312, 226024337, 226024344, 7, 1440x900 
0x37CA2318, 38092265362198256, 226024407, 226024414, 7, 1440x900 
0x37CA2318, 38092265362854856, 226024472, 226024479, 7, 1440x900 
0x37CA2318, 38092265363519096, 226024538, 226024546, 8, 1440x900 
0x37CA2318, 38092265364184976, 226024606, 226024613, 7, 1440x900 
0x37CA2318, 38092265364836784, 226024671, 226024679, 8, 1440x900 
0x37CA2318, 38092265365688000, 226024757, 226024766, 9, 1440x900 
0x37CA2318, 38092265366349448, 226024823, 226024831, 8, 1440x900 
0x37CA2318, 38092265367019056, 226024893, 226024901, 8, 1440x900 
0x37CA2318, 38092265367678112, 226024957, 226024965, 8, 1440x900 
0x37CA2318, 38092265368339080, 226025022, 226025030, 8, 1440x900 
0x37CA2318, 38092265368989856, 226025088, 226025097, 9, 1440x900 
0x37CA2318, 38092265369659648, 226025157, 226025165, 8, 1440x900 
0x37CA2318, 38092265370312024, 226025222, 226025230, 8, 1440x900 
0x37CA2318, 38092265370970816, 226025287, 226025295, 8, 1440x900 
0x37CA2318, 38092265371630504, 226025353, 226025361, 8, 1440x900 
0x37CA2318, 38092265372290680, 226025417, 226025425, 8, 1440x900 
0x37CA2318, 38092265372960248, 226025483, 226025492, 9, 1440x900 
0x37CA2318, 38092265373619848, 226025553, 226025561, 8, 1440x900 
0x37CA2318, 38092265374279024, 226025617, 226025625, 8, 1440x900 
0x37CA2318, 38092265374939424, 226025678, 226025686, 8, 1440x900 
0x37CA2318, 38092265375594592, 226025747, 226025753, 6, 1440x900 
0x37CA2318, 38092265376256416, 226025812, 226025820, 8, 1440x900 
0x37CA2318, 38092265376917624, 226025878, 226025886, 8, 1440x900 
0x37CA2318, 38092265377580192, 226025943, 226025951, 8, 1440x900 
0x37CA2318, 38092265378247240, 226026016, 226026024, 8, 1440x900 
0x37CA2318, 38092265378897792, 226026077, 226026084, 7, 1440x900 
0x37CA2318, 38092265379568968, 226026143, 226026152, 9, 1440x900 
0x37CA2318, 38092265380230144, 226026213, 226026222, 9, 1440x900 
0x37CA2318, 38092265380712360, 226026263, 226026272, 9, 1440x900 
0x37CA2318, 38092265381360024, 226026322, 226026329, 7, 1440x900 
0x37CA2318, 38092265382022888, 226026387, 226026396, 9, 1440x900 
0x37CA2318, 38092265382682336, 226026453, 226026461, 8, 1440x900 
0x37CA2318, 38092265383342496, 226026521, 226026530, 9, 1440x900 
0x37CA2318, 38092265384014880, 226026591, 226026598, 7, 1440x900 
0x37CA2318, 38092265384672128, 226026657, 226026664, 7, 1440x900 
0x37CA2318, 38092265385329656, 226026718, 226026726, 8, 1440x900 
0x37CA2318, 38092265385989720, 226026783, 226026791, 8, 1440x900 
0x37CA2318, 38092265386656864, 226026852, 226026859, 7, 1440x900 
0x37CA2318, 38092265387311192, 226026917, 226026924, 7, 1440x900 
0x37CA2318, 38092265387984856, 226026983, 226026992, 9, 1440x900 
0x37CA2318, 38092265388633112, 226027052, 226027060, 8, 1440x900 
0x37CA2318, 38092265389291584, 226027117, 226027125, 8, 1440x900 
0x37CA2318, 38092265389961040, 226027183, 226027190, 7, 1440x900 
0x37CA2318, 38092265390620240, 226027247, 226027255, 8, 1440x900 
0x37CA2318, 38092265391476256, 226027333, 226027342, 9, 1440x900 
0x37CA2318, 38092265392127288, 226027398, 226027406, 8, 1440x900 
0x37CA2318, 38092265392799336, 226027468, 226027477, 9, 1440x900 
0x37CA2318, 38092265393460384, 226027533, 226027542, 9, 1440x900 
0x37CA2318, 38092265394121616, 226027603, 226027611, 8, 1440x900 
0x37CA2318, 38092265394783336, 226027667, 226027675, 8, 1440x900 
0x37CA2318, 38092265395437104, 226027732, 226027739, 7, 1440x900 
0x37CA2318, 38092265396099936, 226027798, 226027806, 8, 1440x900 
0x37CA2318, 38092265396763456, 226027862, 226027872, 10, 1440x900 
0x37CA2318, 38092265397433368, 226027932, 226027940, 8, 1440x900 
0x37CA2318, 38092265398083560, 226027998, 226028006, 8, 1440x900 
0x37CA2318, 38092265398744824, 226028064, 226028072, 8, 1440x900 
0x37CA2318, 38092265399407248, 226028128, 226028137, 9, 1440x900 
0x37CA2318, 38092265400076216, 226028198, 226028206, 8, 1440x900 
0x37CA2318, 38092265400726768, 226028264, 226028272, 8, 1440x900 
0x37CA2318, 38092265401387400, 226028328, 226028336, 8, 1440x900 
0x37CA2318, 38092265402040400, 226028392, 226028400, 8, 1440x900 
0x37CA2318, 38092265402718720, 226028463, 226028471, 8, 1440x900 
0x37CA2318, 38092265403369408, 226028528, 226028536, 8, 1440x900 
0x37CA2318, 38092265404037800, 226028592, 226028601, 9, 1440x900 
0x37CA2318, 38092265404689216, 226028658, 226028667, 9, 1440x900 
0x37CA2318, 38092265405350328, 226028721, 226028729, 8, 1440x900 
0x37CA2318, 38092265406011728, 226028788, 226028797, 9, 1440x900 
0x37CA2318, 38092265406671904, 226028857, 226028865, 8, 1440x900 
0x37CA2318, 38092265407340640, 226028923, 226028930, 7, 1440x900 
0x37CA2318, 38092265407999816, 226028987, 226028994, 7, 1440x900 
0x37CA2318, 38092265408659776, 226029052, 226029059, 7, 1440x900 
0x37CA2318, 38092265409329504, 226029117, 226029125, 8, 1440x900 
0x37CA2318, 38092265409989160, 226029182, 226029191, 9, 1440x900 
0x37CA2318, 38092265410658856, 226029252, 226029259, 7, 1440x900 
0x37CA2318, 38092265411318616, 226029317, 226029325, 8, 1440x900 
0x37CA2318, 38092265411977880, 226029382, 226029390, 8, 1440x900 
0x37CA2318, 38092265412647568, 226029452, 226029459, 7, 1440x900 
0x37CA2318, 38092265413297728, 226029516, 226029523, 7, 1440x900 
0x37CA2318, 38092265413958144, 226029582, 226029589, 7, 1440x900 
0x37CA2318, 38092265414619184, 226029648, 226029655, 7, 1440x900 
0x37CA2318, 38092265415280080, 226029714, 226029722, 8, 1440x900 
0x37CA2318, 38092265415950392, 226029782, 226029790, 8, 1440x900 
0x37CA2318, 38092265416600272, 226029847, 226029855, 8, 1440x900 
0x37CA2318, 38092265417262616, 226029913, 226029921, 8, 1440x900 
0x37CA2318, 38092265417933304, 226029982, 226029991, 9, 1440x900 
0x37CA2318, 38092265418582856, 226030048, 226030056, 8, 1440x900 
0x37CA2318, 38092265419254112, 226030113, 226030121, 8, 1440x900 
0x37CA2318, 38092265419900352, 226030178, 226030186, 8, 1440x900 
0x37CA2318, 38092265420572000, 226030248, 226030256, 8, 1440x900 
0x37CA2318, 38092265421232456, 226030312, 226030321, 9, 1440x900 
0x37CA2318, 38092265421897208, 226030378, 226030386, 8, 1440x900 
0x37CA2318, 38092265422563720, 226030442, 226030452, 10, 1440x900 
0x37CA2318, 38092265423215872, 226030513, 226030521, 8, 1440x900 
0x37CA2318, 38092265423878928, 226030578, 226030586, 8, 1440x900 
0x37CA2318, 38092265424355264, 226030627, 226030636, 9, 1440x900 
0x37CA2318, 38092265425665560, 226030752, 226030760, 8, 1440x900 
0x37CA2318, 38092265426324144, 226030818, 226030826, 8, 1440x900 
0x37CA2318, 38092265426983816, 226030883, 226030891, 8, 1440x900 
0x37CA2318, 38092265427642048, 226030948, 226030956, 8, 1440x900 
0x37CA2318, 38092265428309456, 226031018, 226031027, 9, 1440x900 
0x37CA2318, 38092265429153440, 226031103, 226031112, 9, 1440x900 
0x37CA2318, 38092265429823824, 226031173, 226031181, 8, 1440x900 
0x37CA2318, 38092265430494344, 226031237, 226031245, 8, 1440x900 
0x37CA2318, 38092265431145432, 226031303, 226031312, 9, 1440x900 
0x37CA2318, 38092265431618320, 226031353, 226031361, 8, 1440x900 
0x37CA2318, 38092265432285504, 226031417, 226031425, 8, 1440x900 
0x37CA2318, 38092265432944896, 226031482, 226031490, 8, 1440x900 
0x37CA2318, 38092265433598104, 226031546, 226031554, 8, 1440x900 
0x37CA2318, 38092265434264752, 226031612, 226031621, 9, 1440x900 
0x37CA2318, 38092265434927936, 226031681, 226031689, 8, 1440x900 
0x37CA2318, 38092265435585840, 226031743, 226031752, 9, 1440x900 
0x37CA2318, 38092265436249952, 226031817, 226031825, 8, 1440x900 
0x37CA2318, 38092265437095640, 226031897, 226031905, 8, 1440x900 
0x37CA2318, 38092265437765984, 226031963, 226031972, 9, 1440x900 
0x37CA2318, 38092265438418944, 226032033, 226032041, 8, 1440x900 
0x37CA2318, 38092265438888880, 226032078, 226032085, 7, 1440x900 
0x37CA2318, 38092265439548912, 226032143, 226032151, 8, 1440x900 
0x37CA2318, 38092265440212744, 226032209, 226032216, 7, 1440x900 
0x37CA2318, 38092265440872616, 226032273, 226032281, 8, 1440x900 
0x37CA2318, 38092265441532400, 226032338, 226032347, 9, 1440x900 
0x37CA2318, 38092265442202872, 226032408, 226032415, 7, 1440x900 
0x37CA2318, 38092265442866624, 226032474, 226032482, 8, 1440x900 
0x37CA2318, 38092265443530384, 226032537, 226032546, 9, 1440x900 
0x37CA2318, 38092265444184992, 226032607, 226032615, 8, 1440x900 
0x37CA2318, 38092265444847824, 226032673, 226032680, 7, 1440x900 
0x37CA2318, 38092265445504872, 226032738, 226032745, 7, 1440x900 
0x37CA2318, 38092265446366336, 226032828, 226032837, 9, 1440x900 
0x37CA2318, 38092265447017192, 226032888, 226032895, 7, 1440x900 
0x37CA2318, 38092265447688496, 226032957, 226032966, 9, 1440x900 
0x37CA2318, 38092265448348600, 226033023, 226033031, 8, 1440x900 
0x37CA2318, 38092265449015536, 226033093, 226033101, 8, 1440x900 
0x37CA2318, 38092265449671504, 226033153, 226033162, 9, 1440x900 
0x37CA2318, 38092265450331352, 226033223, 226033231, 8, 1440x900 
0x37CA2318, 38092265450992048, 226033288, 226033296, 8, 1440x900 
0x37CA2318, 38092265451661376, 226033353, 226033362, 9, 1440x900 
0x37CA2318, 38092265452307136, 226033422, 226033430, 8, 1440x900 
0x37CA2318, 38092265452979240, 226033488, 226033497, 9, 1440x900 
0x37CA2318, 38092265453629760, 226033553, 226033561, 8, 1440x900 
0x37CA2318, 38092265454299752, 226033622, 226033631, 9, 1440x900 
0x37CA2318, 38092265454962888, 226033682, 226033690, 8, 1440x900 
0x37CA2318, 38092265455621424, 226033751, 226033759, 8, 1440x900 
0x37CA2318, 38092265456282096, 226033813, 226033822, 9, 1440x900 
0x37CA2318, 38092265456934648, 226033882, 226033890, 8, 1440x900 
0x37CA2318, 38092265457613784, 226033952, 226033960, 8, 1440x900 
0x37CA2318, 38092265458266904, 226034013, 226034021, 8, 1440x900 
0x37CA2318, 38092265458923064, 226034078, 226034086, 8, 1440x900 
0x37CA2318, 38092265459594176, 226034148, 226034155, 7, 1440x900 
0x37CA2318, 38092265460257104, 226034217, 226034225, 8, 1440x900 
0x37CA2318, 38092265460917040, 226034279, 226034287, 8, 1440x900 
0x37CA2318, 38092265461576304, 226034348, 226034356, 8, 1440x900 
0x37CA2318, 38092265462232368, 226034412, 226034420, 8, 1440x900 
0x37CA2318, 38092265462894816, 226034479, 226034487, 8, 1440x900 
0x37CA2318, 38092265463556544, 226034543, 226034552, 9, 1440x900 
0x37CA2318, 38092265464212256, 226034613, 226034621, 8, 1440x900 
0x37CA2318, 38092265464882984, 226034677, 226034685, 8, 1440x900 
0x37CA2318, 38092265465543224, 226034742, 226034750, 8, 1440x900 
0x37CA2318, 38092265466203248, 226034808, 226034816, 8, 1440x900 
0x37CA2318, 38092265466872528, 226034878, 226034886, 8, 1440x900 
0x37CA2318, 38092265467523240, 226034938, 226034948, 10, 1440x900 
0x37CA2318, 38092265468181312, 226035007, 226035015, 8, 1440x900 
0x37CA2318, 38092265468852320, 226035072, 226035080, 8, 1440x900 
0x37CA2318, 38092265469506680, 226035138, 226035146, 8, 1440x900 
0x37CA2318, 38092265470158088, 226035203, 226035212, 9, 1440x900 
0x37CA2318, 38092265470829120, 226035273, 226035281, 8, 1440x900 
0x37CA2318, 38092265471492456, 226035338, 226035346, 8, 1440x900 
0x37CA2318, 38092265472144016, 226035403, 226035411, 8, 1440x900 
0x37CA2318, 38092265472819208, 226035473, 226035481, 8, 1440x900 
0x37CA2318, 38092265473474424, 226035538, 226035545, 7, 1440x900 
0x37CA2318, 38092265474141544, 226035603, 226035611, 8, 1440x900 
0x37CA2318, 38092265474806200, 226035672, 226035680, 8, 1440x900 
0x37CA2318, 38092265475476128, 226035738, 226035746, 8, 1440x900 
0x37CA2318, 38092265476135888, 226035802, 226035810, 8, 1440x900 
0x37CA2318, 38092265476786928, 226035867, 226035875, 8, 1440x900 
0x37CA2318, 38092265477448816, 226035933, 226035941, 8, 1440x900 
0x37CA2318, 38092265478118408, 226035998, 226036008, 10, 1440x900 
0x37CA2318, 38092265478777864, 226036068, 226036076, 8, 1440x900 
0x37CA2318, 38092265479446696, 226036132, 226036139, 7, 1440x900 
0x37CA2318, 38092265480098544, 226036197, 226036204, 7, 1440x900 
0x37CA2318, 38092265480758504, 226036262, 226036270, 8, 1440x900 
0x37CA2318, 38092265481418576, 226036328, 226036335, 7, 1440x900 
0x37CA2318, 38092265482077184, 226036393, 226036401, 8, 1440x900 
0x37CA2318, 38092265482751520, 226036467, 226036475, 8, 1440x900 
0x37CA2318, 38092265483402296, 226036527, 226036536, 9, 1440x900 
0x37CA2318, 38092265484065480, 226036597, 226036605, 8, 1440x900 
0x37CA2318, 38092265484723424, 226036659, 226036668, 9, 1440x900 
0x37CA2318, 38092265485384488, 226036727, 226036736, 9, 1440x900 
0x37CA2318, 38092265485860112, 226036775, 226036784, 9, 1440x900 
0x37CA2318, 38092265486510200, 226036838, 226036846, 8, 1440x900 
0x37CA2318, 38092265487171408, 226036903, 226036911, 8, 1440x900 
0x37CA2318, 38092265487831936, 226036968, 226036976, 8, 1440x900 
0x37CA2318, 38092265489156440, 226037102, 226037110, 8, 1440x900 
0x37CA2318, 38092265489888336, 226037179, 226037186, 7, 1440x900 
0x37CA2318, 38092265490476960, 226037233, 226037241, 8, 1440x900 
0x37CA2318, 38092265491138184, 226037301, 226037309, 8, 1440x900 
0x37CA2318, 38092265491809392, 226037372, 226037380, 8, 1440x900 
0x37CA2318, 38092265492471504, 226037437, 226037445, 8, 1440x900 
0x37CA2318, 38092265493309464, 226037519, 226037527, 8, 1440x900 
0x37CA2318, 38092265493989144, 226037587, 226037595, 8, 1440x900 
0x37CA2318, 38092265494639944, 226037652, 226037661, 9, 1440x900 
0x37CA2318, 38092265495303720, 226037718, 226037726, 8, 1440x900 
0x37CA2318, 38092265495962536, 226037783, 226037792, 9, 1440x900 
0x37CA2318, 38092265496615336, 226037853, 226037861, 8, 1440x900 
0x37CA2318, 38092265497275728, 226037917, 226037925, 8, 1440x900 
0x37CA2318, 38092265497754832, 226037963, 226037971, 8, 1440x900 
0x37CA2318, 38092265498411048, 226038027, 226038034, 7, 1440x900 
0x37CA2318, 38092265499080200, 226038098, 226038106, 8, 1440x900 
0x37CA2318, 38092265499738032, 226038158, 226038167, 9, 1440x900 
0x37CA2318, 38092265500401896, 226038229, 226038236, 7, 1440x900 
0x37CA2318, 38092265501066232, 226038292, 226038300, 8, 1440x900 
0x37CA2318, 38092265501729336, 226038358, 226038366, 8, 1440x900 
0x37CA2318, 38092265502384016, 226038423, 226038431, 8, 1440x900 
0x37CA2318, 38092265503046712, 226038497, 226038505, 8, 1440x900 
0x37CA2318, 38092265503713160, 226038563, 226038572, 9, 1440x900 
0x37CA2318, 38092265504365184, 226038626, 226038634, 8, 1440x900 
0x37CA2318, 38092265505022224, 226038688, 226038695, 7, 1440x900 
0x37CA2318, 38092265505683008, 226038753, 226038761, 8, 1440x900 
0x37CA2318, 38092265506558256, 226038841, 226038850, 9, 1440x900 
0x37CA2318, 38092265507219760, 226038907, 226038915, 8, 1440x900 
0x37CA2318, 38092265507874600, 226038973, 226038981, 8, 1440x900 
0x37CA2318, 38092265508542064, 226039043, 226039051, 8, 1440x900 
0x37CA2318, 38092265509203256, 226039107, 226039115, 8, 1440x900 
0x37CA2318, 38092265509872848, 226039178, 226039186, 8, 1440x900 
0x37CA2318, 38092265510328088, 226039219, 226039228, 9, 1440x900 
0x37CA2318, 38092265510993784, 226039288, 226039296, 8, 1440x900 
0x37CA2318, 38092265511706304, 226039357, 226039365, 8, 1440x900 
0x37CA2318, 38092265512563960, 226039448, 226039456, 8, 1440x900 
0x37CA2318, 38092265513206704, 226039509, 226039518, 9, 1440x900 
0x37CA2318, 38092265513867960, 226039573, 226039581, 8, 1440x900 
0x37CA2318, 38092265514893112, 226039676, 226039688, 12, 1440x900 
0x37CA2318, 38092265515172424, 226039709, 226039723, 14, 1440x900 
0x37CA2318, 38092265515746272, 226039758, 226039767, 9, 1440x900 
0x37CA2318, 38092265516339208, 226039822, 226039828, 6, 1440x900 
0x37CA2318, 38092265517003216, 226039887, 226039895, 8, 1440x900 
0x37CA2318, 38092265517857344, 226039973, 226039982, 9, 1440x900 
0x37CA2318, 38092265518323768, 226040017, 226040025, 8, 1440x900 
0x37CA2318, 38092265519114080, 226040113, 226040140, 27, 1440x900 
0x37CA2318, 38092265519898376, 226040192, 226040214, 22, 1440x900 
0x37CA2318, 38092265520577032, 226040251, 226040291, 40, 1440x900 
0x37CA2318, 38092265521265008, 226040320, 226040341, 21, 1440x900 
0x37CA2318, 38092265521917056, 226040380, 226040400, 20, 1440x900 
0x37CA2318, 38092265522550016, 226040442, 226040448, 6, 1440x900 
0x37CA2318, 38092265523075216, 226040492, 226040499, 7, 1440x900 
0x37CA2318, 38092265523735176, 226040558, 226040565, 7, 1440x900 
0x37CA2318, 38092265524396272, 226040623, 226040631, 8, 1440x900 
0x37CA2318, 38092265525055896, 226040692, 226040698, 6, 1440x900 
0x37CA2318, 38092265525909552, 226040777, 226040782, 5, 1440x900 
0x37CA2318, 38092265526470552, 226040833, 226040840, 7, 1440x900 
0x37CA2318, 38092265527036208, 226040889, 226040895, 6, 1440x900 
0x37CA2318, 38092265527696304, 226040957, 226040964, 7, 1440x900 
0x37CA2318, 38092265528356384, 226041022, 226041029, 7, 1440x900 
0x37CA2318, 38092265529020776, 226041093, 226041101, 8, 1440x900 
0x37CA2318, 38092265529681328, 226041158, 226041166, 8, 1440x900 
0x37CA2318, 38092265530341392, 226041223, 226041231, 8, 1440x900 
0x37CA2318, 38092265531198848, 226041312, 226041319, 7, 1440x900 
0x37CA2318, 38092265531883824, 226041390, 226041408, 18, 1440x900 
0x37CA2318, 38092265532560496, 226041445, 226041471, 26, 1440x900 
0x37CA2318, 38092265533125736, 226041501, 226041523, 22, 1440x900 
0x37CA2318, 38092265533818272, 226041574, 226041589, 15, 1440x900 
0x37CA2318, 38092265534473984, 226041650, 226041660, 10, 1440x900 
0x37CA2318, 38092265535222872, 226041713, 226041722, 9, 1440x900 
0x37CA2318, 38092265535736600, 226041774, 226041785, 11, 1440x900 
0x37CA2318, 38092265536427160, 226041847, 226041870, 23, 1440x900 
0x37CA2318, 38092265537170664, 226041911, 226041929, 18, 1440x900 
0x37CA2318, 38092265537757704, 226041959, 226041984, 25, 1440x900 
0x37CA2318, 38092265538458336, 226042032, 226042053, 21, 1440x900 
0x37CA2318, 38092265539170000, 226042116, 226042136, 20, 1440x900 
0x37CA2318, 38092265539756272, 226042170, 226042185, 15, 1440x900 
0x37CA2318, 38092265540404264, 226042228, 226042250, 22, 1440x900 
0x37CA2318, 38092265541096232, 226042310, 226042318, 8, 1440x900 
0x37CA2318, 38092265541777312, 226042367, 226042389, 22, 1440x900 
0x37CA2318, 38092265542438424, 226042431, 226042456, 25, 1440x900 
0x37CA2318, 38092265543068528, 226042493, 226042498, 5, 1440x900 
0x37CA2318, 38092265543628968, 226042548, 226042554, 6, 1440x900 
0x37CA2318, 38092265544418224, 226042636, 226042651, 15, 1440x900 
0x37CA2318, 38092265544946088, 226042686, 226042706, 20, 1440x900 
0x37CA2318, 38092265545612952, 226042762, 226042795, 33, 1440x900 
0x37CA2318, 38092265546279048, 226042817, 226042835, 18, 1440x900 
0x37CA2318, 38092265546972560, 226042882, 226042888, 6, 1440x900 
0x37CA2318, 38092265547595192, 226042947, 226042952, 5, 1440x900 
0x37CA2318, 38092265548249032, 226043011, 226043015, 4, 1440x900 
0x37CA2318, 38092265548952864, 226043091, 226043103, 12, 1440x900 
0x37CA2318, 38092265549637688, 226043157, 226043188, 31, 1440x900 
0x37CA2318, 38092265550298344, 226043220, 226043238, 18, 1440x900 
0x37CA2318, 38092265550994504, 226043304, 226043329, 25, 1440x900 
0x37CA2318, 38092265551565312, 226043344, 226043363, 19, 1440x900 
0x37CA2318, 38092265552249136, 226043409, 226043434, 25, 1440x900 
0x37CA2318, 38092265552947432, 226043479, 226043503, 24, 1440x900 
0x37CA2318, 38092265553646080, 226043564, 226043571, 7, 1440x900 
0x37CA2318, 38092265554322312, 226043630, 226043643, 13, 1440x900 
0x37CA2318, 38092265554987808, 226043693, 226043707, 14, 1440x900 
0x37CA2318, 38092265555660016, 226043761, 226043774, 13, 1440x900 
0x37CA2318, 38092265556972296, 226043885, 226043907, 22, 1440x900 
0x37CA2318, 38092265557605448, 226043948, 226043971, 23, 1440x900 
0x37CA2318, 38092265558266776, 226044016, 226044034, 18, 1440x900 
0x37CA2318, 38092265558928776, 226044081, 226044101, 20, 1440x900 
0x37CA2318, 38092265559620728, 226044150, 226044170, 20, 1440x900 
0x37CA2318, 38092265560292336, 226044219, 226044239, 20, 1440x900 
0x37CA2318, 38092265560964592, 226044319, 226044345, 26, 1440x900 
0x37CA2318, 38092265561723968, 226044366, 226044381, 15, 1440x900 
0x37CA2318, 38092265562191168, 226044418, 226044430, 12, 1440x900 
0x37CA2318, 38092265562871464, 226044486, 226044511, 25, 1440x900 
0x37CA2318, 38092265563601912, 226044553, 226044559, 6, 1440x900 
0x37CA2318, 38092265564290928, 226044616, 226044638, 22, 1440x900 
0x37CA2318, 38092265564954376, 226044679, 226044703, 24, 1440x900 
0x37CA2318, 38092265565519880, 226044747, 226044753, 6, 1440x900 
0x37CA2318, 38092265566163256, 226044805, 226044824, 19, 1440x900 
0x37CA2318, 38092265566898312, 226044879, 226044897, 18, 1440x900 
0x37CA2318, 38092265567608480, 226044960, 226044969, 9, 1440x900 
0x37CA2318, 38092265568293504, 226045013, 226045038, 25, 1440x900 
0x37CA2318, 38092265568982856, 226045082, 226045106, 24, 1440x900 
0x37CA2318, 38092265569527288, 226045146, 226045170, 24, 1440x900 
0x37CA2318, 38092265570267944, 226045216, 226045236, 20, 1440x900 
0x37CA2318, 38092265570837072, 226045268, 226045275, 7, 1440x900 
0x37CA2318, 38092265571589808, 226045346, 226045366, 20, 1440x900 
0x37CA2318, 38092265572273968, 226045416, 226045439, 23, 1440x900 
0x37CA2318, 38092265572965616, 226045487, 226045504, 17, 1440x900 
0x37CA2318, 38092265573633048, 226045547, 226045558, 11, 1440x900 
0x37CA2318, 38092265574157496, 226045615, 226045624, 9, 1440x900 
0x37CA2318, 38092265574842272, 226045682, 226045696, 14, 1440x900 
0x37CA2318, 38092265575496648, 226045740, 226045757, 17, 1440x900 
0x37CA2318, 38092265576168840, 226045802, 226045824, 22, 1440x900 
0x37CA2318, 38092265576877136, 226045884, 226045901, 17, 1440x900 
0x37CA2318, 38092265577632944, 226045953, 226045977, 24, 1440x900 
0x37CA2318, 38092265578154144, 226046002, 226046007, 5, 1440x900 
0x37CA2318, 38092265578839512, 226046068, 226046092, 24, 1440x900 
0x37CA2318, 38092265579557400, 226046140, 226046164, 24, 1440x900 
0x37CA2318, 38092265580257328, 226046209, 226046234, 25, 1440x900 
0x37CA2318, 38092265580783328, 226046266, 226046298, 32, 1440x900 
0x37CA2318, 38092265581498512, 226046342, 226046357, 15, 1440x900 
0x37CA2318, 38092265582176312, 226046415, 226046443, 28, 1440x900 
0x37CA2318, 38092265582846464, 226046468, 226046477, 9, 1440x900 
0x37CA2318, 38092265583590848, 226046543, 226046566, 23, 1440x900 
0x37CA2318, 38092265584138008, 226046598, 226046626, 28, 1440x900 
0x37CA2318, 38092265584795728, 226046666, 226046671, 5, 1440x900 
0x37CA2318, 38092265585422336, 226046729, 226046754, 25, 1440x900 
0x37CA2318, 38092265586120840, 226046804, 226046815, 11, 1440x900 
0x37CA2318, 38092265586783976, 226046871, 226046885, 14, 1440x900 
0x37CA2318, 38092265587500688, 226046937, 226046942, 5, 1440x900 
0x37CA2318, 38092265588049936, 226046990, 226046998, 8, 1440x900 
0x37CA2318, 38092265588809488, 226047077, 226047085, 8, 1440x900 
0x37CA2318, 38092265589463352, 226047133, 226047156, 23, 1440x900 
0x37CA2318, 38092265590150960, 226047202, 226047207, 5, 1440x900 
0x37CA2318, 38092265590706160, 226047258, 226047268, 10, 1440x900 
0x37CA2318, 38092265591487376, 226047337, 226047356, 19, 1440x900 
0x37CA2318, 38092265592166568, 226047402, 226047407, 5, 1440x900 
0x37CA2318, 38092265592690280, 226047459, 226047481, 22, 1440x900 
0x37CA2318, 38092265593448736, 226047547, 226047555, 8, 1440x900 
0x37CA2318, 38092265594122880, 226047597, 226047602, 5, 1440x900 
0x37CA2318, 38092265594734752, 226047665, 226047672, 7, 1440x900 
0x37CA2318, 38092265595395432, 226047723, 226047735, 12, 1440x900 
0x37CA2318, 38092265596143464, 226047798, 226047823, 25, 1440x900 
0x37CA2318, 38092265596682408, 226047853, 226047877, 24, 1440x900 
0x37CA2318, 38092265597486432, 226047933, 226047942, 9, 1440x900 
0x37CA2318, 38092265598025448, 226047987, 226047993, 6, 1440x900 
0x37CA2318, 38092265598700672, 226048064, 226048089, 25, 1440x900 
0x37CA2318, 38092265599355560, 226048121, 226048143, 22, 1440x900 
0x37CA2318, 38092265600067752, 226048192, 226048199, 7, 1440x900 
0x37CA2318, 38092265600798280, 226048265, 226048272, 7, 1440x900 
0x37CA2318, 38092265601331928, 226048318, 226048330, 12, 1440x900 
0x37CA2318, 38092265601991440, 226048393, 226048405, 12, 1440x900 
0x37CA2318, 38092265602694768, 226048457, 226048464, 7, 1440x900 
0x37CA2318, 38092265603348456, 226048529, 226048537, 8, 1440x900 
0x37CA2318, 38092265603973112, 226048590, 226048603, 13, 1440x900 
0x37CA2318, 38092265604704424, 226048669, 226048677, 8, 1440x900 
0x37CA2318, 38092265605354096, 226048722, 226048727, 5, 1440x900 
0x37CA2318, 38092265605961488, 226048780, 226048791, 11, 1440x900 
0x37CA2318, 38092265606647464, 226048849, 226048856, 7, 1440x900 
0x37CA2318, 38092265607397608, 226048924, 226048930, 6, 1440x900 
0x37CA2318, 38092265607953784, 226048979, 226048986, 7, 1440x900 
0x37CA2318, 38092265608717824, 226049060, 226049065, 5, 1440x900 
0x37CA2318, 38092265609277984, 226049112, 226049122, 10, 1440x900 
0x37CA2318, 38092265610032808, 226049187, 226049196, 9, 1440x900 
0x37CA2318, 38092265610591600, 226049246, 226049252, 6, 1440x900 
0x37CA2318, 38092265611365880, 226049327, 226049344, 17, 1440x900 
0x37CA2318, 38092265611915744, 226049378, 226049383, 5, 1440x900 
0x37CA2318, 38092265612675040, 226049453, 226049476, 23, 1440x900 
0x37CA2318, 38092265613360896, 226049522, 226049528, 6, 1440x900 
0x37CA2318, 38092265613999720, 226049586, 226049591, 5, 1440x900 
0x37CA2318, 38092265614621416, 226049650, 226049668, 18, 1440x900 
0x37CA2318, 38092265615333288, 226049724, 226049739, 15, 1440x900 
0x37CA2318, 38092265616010488, 226049785, 226049792, 7, 1440x900 
0x37CA2318, 38092265616548888, 226049846, 226049863, 17, 1440x900 
0x37CA2318, 38092265617293624, 226049913, 226049932, 19, 1440x900 
0x37CA2318, 38092265617859352, 226049971, 226049993, 22, 1440x900 
0x37CA2318, 38092265618600208, 226050045, 226050051, 6, 1440x900 
0x37CA2318, 38092265619182272, 226050119, 226050126, 7, 1440x900 
0x37CA2318, 38092265619896568, 226050178, 226050183, 5, 1440x900 
0x37CA2318, 38092265620635456, 226050249, 226050256, 7, 1440x900 
0x37CA2318, 38092265621207816, 226050311, 226050326, 15, 1440x900 
0x37CA2318, 38092265621931824, 226050378, 226050384, 6, 1440x900 
0x37CA2318, 38092265622527592, 226050442, 226050453, 11, 1440x900 
0x37CA2318, 38092265623240904, 226050512, 226050520, 8, 1440x900 
0x37CA2318, 38092265623829512, 226050570, 226050592, 22, 1440x900 
0x37CA2318, 38092265624555232, 226050642, 226050647, 5, 1440x900 
0x37CA2318, 38092265625237128, 226050707, 226050714, 7, 1440x900 
0x37CA2318, 38092265625799520, 226050763, 226050771, 8, 1440x900 
0x37CA2318, 38092265626510656, 226050835, 226050860, 25, 1440x900 
0x37CA2318, 38092265627219504, 226050907, 226050931, 24, 1440x900 
0x37CA2318, 38092265627825752, 226050978, 226050984, 6, 1440x900 
0x37CA2318, 38092265628443496, 226051028, 226051035, 7, 1440x900 
0x37CA2318, 38092265629211496, 226051107, 226051130, 23, 1440x900 
0x37CA2318, 38092265629768096, 226051168, 226051185, 17, 1440x900 
0x37CA2318, 38092265630462384, 226051231, 226051238, 7, 1440x900 
0x37CA2318, 38092265631236064, 226051309, 226051332, 23, 1440x900 
0x37CA2318, 38092265631937856, 226051378, 226051388, 10, 1440x900 
0x37CA2318, 38092265632464608, 226051432, 226051438, 6, 1440x900 
0x37CA2318, 38092265633212864, 226051517, 226051528, 11, 1440x900 
0x37CA2318, 38092265633838768, 226051578, 226051582, 4, 1440x900 
0x37CA2318, 38092265634452432, 226051630, 226051636, 6, 1440x900 
0x37CA2318, 38092265635199432, 226051707, 226051711, 4, 1440x900 
0x37CA2318, 38092265635796680, 226051773, 226051780, 7, 1440x900 
0x37CA2318, 38092265636437168, 226051827, 226051851, 24, 1440x900 
0x37CA2318, 38092265637201048, 226051905, 226051929, 24, 1440x900 
0x37CA2318, 38092265637731096, 226051967, 226051980, 13, 1440x900 
0x37CA2318, 38092265638397776, 226052024, 226052031, 7, 1440x900 
0x37CA2318, 38092265639131408, 226052098, 226052105, 7, 1440x900 
0x37CA2318, 38092265639729536, 226052161, 226052179, 18, 1440x900 
0x37CA2318, 38092265640438040, 226052228, 226052234, 6, 1440x900 
0x37CA2318, 38092265641230200, 226052308, 226052330, 22, 1440x900 
0x37CA2318, 38092265641778920, 226052373, 226052395, 22, 1440x900 
0x37CA2318, 38092265642489496, 226052432, 226052441, 9, 1440x900 
0x37CA2318, 38092265643222880, 226052507, 226052514, 7, 1440x900 
0x37CA2318, 38092265643759040, 226052563, 226052567, 4, 1440x900 
0x37CA2318, 38092265644534392, 226052640, 226052646, 6, 1440x900 
0x37CA2318, 38092265645095760, 226052708, 226052715, 7, 1440x900 
0x37CA2318, 38092265645814248, 226052769, 226052776, 7, 1440x900 
0x37CA2318, 38092265646563312, 226052840, 226052847, 7, 1440x900 
0x37CA2318, 38092265647129232, 226052897, 226052908, 11, 1440x900 
0x37CA2318, 38092265647880008, 226052973, 226052980, 7, 1440x900 
0x37CA2318, 38092265648415280, 226053027, 226053050, 23, 1440x900 
0x37CA2318, 38092265649115448, 226053103, 226053118, 15, 1440x900 
0x37CA2318, 38092265649872584, 226053178, 226053195, 17, 1440x900 
0x37CA2318, 38092265650551208, 226053238, 226053255, 17, 1440x900 
0x37CA2318, 38092265651110544, 226053302, 226053320, 18, 1440x900 
0x37CA2318, 38092265651871968, 226053373, 226053396, 23, 1440x900 
0x37CA2318, 38092265652403152, 226053424, 226053434, 10, 1440x900 
0x37CA2318, 38092265653151280, 226053499, 226053506, 7, 1440x900 
0x37CA2318, 38092265653729392, 226053572, 226053580, 8, 1440x900 
0x37CA2318, 38092265654444280, 226053629, 226053638, 9, 1440x900 
0x37CA2318, 38092265655204104, 226053708, 226053715, 7, 1440x900 
0x37CA2318, 38092265655939800, 226053779, 226053802, 23, 1440x900 
0x37CA2318, 38092265656469624, 226053834, 226053841, 7, 1440x900 
0x37CA2318, 38092265657260448, 226053915, 226053933, 18, 1440x900 
0x37CA2318, 38092265657781696, 226053965, 226053986, 21, 1440x900 
0x37CA2318, 38092265658509328, 226054037, 226054047, 10, 1440x900 
0x37CA2318, 38092265659252176, 226054108, 226054118, 10, 1440x900 
0x37CA2318, 38092265659782792, 226054164, 226054187, 23, 1440x900 
0x37CA2318, 38092265660565704, 226054242, 226054265, 23, 1440x900 
0x37CA2318, 38092265661090512, 226054300, 226054316, 16, 1440x900 
0x37CA2318, 38092265661837016, 226054367, 226054375, 8, 1440x900 
0x37CA2318, 38092265662414616, 226054441, 226054448, 7, 1440x900 
0x37CA2318, 38092265663200720, 226054514, 226054523, 9, 1440x900 
0x37CA2318, 38092265663871768, 226054573, 226054595, 22, 1440x900 
0x37CA2318, 38092265664392720, 226054632, 226054646, 14, 1440x900 
0x37CA2318, 38092265665132136, 226054699, 226054723, 24, 1440x900 
0x37CA2318, 38092265665751408, 226054758, 226054784, 26, 1440x900 
0x37CA2318, 38092265667024480, 226054887, 226054894, 7, 1440x900 
0x37CA2318, 38092265667681576, 226054952, 226054958, 6, 1440x900 
0x37CA2318, 38092265668336368, 226055019, 226055027, 8, 1440x900 
0x37CA2318, 38092265668999040, 226055086, 226055091, 5, 1440x900 
0x37CA2318, 38092265669652232, 226055152, 226055157, 5, 1440x900 
0x37CA2318, 38092265670513240, 226055238, 226055244, 6, 1440x900 
0x37CA2318, 38092265670976808, 226055283, 226055290, 7, 1440x900 
0x37CA2318, 38092265671754576, 226055363, 226055369, 6, 1440x900 
0x37CA2318, 38092265672299080, 226055418, 226055424, 6, 1440x900 
0x37CA2318, 38092265672956968, 226055483, 226055489, 6, 1440x900 
0x37CA2318, 38092265673616256, 226055548, 226055553, 5, 1440x900 
0x37CA2318, 38092265674276688, 226055613, 226055619, 6, 1440x900 
0x37CA2318, 38092265674936544, 226055678, 226055685, 7, 1440x900 
0x37CA2318, 38092265675599920, 226055747, 226055754, 7, 1440x900 
0x37CA2318, 38092265676260736, 226055818, 226055826, 8, 1440x900 
0x37CA2318, 38092265676997312, 226055887, 226055907, 20, 1440x900 
0x37CA2318, 38092265677732352, 226055959, 226055984, 25, 1440x900 
0x37CA2318, 38092265678303536, 226056016, 226056038, 22, 1440x900 
0x37CA2318, 38092265679029960, 226056087, 226056113, 26, 1440x900 
0x37CA2318, 38092265679773680, 226056162, 226056183, 21, 1440x900 
0x37CA2318, 38092265680298568, 226056214, 226056232, 18, 1440x900 
0x37CA2318, 38092265681032640, 226056288, 226056315, 27, 1440x900 
0x37CA2318, 38092265681643376, 226056363, 226056371, 8, 1440x900 
0x37CA2318, 38092265682354584, 226056425, 226056443, 18, 1440x900 
0x37CA2318, 38092265683052816, 226056488, 226056503, 15, 1440x900 
0x37CA2318, 38092265683601128, 226056543, 226056568, 25, 1440x900 
0x37CA2318, 38092265684395664, 226056641, 226056648, 7, 1440x900 
0x37CA2318, 38092265684963352, 226056691, 226056703, 12, 1440x900 
0x37CA2318, 38092265685649568, 226056761, 226056774, 13, 1440x900 
0x37CA2318, 38092265686388904, 226056827, 226056833, 6, 1440x900 
0x37CA2318, 38092265686965560, 226056884, 226056891, 7, 1440x900 
0x37CA2318, 38092265687791616, 226056964, 226056993, 29, 1440x900 
0x37CA2318, 38092265688329744, 226057029, 226057043, 14, 1440x900 
0x37CA2318, 38092265689086312, 226057094, 226057104, 10, 1440x900 
0x37CA2318, 38092265689676032, 226057163, 226057178, 15, 1440x900 
0x37CA2318, 38092265690432192, 226057256, 226057285, 29, 1440x900 
0x37CA2318, 38092265691130640, 226057311, 226057325, 14, 1440x900 
0x37CA2318, 38092265691838392, 226057370, 226057392, 22, 1440x900 
0x37CA2318, 38092265692587648, 226057447, 226057470, 23, 1440x900 
0x37CA2318, 38092265693176680, 226057504, 226057537, 33, 1440x900 
0x37CA2318, 38092265693766392, 226057569, 226057595, 26, 1440x900 
0x37CA2318, 38092265694462040, 226057646, 226057657, 11, 1440x900 
0x37CA2318, 38092265694965232, 226057682, 226057713, 31, 1440x900 
0x37CA2318, 38092265695807264, 226057775, 226057781, 6, 1440x900 
0x37CA2318, 38092265696266640, 226057814, 226057842, 28, 1440x900 
0x37CA2318, 38092265697000952, 226057888, 226057896, 8, 1440x900 
0x37CA2318, 38092265697569088, 226057943, 226057949, 6, 1440x900 
0x37CA2318, 38092265698225664, 226058008, 226058015, 7, 1440x900 
0x37CA2318, 38092265698898136, 226058073, 226058080, 7, 1440x900 
0x37CA2318, 38092265699588568, 226058146, 226058151, 5, 1440x900 
0x37CA2318, 38092265700246112, 226058308, 226058319, 11, 1440x900 
0x37CA2318, 38092265701902224, 226058378, 226058383, 5, 1440x900 
0x37CA2318, 38092265702562008, 226058443, 226058448, 5, 1440x900 
0x37CA2318, 38092265703228632, 226058507, 226058514, 7, 1440x900 
0x37CA2318, 38092265703962416, 226058582, 226058591, 9, 1440x900 
0x37CA2318, 38092265704554000, 226058641, 226058647, 6, 1440x900 
0x37CA2318, 38092265705216592, 226058707, 226058714, 7, 1440x900 
0x37CA2318, 38092265706062736, 226058790, 226058797, 7, 1440x900 
0x37CA2318, 38092265706554512, 226058847, 226058876, 29, 1440x900 
0x37CA2318, 38092265707363512, 226058923, 226058931, 8, 1440x900 
0x37CA2318, 38092265707912192, 226058983, 226058992, 9, 1440x900 
0x37CA2318, 38092265709004152, 226059093, 226059100, 7, 1440x900 
0x37CA2318, 38092265709398632, 226059128, 226059138, 10, 1440x900 
0x37CA2318, 38092265710013320, 226059188, 226059198, 10, 1440x900 
0x37CA2318, 38092265710674736, 226059252, 226059260, 8, 1440x900 
0x37CA2318, 38092265711337224, 226059322, 226059328, 6, 1440x900 
0x37CA2318, 38092265712002392, 226059387, 226059396, 9, 1440x900 
0x37CA2318, 38092265712917296, 226059476, 226059492, 16, 1440x900 
0x37CA2318, 38092265713324760, 226059517, 226059526, 9, 1440x900 
0x37CA2318, 38092265713983440, 226059586, 226059592, 6, 1440x900 
0x37CA2318, 38092265714644512, 226059648, 226059655, 7, 1440x900 
0x37CA2318, 38092265715304608, 226059716, 226059724, 8, 1440x900 
0x37CA2318, 38092265715967480, 226059782, 226059789, 7, 1440x900 
0x37CA2318, 38092265716628720, 226059848, 226059856, 8, 1440x900 
0x37CA2318, 38092265717293800, 226059918, 226059926, 8, 1440x900 
0x37CA2318, 38092265717981168, 226059983, 226059991, 8, 1440x900 
0x37CA2318, 38092265718608904, 226060047, 226060054, 7, 1440x900 
0x37CA2318, 38092265719268816, 226060112, 226060119, 7, 1440x900 
0x37CA2318, 38092265719928896, 226060177, 226060185, 8, 1440x900 
0x37CA2318, 38092265720589184, 226060247, 226060254, 7, 1440x900 
0x37CA2318, 38092265721257472, 226060313, 226060322, 9, 1440x900 
0x37CA2318, 38092265721916408, 226060381, 226060389, 8, 1440x900 
0x37CA2318, 38092265722582432, 226060444, 226060453, 9, 1440x900 
0x37CA2318, 38092265723235856, 226060512, 226060519, 7, 1440x900 
0x37CA2318, 38092265723886880, 226060572, 226060581, 9, 1440x900 
0x37CA2318, 38092265724547432, 226060641, 226060648, 7, 1440x900 
0x37CA2318, 38092265725207504, 226060707, 226060714, 7, 1440x900 
0x37CA2318, 38092265725868392, 226060772, 226060779, 7, 1440x900 
0x37CA2318, 38092265726527616, 226060838, 226060847, 9, 1440x900 
0x37CA2318, 38092265727188504, 226060906, 226060913, 7, 1440x900 
0x37CA2318, 38092265727847728, 226060972, 226060979, 7, 1440x900 
0x37CA2318, 38092265728507632, 226061037, 226061045, 8, 1440x900 
0x37CA2318, 38092265729172720, 226061103, 226061111, 8, 1440x900 
0x37CA2318, 38092265729832568, 226061171, 226061179, 8, 1440x900 
0x37CA2318, 38092265730505408, 226061239, 226061247, 8, 1440x900 
0x37CA2318, 38092265731157000, 226061302, 226061310, 8, 1440x900 
0x37CA2318, 38092265731819520, 226061368, 226061377, 9, 1440x900 
0x37CA2318, 38092265732470944, 226061432, 226061440, 8, 1440x900 
0x37CA2318, 38092265733135408, 226061497, 226061506, 9, 1440x900 
0x37CA2318, 38092265733838792, 226061568, 226061577, 9, 1440x900 
0x37CA2318, 38092265734450720, 226061633, 226061641, 8, 1440x900 
0x37CA2318, 38092265735123360, 226061703, 226061712, 9, 1440x900 
0x37CA2318, 38092265735783008, 226061768, 226061776, 8, 1440x900 
0x37CA2318, 38092265736441656, 226061832, 226061840, 8, 1440x900 
0x37CA2318, 38092265737148312, 226061919, 226061936, 17, 1440x900 
0x37CA2318, 38092265737976704, 226061991, 226062010, 19, 1440x900 
0x37CA2318, 38092265738528056, 226062044, 226062054, 10, 1440x900 
0x37CA2318, 38092265739094824, 226062094, 226062103, 9, 1440x900 
0x37CA2318, 38092265739746080, 226062163, 226062171, 8, 1440x900 
0x37CA2318, 38092265740409200, 226062228, 226062235, 7, 1440x900 
0x37CA2318, 38092265741211008, 226062307, 226062316, 9, 1440x900 
0x37CA2318, 38092265741745000, 226062358, 226062366, 8, 1440x900 
0x37CA2318, 38092265742390520, 226062423, 226062433, 10, 1440x900 
0x37CA2318, 38092265743049744, 226062492, 226062499, 7, 1440x900 
0x37CA2318, 38092265743710208, 226062557, 226062566, 9, 1440x900 
0x37CA2318, 38092265744382080, 226062623, 226062633, 10, 1440x900 
0x37CA2318, 38092265745036152, 226062688, 226062698, 10, 1440x900 
0x37CA2318, 38092265745695848, 226062757, 226062765, 8, 1440x900 
0x37CA2318, 38092265746355880, 226062823, 226062830, 7, 1440x900 
0x37CA2318, 38092265747016160, 226062887, 226062895, 8, 1440x900 
0x37CA2318, 38092265747686000, 226062953, 226062961, 8, 1440x900 
0x37CA2318, 38092265748354056, 226063023, 226063033, 10, 1440x900 
0x37CA2318, 38092265749015088, 226063093, 226063102, 9, 1440x900 
0x37CA2318, 38092265749681328, 226063158, 226063171, 13, 1440x900 
0x37CA2318, 38092265750345384, 226063223, 226063233, 10, 1440x900 
0x37CA2318, 38092265751660744, 226063358, 226063367, 9, 1440x900 
0x37CA2318, 38092265752319224, 226063418, 226063426, 8, 1440x900 
0x37CA2318, 38092265752976776, 226063482, 226063491, 9, 1440x900 
0x37CA2318, 38092265753636032, 226063548, 226063556, 8, 1440x900 
0x37CA2318, 38092265754296208, 226063613, 226063622, 9, 1440x900 
0x37CA2318, 38092265754969368, 226063687, 226063695, 8, 1440x900 
0x37CA2318, 38092265755635744, 226063751, 226063759, 8, 1440x900 
0x37CA2318, 38092265756281168, 226063813, 226063821, 8, 1440x900 
0x37CA2318, 38092265756946264, 226063888, 226063897, 9, 1440x900 
0x37CA2318, 38092265757608856, 226063953, 226063960, 7, 1440x900 
0x37CA2318, 38092265758262176, 226064013, 226064022, 9, 1440x900 
0x37CA2318, 38092265758935840, 226064082, 226064091, 9, 1440x900 
0x37CA2318, 38092265759584176, 226064146, 226064155, 9, 1440x900 
0x37CA2318, 38092265760239040, 226064208, 226064218, 10, 1440x900 
0x37CA2318, 38092265760909232, 226064277, 226064287, 10, 1440x900 
0x37CA2318, 38092265761563016, 226064342, 226064353, 11, 1440x900 
0x37CA2318, 38092265762231808, 226064412, 226064420, 8, 1440x900 
0x37CA2318, 38092265762892384, 226064480, 226064490, 10, 1440x900 
0x37CA2318, 38092265763548040, 226064543, 226064552, 9, 1440x900 
0x37CA2318, 38092265764209552, 226064607, 226064615, 8, 1440x900 
0x37CA2318, 38092265764866320, 226064672, 226064680, 8, 1440x900 
0x37CA2318, 38092265765562320, 226064742, 226064750, 8, 1440x900 
0x37CA2318, 38092265766188808, 226064808, 226064816, 8, 1440x900 
0x37CA2318, 38092265766852520, 226064872, 226064881, 9, 1440x900 
0x37CA2318, 38092265767511368, 226064938, 226064946, 8, 1440x900 
0x37CA2318, 38092265768172552, 226065008, 226065017, 9, 1440x900 
0x37CA2318, 38092265768827800, 226065068, 226065075, 7, 1440x900 
0x37CA2318, 38092265769488176, 226065133, 226065143, 10, 1440x900 
0x37CA2318, 38092265770166632, 226065208, 226065217, 9, 1440x900 
0x37CA2318, 38092265770806912, 226065272, 226065280, 8, 1440x900 
0x37CA2318, 38092265771477248, 226065333, 226065341, 8, 1440x900 
0x37CA2318, 38092265772125760, 226065397, 226065405, 8, 1440x900 
0x37CA2318, 38092265772787240, 226065467, 226065475, 8, 1440x900 
0x37CA2318, 38092265773455448, 226065533, 226065541, 8, 1440x900 
0x37CA2318, 38092265774110264, 226065597, 226065605, 8, 1440x900 
0x37CA2318, 38092265774769472, 226065663, 226065672, 9, 1440x900 
0x37CA2318, 38092265775453328, 226065732, 226065740, 8, 1440x900 
0x37CA2318, 38092265776094520, 226065798, 226065807, 9, 1440x900 
0x37CA2318, 38092265776753952, 226065862, 226065869, 7, 1440x900 
0x37CA2318, 38092265777406792, 226065927, 226065935, 8, 1440x900 
0x37CA2318, 38092265778078344, 226066000, 226066009, 9, 1440x900 
0x37CA2318, 38092265778731048, 226066058, 226066068, 10, 1440x900 
0x37CA2318, 38092265779395616, 226066127, 226066136, 9, 1440x900 
0x37CA2318, 38092265780055424, 226066192, 226066202, 10, 1440x900 
0x37CA2318, 38092265780714896, 226066257, 226066267, 10, 1440x900 
0x37CA2318, 38092265781375200, 226066323, 226066333, 10, 1440x900 
0x37CA2318, 38092265782039536, 226066388, 226066397, 9, 1440x900 
0x37CA2318, 38092265782693768, 226066456, 226066464, 8, 1440x900 
0x37CA2318, 38092265783353880, 226066521, 226066529, 8, 1440x900 
0x37CA2318, 38092265784013584, 226066587, 226066595, 8, 1440x900 
0x37CA2318, 38092265784673440, 226066653, 226066661, 8, 1440x900 
0x37CA2318, 38092265785333872, 226066718, 226066726, 8, 1440x900 
0x37CA2318, 38092265786002072, 226066787, 226066797, 10, 1440x900 
0x37CA2318, 38092265786659832, 226066852, 226066860, 8, 1440x900 
0x37CA2318, 38092265787326160, 226066918, 226066926, 8, 1440x900 
0x37CA2318, 38092265787975440, 226066986, 226066994, 8, 1440x900 
0x37CA2318, 38092265788635216, 226067048, 226067056, 8, 1440x900 
0x37CA2318, 38092265789309080, 226067116, 226067128, 12, 1440x900 
0x37CA2318, 38092265790126368, 226067208, 226067223, 15, 1440x900 
0x37CA2318, 38092265790766816, 226067263, 226067270, 7, 1440x900 
0x37CA2318, 38092265791292656, 226067317, 226067324, 7, 1440x900 
0x37CA2318, 38092265791950336, 226067379, 226067389, 10, 1440x900 
0x37CA2318, 38092265792620712, 226067448, 226067456, 8, 1440x900 
0x37CA2318, 38092265793280272, 226067513, 226067522, 9, 1440x900 
0x37CA2318, 38092265793940952, 226067581, 226067588, 7, 1440x900 
0x37CA2318, 38092265794603856, 226067647, 226067654, 7, 1440x900 
0x37CA2318, 38092265795263968, 226067712, 226067721, 9, 1440x900 
0x37CA2318, 38092265795922728, 226067777, 226067785, 8, 1440x900 
0x37CA2318, 38092265796583904, 226067843, 226067852, 9, 1440x900 
0x37CA2318, 38092265797243512, 226067912, 226067920, 8, 1440x900 
0x37CA2318, 38092265797905904, 226067977, 226067985, 8, 1440x900 
0x37CA2318, 38092265798567760, 226068042, 226068051, 9, 1440x900 
0x37CA2318, 38092265799233400, 226068113, 226068120, 7, 1440x900 
0x37CA2318, 38092265799891744, 226068178, 226068186, 8, 1440x900 
0x37CA2318, 38092265800554144, 226068243, 226068252, 9, 1440x900 
0x37CA2318, 38092265801213272, 226068308, 226068318, 10, 1440x900 
0x37CA2318, 38092265801897080, 226068377, 226068384, 7, 1440x900 
0x37CA2318, 38092265802560696, 226068442, 226068450, 8, 1440x900 
0x37CA2318, 38092265803189824, 226068503, 226068511, 8, 1440x900 
0x37CA2318, 38092265804045128, 226068592, 226068600, 8, 1440x900 
0x37CA2318, 38092265804516808, 226068638, 226068647, 9, 1440x900 
0x37CA2318, 38092265805408640, 226068738, 226068746, 8, 1440x900 
0x37CA2318, 38092265805875176, 226068773, 226068780, 7, 1440x900 
0x37CA2318, 38092265806499752, 226068837, 226068844, 7, 1440x900 
0x37CA2318, 38092265807167904, 226068907, 226068914, 7, 1440x900 
0x37CA2318, 38092265807828104, 226068968, 226068976, 8, 1440x900 
0x37CA2318, 38092265808491056, 226069037, 226069045, 8, 1440x900 
0x37CA2318, 38092265809158528, 226069107, 226069115, 8, 1440x900 
0x37CA2318, 38092265809820808, 226069174, 226069182, 8, 1440x900 
0x37CA2318, 38092265810468320, 226069234, 226069242, 8, 1440x900 
0x37CA2318, 38092265811150992, 226069302, 226069309, 7, 1440x900 
0x37CA2318, 38092265811776240, 226069363, 226069370, 7, 1440x900 
0x37CA2318, 38092265812436888, 226069427, 226069435, 8, 1440x900 
0x37CA2318, 38092265813296072, 226069513, 226069550, 37, 1440x900 
0x37CA2318, 38092265813944576, 226069586, 226069604, 18, 1440x900 
0x37CA2318, 38092265814491512, 226069632, 226069642, 10, 1440x900 
0x37CA2318, 38092265815108696, 226069697, 226069715, 18, 1440x900 
0x37CA2318, 38092265815929752, 226069778, 226069786, 8, 1440x900 
0x37CA2318, 38092265816402528, 226069827, 226069835, 8, 1440x900 
0x37CA2318, 38092265817268736, 226069912, 226069919, 7, 1440x900 
0x37CA2318, 38092265817816536, 226069968, 226069978, 10, 1440x900 
0x37CA2318, 38092265818516912, 226070043, 226070051, 8, 1440x900 
0x37CA2318, 38092265819086752, 226070094, 226070101, 7, 1440x900 
0x37CA2318, 38092265819911344, 226070177, 226070185, 8, 1440x900 
0x37CA2318, 38092265820590496, 226070246, 226070253, 7, 1440x900 
0x37CA2318, 38092265821160848, 226070302, 226070312, 10, 1440x900 
0x37CA2318, 38092265821921432, 226070377, 226070387, 10, 1440x900 
0x37CA2318, 38092265822388208, 226070422, 226070431, 9, 1440x900 
0x37CA2318, 38092265823242000, 226070508, 226070516, 8, 1440x900 
0x37CA2318, 38092265823894664, 226070577, 226070585, 8, 1440x900 
0x37CA2318, 38092265824547448, 226070641, 226070649, 8, 1440x900 
0x37CA2318, 38092265825213160, 226070713, 226070720, 7, 1440x900 
0x37CA2318, 38092265825883032, 226070778, 226070786, 8, 1440x900 
0x37CA2318, 38092265826526920, 226070838, 226070847, 9, 1440x900 
0x37CA2318, 38092265827197472, 226070908, 226070916, 8, 1440x900 
0x37CA2318, 38092265827855848, 226070977, 226070985, 8, 1440x900 
0x37CA2318, 38092265828507408, 226071043, 226071051, 8, 1440x900 
0x37CA2318, 38092265829171672, 226071109, 226071121, 12, 1440x900 
0x37CA2318, 38092265829685472, 226071158, 226071166, 8, 1440x900 
0x37CA2318, 38092265830500112, 226071237, 226071246, 9, 1440x900 
0x37CA2318, 38092265831820912, 226071373, 226071381, 8, 1440x900 
0x37CA2318, 38092265832482936, 226071437, 226071445, 8, 1440x900 
0x37CA2318, 38092265833152456, 226071502, 226071510, 8, 1440x900 
0x37CA2318, 38092265833803184, 226071568, 226071576, 8, 1440x900 
0x37CA2318, 38092265834468720, 226071638, 226071647, 9, 1440x900 
0x37CA2318, 38092265835138088, 226071702, 226071709, 7, 1440x900 
0x37CA2318, 38092265836016432, 226071787, 226071794, 7, 1440x900 
0x37CA2318, 38092265836286616, 226071816, 226071824, 8, 1440x900 
0x37CA2318, 38092265836945096, 226071887, 226071903, 16, 1440x900 
0x37CA2318, 38092265837690608, 226071954, 226071965, 11, 1440x900 
0x37CA2318, 38092265838297376, 226072017, 226072042, 25, 1440x900 
0x37CA2318, 38092265839064544, 226072093, 226072119, 26, 1440x900 
0x37CA2318, 38092265839589800, 226072149, 226072170, 21, 1440x900 
0x37CA2318, 38092265840335688, 226072218, 226072241, 23, 1440x900 
0x37CA2318, 38092265840907264, 226072278, 226072302, 24, 1440x900 
0x37CA2318, 38092265841723496, 226072365, 226072375, 10, 1440x900 
0x37CA2318, 38092265842286992, 226072423, 226072431, 8, 1440x900 
0x37CA2318, 38092265842971320, 226072483, 226072493, 10, 1440x900 
0x37CA2318, 38092265843555288, 226072540, 226072567, 27, 1440x900 
0x37CA2318, 38092265844357720, 226072639, 226072648, 9, 1440x900 
0x37CA2318, 38092265844888536, 226072680, 226072703, 23, 1440x900 
0x37CA2318, 38092265845667528, 226072753, 226072803, 50, 1440x900 
0x37CA2318, 38092265846279256, 226072824, 226072842, 18, 1440x900 
0x37CA2318, 38092265846846152, 226072868, 226072876, 8, 1440x900 
0x37CA2318, 38092265847569888, 226072943, 226072950, 7, 1440x900 
0x37CA2318, 38092265848174488, 226073010, 226073028, 18, 1440x900 
0x37CA2318, 38092265848930296, 226073078, 226073088, 10, 1440x900 
0x37CA2318, 38092265849548088, 226073149, 226073160, 11, 1440x900 
0x37CA2318, 38092265850207544, 226073212, 226073229, 17, 1440x900 
0x37CA2318, 38092265850958912, 226073283, 226073309, 26, 1440x900 
0x37CA2318, 38092265851507768, 226073334, 226073345, 11, 1440x900 
0x37CA2318, 38092265852279424, 226073413, 226073422, 9, 1440x900 
0x37CA2318, 38092265852846128, 226073480, 226073492, 12, 1440x900 
0x37CA2318, 38092265853551368, 226073546, 226073574, 28, 1440x900 
0x37CA2318, 38092265854168576, 226073610, 226073628, 18, 1440x900 
0x37CA2318, 38092265854926544, 226073684, 226073694, 10, 1440x900 
0x37CA2318, 38092265855574456, 226073743, 226073752, 9, 1440x900 
0x37CA2318, 38092265856123768, 226073799, 226073823, 24, 1440x900 
0x37CA2318, 38092265856878688, 226073873, 226073897, 24, 1440x900 
0x37CA2318, 38092265857479248, 226073941, 226073951, 10, 1440x900 
0x37CA2318, 38092265858183888, 226074010, 226074026, 16, 1440x900 
0x37CA2318, 38092265858897064, 226074078, 226074085, 7, 1440x900 
0x37CA2318, 38092265859444976, 226074132, 226074139, 7, 1440x900 
0x37CA2318, 38092265860068616, 226074192, 226074204, 12, 1440x900 
0x37CA2318, 38092265860730912, 226074258, 226074266, 8, 1440x900 
0x37CA2318, 38092265861409208, 226074327, 226074334, 7, 1440x900 
0x37CA2318, 38092265862238904, 226074408, 226074416, 8, 1440x900 
0x37CA2318, 38092265862890024, 226074473, 226074480, 7, 1440x900 
0x37CA2318, 38092265863561640, 226074542, 226074548, 6, 1440x900 
0x37CA2318, 38092265864221392, 226074608, 226074615, 7, 1440x900 
0x37CA2318, 38092265864882096, 226074673, 226074680, 7, 1440x900 
0x37CA2318, 38092265865551728, 226074741, 226074748, 7, 1440x900 
0x37CA2318, 38092265866202960, 226074806, 226074813, 7, 1440x900 
0x37CA2318, 38092265866871712, 226074873, 226074879, 6, 1440x900 
0x37CA2318, 38092265867516576, 226074937, 226074944, 7, 1440x900 
0x37CA2318, 38092265868188856, 226075006, 226075013, 7, 1440x900 
0x37CA2318, 38092265868852888, 226075072, 226075080, 8, 1440x900 
0x37CA2318, 38092265870175528, 226075207, 226075215, 8, 1440x900 
0x37CA2318, 38092265870835896, 226075273, 226075281, 8, 1440x900 
0x37CA2318, 38092265871505848, 226075338, 226075346, 8, 1440x900 
0x37CA2318, 38092265872157160, 226075408, 226075415, 7, 1440x900 
0x37CA2318, 38092265872819088, 226075473, 226075481, 8, 1440x900 
0x37CA2318, 38092265873478208, 226075538, 226075546, 8, 1440x900 
0x37CA2318, 38092265874140048, 226075604, 226075612, 8, 1440x900 
0x37CA2318, 38092265874800320, 226075667, 226075675, 8, 1440x900 
0x37CA2318, 38092265875460112, 226075738, 226075746, 8, 1440x900 
0x37CA2318, 38092265876120624, 226075803, 226075811, 8, 1440x900 
0x37CA2318, 38092265876789336, 226075869, 226075877, 8, 1440x900 
0x37CA2318, 38092265877248392, 226075913, 226075920, 7, 1440x900 
0x37CA2318, 38092265878109024, 226075997, 226076004, 7, 1440x900 
0x37CA2318, 38092265878775128, 226076062, 226076071, 9, 1440x900 
0x37CA2318, 38092265879442280, 226076127, 226076135, 8, 1440x900 
0x37CA2318, 38092265880100344, 226076197, 226076204, 7, 1440x900 
0x37CA2318, 38092265880759128, 226076263, 226076271, 8, 1440x900 
0x37CA2318, 38092265881423840, 226076333, 226076341, 8, 1440x900 
0x37CA2318, 38092265882093824, 226076402, 226076411, 9, 1440x900 
0x37CA2318, 38092265882740696, 226076463, 226076471, 8, 1440x900 
0x37CA2318, 38092265883411976, 226076527, 226076536, 9, 1440x900 
0x37CA2318, 38092265884064840, 226076599, 226076607, 8, 1440x900 
0x37CA2318, 38092265884725264, 226076658, 226076667, 9, 1440x900 
0x37CA2318, 38092265885194192, 226076708, 226076715, 7, 1440x900 
0x37CA2318, 38092265886044704, 226076793, 226076801, 8, 1440x900 
0x37CA2318, 38092265886704352, 226076863, 226076872, 9, 1440x900 
0x37CA2318, 38092265887368808, 226076923, 226076930, 7, 1440x900 
0x37CA2318, 38092265888036720, 226076993, 226077001, 8, 1440x900 
0x37CA2318, 38092265888706360, 226077059, 226077067, 8, 1440x900 
0x37CA2318, 38092265889357440, 226077123, 226077131, 8, 1440x900 
0x37CA2318, 38092265890027472, 226077193, 226077201, 8, 1440x900 
0x37CA2318, 38092265890679640, 226077257, 226077265, 8, 1440x900 
0x37CA2318, 38092265891330464, 226077323, 226077331, 8, 1440x900 
0x37CA2318, 38092265891991632, 226077388, 226077396, 8, 1440x900 
0x37CA2318, 38092265892668712, 226077458, 226077466, 8, 1440x900 
0x37CA2318, 38092265893131552, 226077503, 226077511, 8, 1440x900 
0x37CA2318, 38092265893981680, 226077588, 226077597, 9, 1440x900 
0x37CA2318, 38092265894646928, 226077657, 226077666, 9, 1440x900 
0x37CA2318, 38092265895307848, 226077717, 226077725, 8, 1440x900 
0x37CA2318, 38092265895965472, 226077783, 226077790, 7, 1440x900 
0x37CA2318, 38092265896619656, 226077848, 226077856, 8, 1440x900 
0x37CA2318, 38092265897282320, 226077918, 226077926, 8, 1440x900 
0x37CA2318, 38092265897951848, 226077982, 226077990, 8, 1440x900 
0x37CA2318, 38092265898595536, 226078047, 226078056, 9, 1440x900 
0x37CA2318, 38092265899272376, 226078118, 226078126, 8, 1440x900 
0x37CA2318, 38092265899933792, 226078183, 226078191, 8, 1440x900 
0x37CA2318, 38092265900586776, 226078248, 226078256, 8, 1440x900 
0x37CA2318, 38092265901121344, 226078303, 226078311, 8, 1440x900 
0x37CA2318, 38092265901907120, 226078378, 226078387, 9, 1440x900 
0x37CA2318, 38092265902568368, 226078443, 226078452, 9, 1440x900 
0x37CA2318, 38092265903229376, 226078513, 226078521, 8, 1440x900 
0x37CA2318, 38092265903890944, 226078577, 226078585, 8, 1440x900 
0x37CA2318, 38092265904544904, 226078643, 226078651, 8, 1440x900 
0x37CA2318, 38092265905215328, 226078712, 226078720, 8, 1440x900 
0x37CA2318, 38092265905874464, 226078777, 226078785, 8, 1440x900 
0x37CA2318, 38092265906536320, 226078842, 226078851, 9, 1440x900 
0x37CA2318, 38092265907205960, 226078908, 226078917, 9, 1440x900 
0x37CA2318, 38092265907857376, 226078973, 226078982, 9, 1440x900 
0x37CA2318, 38092265908526224, 226079042, 226079050, 8, 1440x900 
0x37CA2318, 38092265909117720, 226079097, 226079105, 8, 1440x900 
0x37CA2318, 38092265909854184, 226079178, 226079186, 8, 1440x900 
0x37CA2318, 38092265910507224, 226079243, 226079251, 8, 1440x900 
0x37CA2318, 38092265911170656, 226079307, 226079315, 8, 1440x900 
0x37CA2318, 38092265911822832, 226079373, 226079381, 8, 1440x900 
0x37CA2318, 38092265912492848, 226079438, 226079446, 8, 1440x900 
0x37CA2318, 38092265913155760, 226079502, 226079511, 9, 1440x900 
0x37CA2318, 38092265913810752, 226079572, 226079580, 8, 1440x900 
0x37CA2318, 38092265914472928, 226079638, 226079646, 8, 1440x900 
0x37CA2318, 38092265915141696, 226079703, 226079711, 8, 1440x900 
0x37CA2318, 38092265915810712, 226079767, 226079774, 7, 1440x900 
0x37CA2318, 38092265916268416, 226079812, 226079819, 7, 1440x900 
0x37CA2318, 38092265917117224, 226079898, 226079905, 7, 1440x900 
0x37CA2318, 38092265917789632, 226079966, 226079973, 7, 1440x900 
0x37CA2318, 38092265918450328, 226080032, 226080039, 7, 1440x900 
0x37CA2318, 38092265919110168, 226080102, 226080110, 8, 1440x900 
0x37CA2318, 38092265919771768, 226080168, 226080176, 8, 1440x900 
0x37CA2318, 38092265920435944, 226080233, 226080241, 8, 1440x900 
0x37CA2318, 38092265921104760, 226080303, 226080311, 8, 1440x900 
0x37CA2318, 38092265921767432, 226080368, 226080376, 8, 1440x900 
0x37CA2318, 38092265922437152, 226080432, 226080440, 8, 1440x900 
0x37CA2318, 38092265923098592, 226080502, 226080511, 9, 1440x900 
0x37CA2318, 38092265923748336, 226080563, 226080571, 8, 1440x900 
0x37CA2318, 38092265924407840, 226080632, 226080640, 8, 1440x900 
0x37CA2318, 38092265925068112, 226080693, 226080703, 10, 1440x900 
0x37CA2318, 38092265925534552, 226080742, 226080750, 8, 1440x900 
0x37CA2318, 38092265926194480, 226080807, 226080814, 7, 1440x900 
0x37CA2318, 38092265927055656, 226080892, 226080899, 7, 1440x900 
0x37CA2318, 38092265927715776, 226080957, 226080964, 7, 1440x900 
0x37CA2318, 38092265928377296, 226081023, 226081031, 8, 1440x900 
0x37CA2318, 38092265929038008, 226081092, 226081100, 8, 1440x900 
0x37CA2318, 38092265929699936, 226081157, 226081166, 9, 1440x900 
0x37CA2318, 38092265930369608, 226081228, 226081236, 8, 1440x900 
0x37CA2318, 38092265931020632, 226081289, 226081298, 9, 1440x900 
0x37CA2318, 38092265931681456, 226081357, 226081365, 8, 1440x900 
0x37CA2318, 38092265932339248, 226081423, 226081431, 8, 1440x900 
0x37CA2318, 38092265932999408, 226081487, 226081496, 9, 1440x900 
0x37CA2318, 38092265934328408, 226081622, 226081630, 8, 1440x900 
0x37CA2318, 38092265934998784, 226081687, 226081694, 7, 1440x900 
0x37CA2318, 38092265935649368, 226081748, 226081756, 8, 1440x900 
0x37CA2318, 38092265936309904, 226081817, 226081825, 8, 1440x900 
0x37CA2318, 38092265936960792, 226081887, 226081895, 8, 1440x900 
0x37CA2318, 38092265937630816, 226081952, 226081960, 8, 1440x900 
0x37CA2318, 38092265938291672, 226082017, 226082025, 8, 1440x900 
0x37CA2318, 38092265938960696, 226082083, 226082092, 9, 1440x900 
0x37CA2318, 38092265939618968, 226082147, 226082155, 8, 1440x900 
0x37CA2318, 38092265940280032, 226082217, 226082225, 8, 1440x900 
0x37CA2318, 38092265940941264, 226082283, 226082292, 9, 1440x900 
0x37CA2318, 38092265941397128, 226082327, 226082334, 7, 1440x900 
0x37CA2318, 38092265942253520, 226082413, 226082420, 7, 1440x900 
0x37CA2318, 38092265942720328, 226082457, 226082465, 8, 1440x900 
0x37CA2318, 38092265943579840, 226082543, 226082551, 8, 1440x900 
0x37CA2318, 38092265944230600, 226082608, 226082616, 8, 1440x900 
0x37CA2318, 38092265944893856, 226082673, 226082682, 9, 1440x900 
0x37CA2318, 38092265945555344, 226082742, 226082749, 7, 1440x900 
0x37CA2318, 38092265946210488, 226082807, 226082814, 7, 1440x900 
0x37CA2318, 38092265946885664, 226082876, 226082884, 8, 1440x900 
0x37CA2318, 38092265947529512, 226082938, 226082946, 8, 1440x900 
0x37CA2318, 38092265948198832, 226083007, 226083015, 8, 1440x900 
0x37CA2318, 38092265948857768, 226083073, 226083081, 8, 1440x900 
0x37CA2318, 38092265949386952, 226083128, 226083136, 8, 1440x900 
0x37CA2318, 38092265950240208, 226083212, 226083221, 9, 1440x900 
0x37CA2318, 38092265950892192, 226083274, 226083282, 8, 1440x900 
0x37CA2318, 38092265951562232, 226083342, 226083351, 9, 1440x900 
0x37CA2318, 38092265952213968, 226083413, 226083421, 8, 1440x900 
0x37CA2318, 38092265952874512, 226083477, 226083485, 8, 1440x900 
0x37CA2318, 38092265953543184, 226083543, 226083551, 8, 1440x900 
0x37CA2318, 38092265954203648, 226083608, 226083617, 9, 1440x900 
0x37CA2318, 38092265954848376, 226083678, 226083687, 9, 1440x900 
0x37CA2318, 38092265955519056, 226083742, 226083750, 8, 1440x900 
0x37CA2318, 38092265956179480, 226083808, 226083816, 8, 1440x900 
0x37CA2318, 38092265956840552, 226083873, 226083881, 8, 1440x900 
0x37CA2318, 38092265957307184, 226083918, 226083927, 9, 1440x900 
0x37CA2318, 38092265957969704, 226083988, 226083996, 8, 1440x900 
0x37CA2318, 38092265958633120, 226084053, 226084062, 9, 1440x900 
0x37CA2318, 38092265959292976, 226084114, 226084122, 8, 1440x900 
0x37CA2318, 38092265959999208, 226084183, 226084192, 9, 1440x900 
0x37CA2318, 38092265960682096, 226084252, 226084259, 7, 1440x900 
0x37CA2318, 38092265961311600, 226084318, 226084325, 7, 1440x900 
0x37CA2318, 38092265961925616, 226084378, 226084385, 7, 1440x900 
0x37CA2318, 38092265962585648, 226084443, 226084451, 8, 1440x900 
0x37CA2318, 38092265963245720, 226084512, 226084519, 7, 1440x900 
0x37CA2318, 38092265964101520, 226084599, 226084607, 8, 1440x900 
0x37CA2318, 38092265964574208, 226084648, 226084656, 8, 1440x900 
0x37CA2318, 38092265965240264, 226084712, 226084720, 8, 1440x900 
0x37CA2318, 38092265966089800, 226084798, 226084807, 9, 1440x900 
0x37CA2318, 38092265966749160, 226084869, 226084877, 8, 1440x900 
0x37CA2318, 38092265967409832, 226084927, 226084934, 7, 1440x900 
0x37CA2318, 38092265968072488, 226084998, 226085006, 8, 1440x900 
0x37CA2318, 38092265968732096, 226085063, 226085071, 8, 1440x900 
0x37CA2318, 38092265969394096, 226085128, 226085138, 10, 1440x900 
0x37CA2318, 38092265970062464, 226085198, 226085206, 8, 1440x900 
0x37CA2318, 38092265970719056, 226085263, 226085271, 8, 1440x900 
0x37CA2318, 38092265971387440, 226085326, 226085351, 25, 1440x900 
0x37CA2318, 38092265972193968, 226085407, 226085421, 14, 1440x900 
0x37CA2318, 38092265972546904, 226085439, 226085454, 15, 1440x900 
0x37CA2318, 38092265973210336, 226085504, 226085518, 14, 1440x900 
0x37CA2318, 38092265973983176, 226085600, 226085636, 36, 1440x900 
0x37CA2318, 38092265980319784, 226086221, 226086240, 19, 1440x900 
0x37CA2318, 38092265980853576, 226086280, 226086295, 15, 1440x900 
0x37CA2318, 38092265981589960, 226086348, 226086368, 20, 1440x900 
0x37CA2318, 38092265982353032, 226086422, 226086429, 7, 1440x900 
0x37CA2318, 38092265983000296, 226086487, 226086493, 6, 1440x900 
0x37CA2318, 38092265983462968, 226086532, 226086538, 6, 1440x900 
0x37CA2318, 38092265984124160, 226086598, 226086606, 8, 1440x900 
0x37CA2318, 38092265984784136, 226086668, 226086675, 7, 1440x900 
0x37CA2318, 38092265985444616, 226086733, 226086740, 7, 1440x900 
0x37CA2318, 38092265986104336, 226086799, 226086806, 7, 1440x900 
0x37CA2318, 38092265986780544, 226086875, 226086883, 8, 1440x900 
0x37CA2318, 38092265987428336, 226086928, 226086935, 7, 1440x900 
0x37CA2318, 38092265988085800, 226086998, 226087006, 8, 1440x900 
0x37CA2318, 38092265988933808, 226087082, 226087090, 8, 1440x900 
0x37CA2318, 38092265989604704, 226087147, 226087156, 9, 1440x900 
0x37CA2318, 38092265990266304, 226087213, 226087220, 7, 1440x900 
0x37CA2318, 38092265990925120, 226087278, 226087286, 8, 1440x900 
0x37CA2318, 38092265991511264, 226087338, 226087344, 6, 1440x900 
0x37CA2318, 38092265992048960, 226087392, 226087400, 8, 1440x900 
0x37CA2318, 38092265992713936, 226087458, 226087465, 7, 1440x900 
0x37CA2318, 38092265993393920, 226087541, 226087548, 7, 1440x900 
0x37CA2318, 38092265994035520, 226087592, 226087599, 7, 1440x900 
0x37CA2318, 38092265994890736, 226087673, 226087680, 7, 1440x900 
0x37CA2318, 38092265995551664, 226087738, 226087746, 8, 1440x900 
0x37CA2318, 38092265996219392, 226087807, 226087815, 8, 1440x900 
0x37CA2318, 38092265996885032, 226087877, 226087884, 7, 1440x900 
0x37CA2318, 38092265997546048, 226087943, 226087951, 8, 1440x900 
0x37CA2318, 38092265998074392, 226087998, 226088006, 8, 1440x900 
0x37CA2318, 38092265998681904, 226088058, 226088067, 9, 1440x900 
0x37CA2318, 38092265999344976, 226088124, 226088133, 9, 1440x900 
0x37CA2318, 38092265999999232, 226088187, 226088194, 7, 1440x900 
0x37CA2318, 38092266000659616, 226088253, 226088261, 8, 1440x900 
0x37CA2318, 38092266001320344, 226088319, 226088326, 7, 1440x900 
0x37CA2318, 38092266001991448, 226088388, 226088395, 7, 1440x900 
0x37CA2318, 38092266002650752, 226088452, 226088458, 6, 1440x900 
0x37CA2318, 38092266003320488, 226088522, 226088530, 8, 1440x900 
0x37CA2318, 38092266003979160, 226088587, 226088595, 8, 1440x900 
0x37CA2318, 38092266004639840, 226088652, 226088660, 8, 1440x900 
0x37CA2318, 38092266005299920, 226088718, 226088726, 8, 1440x900 
0x37CA2318, 38092266005959944, 226088783, 226088792, 9, 1440x900 
0x37CA2318, 38092266006620408, 226088853, 226088861, 8, 1440x900 
0x37CA2318, 38092266007289864, 226088918, 226088926, 8, 1440x900 
0x37CA2318, 38092266007936864, 226088982, 226088989, 7, 1440x900 
0x37CA2318, 38092266008598688, 226089047, 226089055, 8, 1440x900 
0x37CA2318, 38092266009259472, 226089112, 226089119, 7, 1440x900 
0x37CA2318, 38092266010113096, 226089197, 226089206, 9, 1440x900 
0x37CA2318, 38092266010780720, 226089268, 226089276, 8, 1440x900 
0x37CA2318, 38092266011450728, 226089333, 226089341, 8, 1440x900 
0x37CA2318, 38092266012107904, 226089398, 226089406, 8, 1440x900 
0x37CA2318, 38092266012758384, 226089466, 226089474, 8, 1440x900 
0x37CA2318, 38092266013422384, 226089533, 226089541, 8, 1440x900 
0x37CA2318, 38092266014085160, 226089597, 226089605, 8, 1440x900 
0x37CA2318, 38092266014747912, 226089667, 226089675, 8, 1440x900 
0x37CA2318, 38092266015416632, 226089733, 226089741, 8, 1440x900 
0x37CA2318, 38092266016068408, 226089798, 226089806, 8, 1440x900 
0x37CA2318, 38092266016738224, 226089863, 226089871, 8, 1440x900 
0x37CA2318, 38092266017408864, 226089929, 226089937, 8, 1440x900 
0x37CA2318, 38092266017863232, 226089972, 226089980, 8, 1440x900 
0x37CA2318, 38092266018525120, 226090042, 226090050, 8, 1440x900 
0x37CA2318, 38092266019186840, 226090108, 226090116, 8, 1440x900 
0x37CA2318, 38092266019854048, 226090174, 226090183, 9, 1440x900 
0x37CA2318, 38092266020510224, 226090237, 226090244, 7, 1440x900 
0x37CA2318, 38092266021170320, 226090303, 226090310, 7, 1440x900 
0x37CA2318, 38092266021840024, 226090372, 226090380, 8, 1440x900 
0x37CA2318, 38092266022499416, 226090437, 226090444, 7, 1440x900 
0x37CA2318, 38092266023163248, 226090508, 226090516, 8, 1440x900 
0x37CA2318, 38092266023823608, 226090573, 226090581, 8, 1440x900 
0x37CA2318, 38092266024483168, 226090635, 226090644, 9, 1440x900 
0x37CA2318, 38092266025506744, 226090738, 226090773, 35, 1440x900 
0x37CA2318, 38092266025996936, 226090786, 226090797, 11, 1440x900 
0x37CA2318, 38092266026608568, 226090848, 226090855, 7, 1440x900 
0x37CA2318, 38092266027690408, 226090955, 226091003, 48, 1440x900 
0x37CA2318, 38092266028296640, 226091013, 226091026, 13, 1440x900 
0x37CA2318, 38092266028657920, 226091059, 226091070, 11, 1440x900 
0x37CA2318, 38092266029444248, 226091131, 226091156, 25, 1440x900 
0x37CA2318, 38092266030114968, 226091206, 226091216, 10, 1440x900 
0x37CA2318, 38092266030659976, 226091257, 226091266, 9, 1440x900 
0x37CA2318, 38092266031439912, 226091337, 226091347, 10, 1440x900 
0x37CA2318, 38092266032071392, 226091398, 226091418, 20, 1440x900 
0x37CA2318, 38092266032734496, 226091462, 226091482, 20, 1440x900 
0x37CA2318, 38092266033291632, 226091516, 226091522, 6, 1440x900 
0x37CA2318, 38092266034128864, 226091601, 226091608, 7, 1440x900 
0x37CA2318, 38092266034790624, 226091667, 226091674, 7, 1440x900 
0x37CA2318, 38092266035443056, 226091732, 226091739, 7, 1440x900 
0x37CA2318, 38092266036104624, 226091797, 226091805, 8, 1440x900 
0x37CA2318, 38092266036769296, 226091867, 226091874, 7, 1440x900 
0x37CA2318, 38092266037430104, 226091933, 226091941, 8, 1440x900 
0x37CA2318, 38092266038091616, 226091998, 226092006, 8, 1440x900 
0x37CA2318, 38092266038752968, 226092062, 226092069, 7, 1440x900 
0x37CA2318, 38092266039403760, 226092128, 226092135, 7, 1440x900 
0x37CA2318, 38092266040066480, 226092197, 226092205, 8, 1440x900 
0x37CA2318, 38092266040718616, 226092263, 226092271, 8, 1440x900 
0x37CA2318, 38092266041390080, 226092328, 226092337, 9, 1440x900 
0x37CA2318, 38092266042055744, 226092397, 226092405, 8, 1440x900 
0x37CA2318, 38092266042724752, 226092462, 226092469, 7, 1440x900 
0x37CA2318, 38092266043386016, 226092528, 226092535, 7, 1440x900 
0x37CA2318, 38092266044046632, 226092593, 226092600, 7, 1440x900 
0x37CA2318, 38092266044697648, 226092658, 226092666, 8, 1440x900 
0x37CA2318, 38092266045366336, 226092723, 226092730, 7, 1440x900 
0x37CA2318, 38092266046028392, 226092793, 226092801, 8, 1440x900 
0x37CA2318, 38092266046679096, 226092858, 226092866, 8, 1440x900 
0x37CA2318, 38092266047348672, 226092922, 226092931, 9, 1440x900 
0x37CA2318, 38092266048000352, 226092987, 226092995, 8, 1440x900 
0x37CA2318, 38092266048670456, 226093053, 226093061, 8, 1440x900 
0x37CA2318, 38092266049329232, 226093118, 226093126, 8, 1440x900 
0x37CA2318, 38092266049990160, 226093187, 226093195, 8, 1440x900 
0x37CA2318, 38092266050650376, 226093252, 226093260, 8, 1440x900 
0x37CA2318, 38092266051311176, 226093317, 226093325, 8, 1440x900 
0x37CA2318, 38092266051981000, 226093388, 226093396, 8, 1440x900 
0x37CA2318, 38092266052630560, 226093452, 226093460, 8, 1440x900 
0x37CA2318, 38092266053293472, 226093518, 226093527, 9, 1440x900 
0x37CA2318, 38092266053955136, 226093583, 226093592, 9, 1440x900 
0x37CA2318, 38092266054623792, 226093648, 226093656, 8, 1440x900 
0x37CA2318, 38092266055275120, 226093718, 226093726, 8, 1440x900 
0x37CA2318, 38092266055945712, 226093783, 226093791, 8, 1440x900 
0x37CA2318, 38092266056605464, 226093852, 226093860, 8, 1440x900 
0x37CA2318, 38092266057267280, 226093917, 226093925, 8, 1440x900 
0x37CA2318, 38092266057926264, 226093983, 226093991, 8, 1440x900 
0x37CA2318, 38092266058576776, 226094047, 226094056, 9, 1440x900 
0x37CA2318, 38092266059239096, 226094112, 226094121, 9, 1440x900 
0x37CA2318, 38092266059908992, 226094178, 226094187, 9, 1440x900 
0x37CA2318, 38092266060565696, 226094247, 226094255, 8, 1440x900 
0x37CA2318, 38092266061228832, 226094312, 226094320, 8, 1440x900 
0x37CA2318, 38092266061887888, 226094378, 226094386, 8, 1440x900 
0x37CA2318, 38092266062550296, 226094443, 226094451, 8, 1440x900 
0x37CA2318, 38092266063209296, 226094512, 226094520, 8, 1440x900 
0x37CA2318, 38092266063878776, 226094577, 226094585, 8, 1440x900 
0x37CA2318, 38092266064531080, 226094643, 226094651, 8, 1440x900 
0x37CA2318, 38092266065191440, 226094708, 226094716, 8, 1440x900 
0x37CA2318, 38092266065861872, 226094778, 226094786, 8, 1440x900 
0x37CA2318, 38092266066513280, 226094843, 226094851, 8, 1440x900 
0x37CA2318, 38092266067172752, 226094907, 226094916, 9, 1440x900 
0x37CA2318, 38092266067835840, 226094972, 226094981, 9, 1440x900 
0x37CA2318, 38092266068499616, 226095043, 226095052, 9, 1440x900 
0x37CA2318, 38092266069169224, 226095103, 226095113, 10, 1440x900 
0x37CA2318, 38092266069821256, 226095172, 226095181, 9, 1440x900 
0x37CA2318, 38092266070481640, 226095238, 226095246, 8, 1440x900 
0x37CA2318, 38092266071149664, 226095303, 226095311, 8, 1440x900 
0x37CA2318, 38092266071818768, 226095368, 226095376, 8, 1440x900 
0x37CA2318, 38092266072480392, 226095433, 226095441, 8, 1440x900 
0x37CA2318, 38092266073132464, 226095503, 226095511, 8, 1440x900 
0x37CA2318, 38092266074462344, 226095637, 226095645, 8, 1440x900 
0x37CA2318, 38092266075110040, 226095697, 226095704, 7, 1440x900 
0x37CA2318, 38092266075780640, 226095763, 226095771, 8, 1440x900 
0x37CA2318, 38092266076433480, 226095828, 226095837, 9, 1440x900 
0x37CA2318, 38092266077090608, 226095897, 226095906, 9, 1440x900 
0x37CA2318, 38092266077760176, 226095967, 226095976, 9, 1440x900 
0x37CA2318, 38092266078421304, 226096033, 226096041, 8, 1440x900 
0x37CA2318, 38092266079085792, 226096096, 226096104, 8, 1440x900 
0x37CA2318, 38092266079749592, 226096162, 226096170, 8, 1440x900 
0x37CA2318, 38092266080401392, 226096228, 226096237, 9, 1440x900 
0x37CA2318, 38092266081069696, 226096298, 226096306, 8, 1440x900 
0x37CA2318, 38092266081722064, 226096363, 226096371, 8, 1440x900 
0x37CA2318, 38092266082382136, 226096428, 226096436, 8, 1440x900 
0x37CA2318, 38092266083044000, 226096493, 226096501, 8, 1440x900 
0x37CA2318, 38092266083713904, 226096560, 226096569, 9, 1440x900 
0x37CA2318, 38092266084373008, 226096628, 226096636, 8, 1440x900 
0x37CA2318, 38092266085032464, 226096691, 226096700, 9, 1440x900 
0x37CA2318, 38092266085693664, 226096756, 226096764, 8, 1440x900 
0x37CA2318, 38092266086352560, 226096827, 226096836, 9, 1440x900 
0x37CA2318, 38092266087023832, 226096893, 226096901, 8, 1440x900 
0x37CA2318, 38092266087681336, 226096958, 226096966, 8, 1440x900 
0x37CA2318, 38092266088351152, 226097028, 226097036, 8, 1440x900 
0x37CA2318, 38092266089000720, 226097093, 226097102, 9, 1440x900 
0x37CA2318, 38092266089659560, 226097152, 226097160, 8, 1440x900 
0x37CA2318, 38092266090330736, 226097218, 226097227, 9, 1440x900 
0x37CA2318, 38092266090989816, 226097286, 226097294, 8, 1440x900 
0x37CA2318, 38092266091642744, 226097351, 226097359, 8, 1440x900 
0x37CA2318, 38092266092314512, 226097422, 226097430, 8, 1440x900 
0x37CA2318, 38092266092973328, 226097484, 226097492, 8, 1440x900 
0x37CA2318, 38092266093624640, 226097554, 226097561, 7, 1440x900 
0x37CA2318, 38092266094287552, 226097618, 226097627, 9, 1440x900 
0x37CA2318, 38092266094944408, 226097683, 226097691, 8, 1440x900 
0x37CA2318, 38092266095614912, 226097747, 226097755, 8, 1440x900 
0x37CA2318, 38092266096274512, 226097814, 226097821, 7, 1440x900 
0x37CA2318, 38092266096926496, 226097883, 226097891, 8, 1440x900 
0x37CA2318, 38092266097587600, 226097947, 226097956, 9, 1440x900 
0x37CA2318, 38092266098247456, 226098013, 226098022, 9, 1440x900 
0x37CA2318, 38092266098916896, 226098082, 226098091, 9, 1440x900 
0x37CA2318, 38092266099578896, 226098148, 226098156, 8, 1440x900 
0x37CA2318, 38092266100229976, 226098213, 226098221, 8, 1440x900 
0x37CA2318, 38092266100882096, 226098278, 226098286, 8, 1440x900 
0x37CA2318, 38092266101552600, 226098343, 226098352, 9, 1440x900 
0x37CA2318, 38092266102215792, 226098409, 226098418, 9, 1440x900 
0x37CA2318, 38092266102875984, 226098478, 226098486, 8, 1440x900 
0x37CA2318, 38092266103545024, 226098543, 226098551, 8, 1440x900 
0x37CA2318, 38092266104197152, 226098607, 226098616, 9, 1440x900 
0x37CA2318, 38092266104663496, 226098653, 226098662, 9, 1440x900 
0x37CA2318, 38092266105324136, 226098724, 226098732, 8, 1440x900 
0x37CA2318, 38092266105992216, 226098788, 226098795, 7, 1440x900 
0x37CA2318, 38092266106731472, 226098867, 226098875, 8, 1440x900 
0x37CA2318, 38092266107331648, 226098919, 226098927, 8, 1440x900 
0x37CA2318, 38092266107970936, 226098983, 226098991, 8, 1440x900 
0x37CA2318, 38092266108630848, 226099048, 226099056, 8, 1440x900 
0x37CA2318, 38092266109291120, 226099113, 226099122, 9, 1440x900 
0x37CA2318, 38092266109952640, 226099183, 226099190, 7, 1440x900 
0x37CA2318, 38092266110861736, 226099279, 226099296, 17, 1440x900 
0x37CA2318, 38092266111311200, 226099318, 226099325, 7, 1440x900 
0x37CA2318, 38092266111935032, 226099378, 226099386, 8, 1440x900 
0x37CA2318, 38092266112596712, 226099443, 226099451, 8, 1440x900 
0x37CA2318, 38092266113344376, 226099522, 226099529, 7, 1440x900 
0x37CA2318, 38092266113973592, 226099582, 226099590, 8, 1440x900 
0x37CA2318, 38092266114831648, 226099668, 226099676, 8, 1440x900 
0x37CA2318, 38092266115481816, 226099732, 226099741, 9, 1440x900 
0x37CA2318, 38092266116025528, 226099787, 226099795, 8, 1440x900 
0x37CA2318, 38092266116566256, 226099843, 226099850, 7, 1440x900 
0x37CA2318, 38092266117223568, 226099908, 226099916, 8, 1440x900 
0x37CA2318, 38092266118096776, 226099998, 226100007, 9, 1440x900 
0x37CA2318, 38092266118756136, 226100063, 226100072, 9, 1440x900 
0x37CA2318, 38092266119407704, 226100128, 226100137, 9, 1440x900 
0x37CA2318, 38092266120076320, 226100193, 226100201, 8, 1440x900 
0x37CA2318, 38092266120728880, 226100263, 226100271, 8, 1440x900 
0x37CA2318, 38092266121389024, 226100327, 226100336, 9, 1440x900 
0x37CA2318, 38092266122039832, 226100393, 226100401, 8, 1440x900 
0x37CA2318, 38092266122718448, 226100463, 226100471, 8, 1440x900 
0x37CA2318, 38092266123369048, 226100528, 226100536, 8, 1440x900 
0x37CA2318, 38092266124022184, 226100592, 226100600, 8, 1440x900 
0x37CA2318, 38092266124685320, 226100659, 226100667, 8, 1440x900 
0x37CA2318, 38092266125365200, 226100727, 226100735, 8, 1440x900 
0x37CA2318, 38092266126021952, 226100792, 226100800, 8, 1440x900 
0x37CA2318, 38092266126681368, 226100857, 226100865, 8, 1440x900 
0x37CA2318, 38092266127341496, 226100918, 226100926, 8, 1440x900 
0x37CA2318, 38092266128003560, 226100987, 226100995, 8, 1440x900 
0x37CA2318, 38092266128663296, 226101052, 226101060, 8, 1440x900 
0x37CA2318, 38092266129333672, 226101124, 226101131, 7, 1440x900 
0x37CA2318, 38092266129984296, 226101187, 226101196, 9, 1440x900 
0x37CA2318, 38092266130645848, 226101253, 226101262, 9, 1440x900 
0x37CA2318, 38092266131316592, 226101324, 226101333, 9, 1440x900 
0x37CA2318, 38092266131967472, 226101388, 226101397, 9, 1440x900 
0x37CA2318, 38092266132620936, 226101453, 226101462, 9, 1440x900 
0x37CA2318, 38092266133300032, 226101518, 226101526, 8, 1440x900 
0x37CA2318, 38092266133949600, 226101584, 226101592, 8, 1440x900 
0x37CA2318, 38092266134613328, 226101647, 226101657, 10, 1440x900 
0x37CA2318, 38092266135265760, 226101718, 226101726, 8, 1440x900 
0x37CA2318, 38092266135927400, 226101783, 226101791, 8, 1440x900 
0x37CA2318, 38092266136590784, 226101848, 226101857, 9, 1440x900 
0x37CA2318, 38092266137249512, 226101913, 226101921, 8, 1440x900 
0x37CA2318, 38092266137917200, 226101977, 226101985, 8, 1440x900 
0x37CA2318, 38092266138569784, 226102043, 226102051, 8, 1440x900 
0x37CA2318, 38092266139232888, 226102111, 226102119, 8, 1440x900 
0x37CA2318, 38092266139896032, 226102177, 226102184, 7, 1440x900 
0x37CA2318, 38092266140562408, 226102243, 226102252, 9, 1440x900 
0x37CA2318, 38092266141221376, 226102313, 226102321, 8, 1440x900 
0x37CA2318, 38092266141872776, 226102378, 226102386, 8, 1440x900 
0x37CA2318, 38092266142552656, 226102442, 226102451, 9, 1440x900 
0x37CA2318, 38092266143203808, 226102507, 226102516, 9, 1440x900 
0x37CA2318, 38092266143865744, 226102578, 226102586, 8, 1440x900 
0x37CA2318, 38092266144526144, 226102643, 226102652, 9, 1440x900 
0x37CA2318, 38092266145177528, 226102707, 226102716, 9, 1440x900 
0x37CA2318, 38092266145846000, 226102773, 226102782, 9, 1440x900 
0x37CA2318, 38092266146498640, 226102837, 226102847, 10, 1440x900 
0x37CA2318, 38092266147178264, 226102907, 226102916, 9, 1440x900 
0x37CA2318, 38092266147838296, 226102978, 226102987, 9, 1440x900 
0x37CA2318, 38092266148487872, 226103038, 226103047, 9, 1440x900 
0x37CA2318, 38092266149166776, 226103107, 226103115, 8, 1440x900 
0x37CA2318, 38092266149817792, 226103168, 226103177, 9, 1440x900 
0x37CA2318, 38092266150478688, 226103237, 226103245, 8, 1440x900 
0x37CA2318, 38092266151138760, 226103303, 226103311, 8, 1440x900 
0x37CA2318, 38092266151799648, 226103369, 226103379, 10, 1440x900 
0x37CA2318, 38092266152926048, 226103478, 226103487, 9, 1440x900 
0x37CA2318, 38092266153883760, 226103573, 226103581, 8, 1440x900 
0x37CA2318, 38092266154388808, 226103624, 226103636, 12, 1440x900 
0x37CA2318, 38092266155032688, 226103687, 226103697, 10, 1440x900 
0x37CA2318, 38092266155588448, 226103743, 226103751, 8, 1440x900 
0x37CA2318, 38092266156244544, 226103812, 226103820, 8, 1440x900 
0x37CA2318, 38092266156902024, 226103877, 226103885, 8, 1440x900 
0x37CA2318, 38092266157565656, 226103943, 226103950, 7, 1440x900 
0x37CA2318, 38092266158238976, 226104013, 226104023, 10, 1440x900 
0x37CA2318, 38092266158883616, 226104077, 226104085, 8, 1440x900 
0x37CA2318, 38092266159544848, 226104142, 226104150, 8, 1440x900 
0x37CA2318, 38092266160203168, 226104207, 226104216, 9, 1440x900 
0x37CA2318, 38092266160863152, 226104272, 226104281, 9, 1440x900 
0x37CA2318, 38092266161523200, 226104337, 226104346, 9, 1440x900 
0x37CA2318, 38092266162192800, 226104407, 226104414, 7, 1440x900 
0x37CA2318, 38092266162852728, 226104471, 226104479, 8, 1440x900 
0x37CA2318, 38092266163512640, 226104538, 226104546, 8, 1440x900 
0x37CA2318, 38092266164181064, 226104607, 226104617, 10, 1440x900 
0x37CA2318, 38092266164836120, 226104673, 226104680, 7, 1440x900 
0x37CA2318, 38092266165499472, 226104737, 226104746, 9, 1440x900 
0x37CA2318, 38092266166160120, 226104802, 226104812, 10, 1440x900 
0x37CA2318, 38092266166819840, 226104873, 226104880, 7, 1440x900 
0x37CA2318, 38092266167483352, 226104938, 226104949, 11, 1440x900 
0x37CA2318, 38092266168146912, 226105002, 226105010, 8, 1440x900 
0x37CA2318, 38092266168805040, 226105067, 226105074, 7, 1440x900 
0x37CA2318, 38092266169462856, 226105133, 226105140, 7, 1440x900 
0x37CA2318, 38092266170123208, 226105199, 226105206, 7, 1440x900 
0x37CA2318, 38092266170783272, 226105263, 226105272, 9, 1440x900 
0x37CA2318, 38092266171442776, 226105332, 226105340, 8, 1440x900 
0x37CA2318, 38092266172118256, 226105403, 226105412, 9, 1440x900 
0x37CA2318, 38092266172779080, 226105469, 226105479, 10, 1440x900 
0x37CA2318, 38092266173435160, 226105529, 226105537, 8, 1440x900 
0x37CA2318, 38092266174294760, 226105617, 226105626, 9, 1440x900 
0x37CA2318, 38092266174954864, 226105688, 226105696, 8, 1440x900 
0x37CA2318, 38092266175615488, 226105748, 226105756, 8, 1440x900 
0x37CA2318, 38092266176284296, 226105817, 226105826, 9, 1440x900 
0x37CA2318, 38092266176781000, 226105864, 226105872, 8, 1440x900 
0x37CA2318, 38092266182480000, 226106437, 226106450, 13, 1440x900 
0x37CA2318, 38092266182590408, 226106451, 226106461, 10, 1440x900 
0x37CA2318, 38092266183446768, 226106531, 226106538, 7, 1440x900 
0x37CA2318, 38092266184473408, 226106633, 226106643, 10, 1440x900 
0x37CA2318, 38092266185133264, 226106702, 226106710, 8, 1440x900 
0x37CA2318, 38092266185793056, 226106768, 226106776, 8, 1440x900 
0x37CA2318, 38092266186459288, 226106832, 226106841, 9, 1440x900 
0x37CA2318, 38092266187110264, 226106900, 226106909, 9, 1440x900 
0x37CA2318, 38092266187782136, 226106962, 226106970, 8, 1440x900 
0x37CA2318, 38092266204159784, 226108603, 226108612, 9, 1440x900 
0x37CA2318, 38092266204471168, 226108644, 226108715, 71, 1440x900 
0x37CA2318, 38092266205307232, 226108724, 226108762, 38, 1440x900 
0x37CA2318, 38092266205836848, 226108767, 226108775, 8, 1440x900 
0x37CA2318, 38092266206343160, 226108822, 226108828, 6, 1440x900 
0x37CA2318, 38092266207069232, 226108893, 226108900, 7, 1440x900 
0x37CA2318, 38092266207725696, 226108958, 226108965, 7, 1440x900 
0x37CA2318, 38092266208383056, 226109027, 226109034, 7, 1440x900 
0x37CA2318, 38092266209041392, 226109092, 226109101, 9, 1440x900 
0x37CA2318, 38092266209532496, 226109137, 226109144, 7, 1440x900 
0x37CA2318, 38092266210489120, 226109268, 226109280, 12, 1440x900 
0x37CA2318, 38092266211003536, 226109292, 226109303, 11, 1440x900 
0x37CA2318, 38092266211562304, 226109342, 226109352, 10, 1440x900 
0x37CA2318, 38092266212222736, 226109408, 226109414, 6, 1440x900 
0x37CA2318, 38092266213085408, 226109493, 226109503, 10, 1440x900 
0x37CA2318, 38092266213548624, 226109542, 226109550, 8, 1440x900 
0x37CA2318, 38092266214214192, 226109607, 226109616, 9, 1440x900 
0x37CA2318, 38092266214883000, 226109673, 226109681, 8, 1440x900 
0x37CA2318, 38092266215532192, 226109737, 226109746, 9, 1440x900 
0x37CA2318, 38092266216203112, 226109804, 226109812, 8, 1440x900 
0x37CA2318, 38092266216863776, 226109872, 226109879, 7, 1440x900 
0x37CA2318, 38092266217520208, 226109937, 226109944, 7, 1440x900 
0x37CA2318, 38092266218367576, 226110023, 226110030, 7, 1440x900 
0x37CA2318, 38092266218840608, 226110073, 226110080, 7, 1440x900 
0x37CA2318, 38092266219511792, 226110143, 226110151, 8, 1440x900 
0x37CA2318, 38092266220167872, 226110203, 226110210, 7, 1440x900 
0x37CA2318, 38092266220831752, 226110272, 226110281, 9, 1440x900 
0x37CA2318, 38092266221685696, 226110358, 226110365, 7, 1440x900 
0x37CA2318, 38092266222336320, 226110418, 226110426, 8, 1440x900 
0x37CA2318, 38092266222999872, 226110487, 226110494, 7, 1440x900 
0x37CA2318, 38092266223666432, 226110552, 226110560, 8, 1440x900 
0x37CA2318, 38092266224317592, 226110618, 226110625, 7, 1440x900 
0x37CA2318, 38092266224987816, 226110687, 226110695, 8, 1440x900 
0x37CA2318, 38092266225651376, 226110753, 226110761, 8, 1440x900 
0x37CA2318, 38092266226318104, 226110823, 226110831, 8, 1440x900 
0x37CA2318, 38092266226970144, 226110888, 226110896, 8, 1440x900 
0x37CA2318, 38092266228102760, 226110998, 226111005, 7, 1440x900 
0x37CA2318, 38092266228764984, 226111062, 226111070, 8, 1440x900 
0x37CA2318, 38092266229424416, 226111128, 226111136, 8, 1440x900 
0x37CA2318, 38092266230089136, 226111198, 226111206, 8, 1440x900 
0x37CA2318, 38092266230739776, 226111262, 226111269, 7, 1440x900 
0x37CA2318, 38092266231399920, 226111327, 226111334, 7, 1440x900 
0x37CA2318, 38092266232065360, 226111393, 226111401, 8, 1440x900 
0x37CA2318, 38092266232727736, 226111457, 226111465, 8, 1440x900 
0x37CA2318, 38092266233383768, 226111523, 226111530, 7, 1440x900 
0x37CA2318, 38092266234042240, 226111588, 226111596, 8, 1440x900 
0x37CA2318, 38092266234709992, 226111657, 226111664, 7, 1440x900 
0x37CA2318, 38092266235366368, 226111723, 226111730, 7, 1440x900 
0x37CA2318, 38092266236028616, 226111793, 226111802, 9, 1440x900 
0x37CA2318, 38092266236696104, 226111858, 226111868, 10, 1440x900 
0x37CA2318, 38092266237352472, 226111922, 226111930, 8, 1440x900 
0x37CA2318, 38092266238013936, 226111987, 226111995, 8, 1440x900 
0x37CA2318, 38092266238678272, 226112058, 226112066, 8, 1440x900 
0x37CA2318, 38092266239525304, 226112142, 226112150, 8, 1440x900 
0x37CA2318, 38092266240179200, 226112208, 226112216, 8, 1440x900 
0x37CA2318, 38092266240850304, 226112272, 226112280, 8, 1440x900 
0x37CA2318, 38092266241319960, 226112317, 226112325, 8, 1440x900 
0x37CA2318, 38092266241984064, 226112387, 226112395, 8, 1440x900 
0x37CA2318, 38092266242714888, 226112464, 226112472, 8, 1440x900 
0x37CA2318, 38092266243312952, 226112524, 226112531, 7, 1440x900 
0x37CA2318, 38092266243971680, 226112587, 226112596, 9, 1440x900 
0x37CA2318, 38092266244626320, 226112648, 226112656, 8, 1440x900 
0x37CA2318, 38092266245281552, 226112714, 226112723, 9, 1440x900 
0x37CA2318, 38092266245945536, 226112782, 226112789, 7, 1440x900 
0x37CA2318, 38092266246795704, 226112868, 226112877, 9, 1440x900 
0x37CA2318, 38092266247466120, 226112934, 226112942, 8, 1440x900 
0x37CA2318, 38092266248119184, 226113002, 226113010, 8, 1440x900 
0x37CA2318, 38092266248788656, 226113067, 226113075, 8, 1440x900 
0x37CA2318, 38092266249438528, 226113133, 226113142, 9, 1440x900 
0x37CA2318, 38092266249913032, 226113178, 226113187, 9, 1440x900 
0x37CA2318, 38092266250573104, 226113248, 226113257, 9, 1440x900 
0x37CA2318, 38092266251235504, 226113312, 226113319, 7, 1440x900 
0x37CA2318, 38092266251902544, 226113379, 226113387, 8, 1440x900 
0x37CA2318, 38092266252749136, 226113462, 226113470, 8, 1440x900 
0x37CA2318, 38092266253410456, 226113532, 226113540, 8, 1440x900 
0x37CA2318, 38092266254079376, 226113598, 226113606, 8, 1440x900 
0x37CA2318, 38092266254729360, 226113663, 226113673, 10, 1440x900 
0x37CA2318, 38092266255365848, 226113723, 226113731, 8, 1440x900 
0x37CA2318, 38092266255856688, 226113773, 226113780, 7, 1440x900 
0x37CA2318, 38092266256518440, 226113837, 226113845, 8, 1440x900 
0x37CA2318, 38092266257181768, 226113902, 226113910, 8, 1440x900 
0x37CA2318, 38092266257852160, 226113972, 226113980, 8, 1440x900 
0x37CA2318, 38092266258714392, 226114062, 226114071, 9, 1440x900 
0x37CA2318, 38092266259365816, 226114123, 226114131, 8, 1440x900 
0x37CA2318, 38092266260025000, 226114193, 226114201, 8, 1440x900 
0x37CA2318, 38092266260685864, 226114253, 226114261, 8, 1440x900 
0x37CA2318, 38092266261345744, 226114323, 226114332, 9, 1440x900 
0x37CA2318, 38092266262015160, 226114392, 226114400, 8, 1440x900 
0x37CA2318, 38092266262675192, 226114453, 226114461, 8, 1440x900 
0x37CA2318, 38092266263334176, 226114522, 226114530, 8, 1440x900 
0x37CA2318, 38092266263986768, 226114587, 226114595, 8, 1440x900 
0x37CA2318, 38092266264649248, 226114652, 226114659, 7, 1440x900 
0x37CA2318, 38092266265310088, 226114722, 226114730, 8, 1440x900 
0x37CA2318, 38092266265970032, 226114788, 226114796, 8, 1440x900 
0x37CA2318, 38092266266630880, 226114853, 226114861, 8, 1440x900 
0x37CA2318, 38092266267290720, 226114918, 226114926, 8, 1440x900 
0x37CA2318, 38092266267942752, 226114983, 226114991, 8, 1440x900 
0x37CA2318, 38092266268613264, 226115048, 226115057, 9, 1440x900 
0x37CA2318, 38092266269274192, 226115115, 226115125, 10, 1440x900 
0x37CA2318, 38092266269934136, 226115183, 226115191, 8, 1440x900 
0x37CA2318, 38092266270605376, 226115248, 226115257, 9, 1440x900 
0x37CA2318, 38092266271255368, 226115313, 226115323, 10, 1440x900 
0x37CA2318, 38092266271914888, 226115379, 226115388, 9, 1440x900 
0x37CA2318, 38092266272583888, 226115447, 226115455, 8, 1440x900 
0x37CA2318, 38092266273236184, 226115508, 226115516, 8, 1440x900 
0x37CA2318, 38092266273905608, 226115577, 226115585, 8, 1440x900 
0x37CA2318, 38092266274555344, 226115642, 226115650, 8, 1440x900 
0x37CA2318, 38092266275218056, 226115713, 226115721, 8, 1440x900 
0x37CA2318, 38092266275878248, 226115778, 226115786, 8, 1440x900 
0x37CA2318, 38092266276548160, 226115848, 226115856, 8, 1440x900 
0x37CA2318, 38092266277001456, 226115888, 226115896, 8, 1440x900 
0x37CA2318, 38092266277673056, 226115953, 226115962, 9, 1440x900 
0x37CA2318, 38092266278333776, 226116022, 226116030, 8, 1440x900 
0x37CA2318, 38092266278991160, 226116087, 226116094, 7, 1440x900 
0x37CA2318, 38092266279650336, 226116152, 226116159, 7, 1440x900 
0x37CA2318, 38092266280313264, 226116217, 226116225, 8, 1440x900 
0x37CA2318, 38092266280971216, 226116282, 226116290, 8, 1440x900 
0x37CA2318, 38092266281635104, 226116348, 226116357, 9, 1440x900 
0x37CA2318, 38092266282295552, 226116413, 226116421, 8, 1440x900 
0x37CA2318, 38092266282954296, 226116482, 226116491, 9, 1440x900 
0x37CA2318, 38092266283616592, 226116547, 226116555, 8, 1440x900 
0x37CA2318, 38092266284283896, 226116617, 226116625, 8, 1440x900 
0x37CA2318, 38092266284940824, 226116678, 226116687, 9, 1440x900 
0x37CA2318, 38092266285598440, 226116747, 226116755, 8, 1440x900 
0x37CA2318, 38092266286259480, 226116813, 226116821, 8, 1440x900 
0x37CA2318, 38092266286921424, 226116878, 226116885, 7, 1440x900 
0x37CA2318, 38092266287583360, 226116943, 226116951, 8, 1440x900 
0x37CA2318, 38092266288243128, 226117012, 226117020, 8, 1440x900 
0x37CA2318, 38092266288909872, 226117077, 226117085, 8, 1440x900 
0x37CA2318, 38092266289755960, 226117163, 226117172, 9, 1440x900 
0x37CA2318, 38092266290419520, 226117233, 226117241, 8, 1440x900 
0x37CA2318, 38092266291083536, 226117297, 226117305, 8, 1440x900 
0x37CA2318, 38092266291735176, 226117365, 226117373, 8, 1440x900 
0x37CA2318, 38092266292396424, 226117432, 226117440, 8, 1440x900 
0x37CA2318, 38092266293056248, 226117492, 226117500, 8, 1440x900 
0x37CA2318, 38092266293727328, 226117563, 226117571, 8, 1440x900 
0x37CA2318, 38092266294389720, 226117629, 226117637, 8, 1440x900 
0x37CA2318, 38092266295043664, 226117692, 226117701, 9, 1440x900 
0x37CA2318, 38092266295711960, 226117763, 226117772, 9, 1440x900 
0x37CA2318, 38092266296374472, 226117823, 226117831, 8, 1440x900 
0x37CA2318, 38092266297044040, 226117892, 226117900, 8, 1440x900 
0x37CA2318, 38092266297694920, 226117958, 226117967, 9, 1440x900 
0x37CA2318, 38092266298365416, 226118028, 226118036, 8, 1440x900 
0x37CA2318, 38092266299022728, 226118087, 226118095, 8, 1440x900 
0x37CA2318, 38092266299692104, 226118156, 226118163, 7, 1440x900 
0x37CA2318, 38092266300351912, 226118218, 226118227, 9, 1440x900 
0x37CA2318, 38092266301016992, 226118288, 226118295, 7, 1440x900 
0x37CA2318, 38092266301677912, 226118353, 226118361, 8, 1440x900 
0x37CA2318, 38092266302339176, 226118422, 226118430, 8, 1440x900 
0x37CA2318, 38092266302999280, 226118487, 226118495, 8, 1440x900 
0x37CA2318, 38092266303663288, 226118557, 226118565, 8, 1440x900 
0x37CA2318, 38092266304314752, 226118622, 226118631, 9, 1440x900 
0x37CA2318, 38092266304979728, 226118687, 226118695, 8, 1440x900 
0x37CA2318, 38092266305645248, 226118759, 226118767, 8, 1440x900 
0x37CA2318, 38092266306305552, 226118818, 226118827, 9, 1440x900 
0x37CA2318, 38092266306958360, 226118888, 226118896, 8, 1440x900 
0x37CA2318, 38092266307629888, 226118953, 226118962, 9, 1440x900 
0x37CA2318, 38092266308282616, 226119018, 226119026, 8, 1440x900 
0x37CA2318, 38092266308944032, 226119082, 226119091, 9, 1440x900 
0x37CA2318, 38092266309623136, 226119153, 226119161, 8, 1440x900 
0x37CA2318, 38092266310274576, 226119214, 226119223, 9, 1440x900 
0x37CA2318, 38092266310943224, 226119283, 226119291, 8, 1440x900 
0x37CA2318, 38092266311597328, 226119349, 226119357, 8, 1440x900 
0x37CA2318, 38092266312267168, 226119417, 226119426, 9, 1440x900 
0x37CA2318, 38092266312928184, 226119483, 226119491, 8, 1440x900 
0x37CA2318, 38092266313587728, 226119546, 226119554, 8, 1440x900 
0x37CA2318, 38092266314249192, 226119613, 226119621, 8, 1440x900 
0x37CA2318, 38092266314910928, 226119682, 226119690, 8, 1440x900 
0x37CA2318, 38092266315573440, 226119748, 226119756, 8, 1440x900 
0x37CA2318, 38092266316232832, 226119813, 226119822, 9, 1440x900 
0x37CA2318, 38092266316893328, 226119878, 226119886, 8, 1440x900 
0x37CA2318, 38092266317554544, 226119943, 226119952, 9, 1440x900 
0x37CA2318, 38092266318214352, 226120012, 226120021, 9, 1440x900 
0x37CA2318, 38092266318866984, 226120072, 226120081, 9, 1440x900 
0x37CA2318, 38092266319538256, 226120141, 226120149, 8, 1440x900 
0x37CA2318, 38092266320852944, 226120273, 226120282, 9, 1440x900 
0x37CA2318, 38092266321513608, 226120338, 226120347, 9, 1440x900 
0x37CA2318, 38092266322166216, 226120408, 226120416, 8, 1440x900 
0x37CA2318, 38092266322846208, 226120473, 226120481, 8, 1440x900 
0x37CA2318, 38092266323503224, 226120538, 226120547, 9, 1440x900 
0x37CA2318, 38092266324163968, 226120602, 226120610, 8, 1440x900 
0x37CA2318, 38092266324824328, 226120672, 226120680, 8, 1440x900 
0x37CA2318, 38092266325484904, 226120739, 226120747, 8, 1440x900 
0x37CA2318, 38092266326146288, 226120807, 226120815, 8, 1440x900 
0x37CA2318, 38092266326806336, 226120873, 226120881, 8, 1440x900 
0x37CA2318, 38092266327465912, 226120934, 226120943, 9, 1440x900 
0x37CA2318, 38092266328128800, 226121002, 226121011, 9, 1440x900 
0x37CA2318, 38092266328797040, 226121068, 226121076, 8, 1440x900 
0x37CA2318, 38092266329449232, 226121132, 226121141, 9, 1440x900 
0x37CA2318, 38092266330112840, 226121198, 226121208, 10, 1440x900 
0x37CA2318, 38092266330780336, 226121267, 226121275, 8, 1440x900 
0x37CA2318, 38092266331440456, 226121334, 226121342, 8, 1440x900 
0x37CA2318, 38092266332093536, 226121397, 226121405, 8, 1440x900 
0x37CA2318, 38092266332754320, 226121462, 226121470, 8, 1440x900 
0x37CA2318, 38092266333415928, 226121533, 226121542, 9, 1440x900 
0x37CA2318, 38092266334067640, 226121598, 226121606, 8, 1440x900 
0x37CA2318, 38092266334728864, 226121658, 226121666, 8, 1440x900 
0x37CA2318, 38092266335397472, 226121728, 226121737, 9, 1440x900 
0x37CA2318, 38092266336056184, 226121797, 226121805, 8, 1440x900 
0x37CA2318, 38092266336718328, 226121862, 226121870, 8, 1440x900 
0x37CA2318, 38092266337369872, 226121927, 226121935, 8, 1440x900 
0x37CA2318, 38092266338039680, 226121992, 226122000, 8, 1440x900 
0x37CA2318, 38092266338691768, 226122057, 226122065, 8, 1440x900 
0x37CA2318, 38092266339353936, 226122123, 226122132, 9, 1440x900 
0x37CA2318, 38092266340023792, 226122193, 226122201, 8, 1440x900 
0x37CA2318, 38092266340685256, 226122258, 226122266, 8, 1440x900 
0x37CA2318, 38092266341346056, 226122323, 226122332, 9, 1440x900 
0x37CA2318, 38092266341997200, 226122388, 226122397, 9, 1440x900 
0x37CA2318, 38092266342659456, 226122458, 226122466, 8, 1440x900 
0x37CA2318, 38092266343322176, 226122523, 226122531, 8, 1440x900 
0x37CA2318, 38092266343983200, 226122588, 226122597, 9, 1440x900 
0x37CA2318, 38092266344645904, 226122653, 226122662, 9, 1440x900 
0x37CA2318, 38092266345299840, 226122718, 226122726, 8, 1440x900 
0x37CA2318, 38092266345970080, 226122787, 226122795, 8, 1440x900 
0x37CA2318, 38092266346640296, 226122853, 226122861, 8, 1440x900 
0x37CA2318, 38092266347297656, 226122922, 226122930, 8, 1440x900 
0x37CA2318, 38092266347957824, 226122982, 226122992, 10, 1440x900 
0x37CA2318, 38092266348618768, 226123052, 226123060, 8, 1440x900 
0x37CA2318, 38092266349289000, 226123118, 226123127, 9, 1440x900 
0x37CA2318, 38092266349939096, 226123182, 226123189, 7, 1440x900 
0x37CA2318, 38092266350590864, 226123243, 226123252, 9, 1440x900 
0x37CA2318, 38092266351262408, 226123312, 226123319, 7, 1440x900 
0x37CA2318, 38092266351919552, 226123378, 226123385, 7, 1440x900 
0x37CA2318, 38092266352571672, 226123446, 226123454, 8, 1440x900 
0x37CA2318, 38092266353234192, 226123512, 226123520, 8, 1440x900 
0x37CA2318, 38092266353910608, 226123577, 226123585, 8, 1440x900 
0x37CA2318, 38092266354580560, 226123646, 226123654, 8, 1440x900 
0x37CA2318, 38092266355233416, 226123708, 226123717, 9, 1440x900 
0x37CA2318, 38092266355888968, 226123777, 226123785, 8, 1440x900 
0x37CA2318, 38092266356559496, 226123846, 226123854, 8, 1440x900 
0x37CA2318, 38092266357220808, 226123912, 226123920, 8, 1440x900 
0x37CA2318, 38092266357870144, 226123978, 226123986, 8, 1440x900 
0x37CA2318, 38092266358532016, 226124043, 226124051, 8, 1440x900 
0x37CA2318, 38092266359192440, 226124107, 226124116, 9, 1440x900 
0x37CA2318, 38092266359854864, 226124173, 226124183, 10, 1440x900 
0x37CA2318, 38092266360515368, 226124238, 226124247, 9, 1440x900 
0x37CA2318, 38092266361171712, 226124304, 226124312, 8, 1440x900 
0x37CA2318, 38092266361832440, 226124372, 226124380, 8, 1440x900 
0x37CA2318, 38092266362494536, 226124439, 226124448, 9, 1440x900 
0x37CA2318, 38092266363147488, 226124503, 226124511, 8, 1440x900 
0x37CA2318, 38092266363817656, 226124572, 226124581, 9, 1440x900 
0x37CA2318, 38092266364485152, 226124637, 226124645, 8, 1440x900 
0x37CA2318, 38092266365142736, 226124703, 226124711, 8, 1440x900 
0x37CA2318, 38092266365795792, 226124768, 226124776, 8, 1440x900 
0x37CA2318, 38092266366465272, 226124839, 226124848, 9, 1440x900 
0x37CA2318, 38092266367133832, 226124898, 226124906, 8, 1440x900 
0x37CA2318, 38092266367785280, 226124968, 226124976, 8, 1440x900 
0x37CA2318, 38092266368447592, 226125032, 226125041, 9, 1440x900 
0x37CA2318, 38092266369108136, 226125102, 226125110, 8, 1440x900 
0x37CA2318, 38092266369769592, 226125168, 226125176, 8, 1440x900 
0x37CA2318, 38092266370431872, 226125234, 226125242, 8, 1440x900 
0x37CA2318, 38092266371091288, 226125296, 226125304, 8, 1440x900 
0x37CA2318, 38092266371751520, 226125361, 226125369, 8, 1440x900 
0x37CA2318, 38092266372411728, 226125427, 226125435, 8, 1440x900 
0x37CA2318, 38092266373074744, 226125493, 226125502, 9, 1440x900 
0x37CA2318, 38092266373733632, 226125559, 226125567, 8, 1440x900 
0x37CA2318, 38092266374394272, 226125628, 226125636, 8, 1440x900 
0x37CA2318, 38092266375054592, 226125693, 226125700, 7, 1440x900 
0x37CA2318, 38092266375716192, 226125758, 226125766, 8, 1440x900 
0x37CA2318, 38092266376377192, 226125828, 226125836, 8, 1440x900 
0x37CA2318, 38092266377037064, 226125891, 226125899, 8, 1440x900 
0x37CA2318, 38092266377697480, 226125957, 226125966, 9, 1440x900 
0x37CA2318, 38092266378359624, 226126023, 226126032, 9, 1440x900 
0x37CA2318, 38092266379012368, 226126092, 226126100, 8, 1440x900 
0x37CA2318, 38092266379682568, 226126158, 226126166, 8, 1440x900 
0x37CA2318, 38092266380338800, 226126222, 226126232, 10, 1440x900 
0x37CA2318, 38092266380992048, 226126288, 226126297, 9, 1440x900 
0x37CA2318, 38092266381665400, 226126357, 226126365, 8, 1440x900 
0x37CA2318, 38092266382328752, 226126423, 226126431, 8, 1440x900 
0x37CA2318, 38092266382986216, 226126487, 226126496, 9, 1440x900 
0x37CA2318, 38092266383656448, 226126553, 226126562, 9, 1440x900 
0x37CA2318, 38092266384307760, 226126618, 226126627, 9, 1440x900 
0x37CA2318, 38092266384969536, 226126683, 226126692, 9, 1440x900 
0x37CA2318, 38092266385630712, 226126751, 226126759, 8, 1440x900 
0x37CA2318, 38092266386298760, 226126817, 226126825, 8, 1440x900 
0x37CA2318, 38092266386965768, 226126883, 226126891, 8, 1440x900 
0x37CA2318, 38092266387617832, 226126952, 226126960, 8, 1440x900 
0x37CA2318, 38092266388289232, 226127018, 226127026, 8, 1440x900 
0x37CA2318, 38092266388956616, 226127087, 226127095, 8, 1440x900 
0x37CA2318, 38092266389607352, 226127152, 226127160, 8, 1440x900 
0x37CA2318, 38092266390286096, 226127217, 226127225, 8, 1440x900 
0x37CA2318, 38092266390940312, 226127282, 226127291, 9, 1440x900 
0x37CA2318, 38092266391592672, 226127347, 226127355, 8, 1440x900 
0x37CA2318, 38092266392260352, 226127417, 226127425, 8, 1440x900 
0x37CA2318, 38092266392930032, 226127483, 226127492, 9, 1440x900 
0x37CA2318, 38092266393591648, 226127547, 226127555, 8, 1440x900 
0x37CA2318, 38092266394242816, 226127613, 226127621, 8, 1440x900 
0x37CA2318, 38092266394895064, 226127678, 226127687, 9, 1440x900 
0x37CA2318, 38092266395559384, 226127743, 226127752, 9, 1440x900 
0x37CA2318, 38092266396230160, 226127812, 226127820, 8, 1440x900 
0x37CA2318, 38092266396880360, 226127878, 226127887, 9, 1440x900 
0x37CA2318, 38092266397550888, 226127947, 226127955, 8, 1440x900 
0x37CA2318, 38092266398212120, 226128013, 226128021, 8, 1440x900 
0x37CA2318, 38092266398862728, 226128073, 226128081, 8, 1440x900 
0x37CA2318, 38092266399526504, 226128143, 226128151, 8, 1440x900 
0x37CA2318, 38092266400845344, 226128273, 226128281, 8, 1440x900 
0x37CA2318, 38092266401514992, 226128338, 226128347, 9, 1440x900 
0x37CA2318, 38092266402175984, 226128407, 226128415, 8, 1440x900 
0x37CA2318, 38092266402829448, 226128472, 226128481, 9, 1440x900 
0x37CA2318, 38092266403491328, 226128538, 226128547, 9, 1440x900 
0x37CA2318, 38092266404157704, 226128614, 226128623, 9, 1440x900 
0x37CA2318, 38092266404819528, 226128668, 226128676, 8, 1440x900 
0x37CA2318, 38092266405479968, 226128738, 226128746, 8, 1440x900 
0x37CA2318, 38092266406139560, 226128803, 226128811, 8, 1440x900 
0x37CA2318, 38092266406793112, 226128872, 226128880, 8, 1440x900 
0x37CA2318, 38092266407457744, 226128938, 226128946, 8, 1440x900 
0x37CA2318, 38092266408126984, 226129002, 226129010, 8, 1440x900 
0x37CA2318, 38092266408779288, 226129067, 226129075, 8, 1440x900 
0x37CA2318, 38092266409449832, 226129137, 226129145, 8, 1440x900 
0x37CA2318, 38092266410100064, 226129197, 226129206, 9, 1440x900 
0x37CA2318, 38092266410753976, 226129263, 226129272, 9, 1440x900 
0x37CA2318, 38092266411417208, 226129332, 226129340, 8, 1440x900 
0x37CA2318, 38092266412097072, 226129403, 226129411, 8, 1440x900 
0x37CA2318, 38092266412756912, 226129463, 226129472, 9, 1440x900 
0x37CA2318, 38092266413408176, 226129527, 226129536, 9, 1440x900 
0x37CA2318, 38092266414068448, 226129597, 226129605, 8, 1440x900 
0x37CA2318, 38092266414729072, 226129662, 226129670, 8, 1440x900 
0x37CA2318, 38092266415389872, 226129727, 226129735, 8, 1440x900 
0x37CA2318, 38092266416058296, 226129792, 226129800, 8, 1440x900 
0x37CA2318, 38092266416710016, 226129862, 226129870, 8, 1440x900 
0x37CA2318, 38092266417372224, 226129927, 226129935, 8, 1440x900 
0x37CA2318, 38092266418040008, 226129997, 226130005, 8, 1440x900 
0x37CA2318, 38092266418698488, 226130062, 226130070, 8, 1440x900 
0x37CA2318, 38092266419357600, 226130123, 226130132, 9, 1440x900 
0x37CA2318, 38092266420018432, 226130193, 226130201, 8, 1440x900 
0x37CA2318, 38092266420679120, 226130258, 226130266, 8, 1440x900 
0x37CA2318, 38092266421332688, 226130322, 226130331, 9, 1440x900 
0x37CA2318, 38092266421996736, 226130387, 226130396, 9, 1440x900 
0x37CA2318, 38092266422669472, 226130458, 226130466, 8, 1440x900 
0x37CA2318, 38092266423320816, 226130522, 226130531, 9, 1440x900 
0x37CA2318, 38092266423980880, 226130587, 226130595, 8, 1440x900 
0x37CA2318, 38092266424649648, 226130652, 226130661, 9, 1440x900 
0x37CA2318, 38092266425296240, 226130718, 226130726, 8, 1440x900 
0x37CA2318, 38092266425966208, 226130783, 226130791, 8, 1440x900 
0x37CA2318, 38092266426629032, 226130853, 226130862, 9, 1440x900 
0x37CA2318, 38092266427289912, 226130917, 226130926, 9, 1440x900 
0x37CA2318, 38092266427951760, 226130983, 226130992, 9, 1440x900 
0x37CA2318, 38092266428594624, 226131048, 226131057, 9, 1440x900 
0x37CA2318, 38092266429255712, 226131117, 226131125, 8, 1440x900 
0x37CA2318, 38092266429918752, 226131183, 226131191, 8, 1440x900 
0x37CA2318, 38092266430579688, 226131246, 226131255, 9, 1440x900 
0x37CA2318, 38092266431241464, 226131311, 226131319, 8, 1440x900 
0x37CA2318, 38092266431912304, 226131382, 226131390, 8, 1440x900 
0x37CA2318, 38092266432562984, 226131443, 226131452, 9, 1440x900 
0x37CA2318, 38092266433222128, 226131508, 226131517, 9, 1440x900 
0x37CA2318, 38092266433891424, 226131578, 226131586, 8, 1440x900 
0x37CA2318, 38092266434541928, 226131643, 226131652, 9, 1440x900 
0x37CA2318, 38092266435203648, 226131707, 226131715, 8, 1440x900 
0x37CA2318, 38092266435865000, 226131773, 226131781, 8, 1440x900 
0x37CA2318, 38092266436518016, 226131837, 226131846, 9, 1440x900 
0x37CA2318, 38092266437189536, 226131906, 226131914, 8, 1440x900 
0x37CA2318, 38092266437857544, 226131978, 226131986, 8, 1440x900 
0x37CA2318, 38092266438525280, 226132043, 226132051, 8, 1440x900 
0x37CA2318, 38092266439184032, 226132107, 226132115, 8, 1440x900 
0x37CA2318, 38092266439843728, 226132173, 226132182, 9, 1440x900 
0x37CA2318, 38092266440507640, 226132243, 226132251, 8, 1440x900 
0x37CA2318, 38092266441165208, 226132303, 226132311, 8, 1440x900 
0x37CA2318, 38092266441827840, 226132373, 226132381, 8, 1440x900 
0x37CA2318, 38092266442497448, 226132438, 226132447, 9, 1440x900 
0x37CA2318, 38092266443157360, 226132503, 226132512, 9, 1440x900 
0x37CA2318, 38092266443820048, 226132573, 226132581, 8, 1440x900 
0x37CA2318, 38092266444480904, 226132637, 226132645, 8, 1440x900 
0x37CA2318, 38092266445141424, 226132702, 226132711, 9, 1440x900 
0x37CA2318, 38092266445808784, 226132768, 226132777, 9, 1440x900 
0x37CA2318, 38092266446461640, 226132833, 226132840, 7, 1440x900 
0x37CA2318, 38092266447123968, 226132902, 226132911, 9, 1440x900 
0x37CA2318, 38092266447782800, 226132967, 226132976, 9, 1440x900 
0x37CA2318, 38092266448445536, 226133034, 226133042, 8, 1440x900 
0x37CA2318, 38092266449111304, 226133097, 226133106, 9, 1440x900 
0x37CA2318, 38092266449764400, 226133167, 226133176, 9, 1440x900 
0x37CA2318, 38092266450415472, 226133234, 226133243, 9, 1440x900 
0x37CA2318, 38092266451078288, 226133297, 226133305, 8, 1440x900 
0x37CA2318, 38092266451744392, 226133363, 226133371, 8, 1440x900 
0x37CA2318, 38092266452413152, 226133427, 226133436, 9, 1440x900 
0x37CA2318, 38092266453073080, 226133498, 226133507, 9, 1440x900 
0x37CA2318, 38092266453731600, 226133563, 226133572, 9, 1440x900 
0x37CA2318, 38092266454394088, 226133632, 226133640, 8, 1440x900 
0x37CA2318, 38092266455062800, 226133697, 226133705, 8, 1440x900 
0x37CA2318, 38092266455714864, 226133763, 226133771, 8, 1440x900 
0x37CA2318, 38092266456374928, 226133828, 226133836, 8, 1440x900 
0x37CA2318, 38092266457043656, 226133893, 226133901, 8, 1440x900 
0x37CA2318, 38092266457704816, 226133962, 226133970, 8, 1440x900 
0x37CA2318, 38092266458372752, 226134028, 226134036, 8, 1440x900 
0x37CA2318, 38092266459031944, 226134092, 226134100, 8, 1440x900 
0x37CA2318, 38092266459701792, 226134158, 226134166, 8, 1440x900 
0x37CA2318, 38092266460352624, 226134222, 226134231, 9, 1440x900 
0x37CA2318, 38092266461016712, 226134292, 226134300, 8, 1440x900 
0x37CA2318, 38092266461685144, 226134358, 226134366, 8, 1440x900 
0x37CA2318, 38092266462335824, 226134421, 226134429, 8, 1440x900 
0x37CA2318, 38092266462996672, 226134487, 226134495, 8, 1440x900 
0x37CA2318, 38092266463656544, 226134552, 226134561, 9, 1440x900 
0x37CA2318, 38092266464318736, 226134623, 226134632, 9, 1440x900 
0x37CA2318, 38092266464971488, 226134684, 226134692, 8, 1440x900 
0x37CA2318, 38092266465635264, 226134753, 226134762, 9, 1440x900 
0x37CA2318, 38092266466305800, 226134823, 226134832, 9, 1440x900 
0x37CA2318, 38092266466956960, 226134887, 226134895, 8, 1440x900 
0x37CA2318, 38092266467618776, 226134953, 226134961, 8, 1440x900 
0x37CA2318, 38092266468276616, 226135016, 226135026, 10, 1440x900 
0x37CA2318, 38092266468936696, 226135078, 226135087, 9, 1440x900 
0x37CA2318, 38092266469597824, 226135147, 226135155, 8, 1440x900 
0x37CA2318, 38092266470259224, 226135212, 226135220, 8, 1440x900 
0x37CA2318, 38092266470911872, 226135277, 226135285, 8, 1440x900 
0x37CA2318, 38092266471581064, 226135343, 226135351, 8, 1440x900 
0x37CA2318, 38092266472241104, 226135408, 226135416, 8, 1440x900 
0x37CA2318, 38092266472892960, 226135477, 226135485, 8, 1440x900 
0x37CA2318, 38092266473562240, 226135543, 226135552, 9, 1440x900 
0x37CA2318, 38092266474215440, 226135613, 226135621, 8, 1440x900 
0x37CA2318, 38092266474886656, 226135677, 226135685, 8, 1440x900 
0x37CA2318, 38092266475547576, 226135747, 226135755, 8, 1440x900 
0x37CA2318, 38092266476202016, 226135808, 226135817, 9, 1440x900 
0x37CA2318, 38092266476859320, 226135877, 226135885, 8, 1440x900 
0x37CA2318, 38092266477530392, 226135942, 226135950, 8, 1440x900 
0x37CA2318, 38092266478198920, 226136007, 226136016, 9, 1440x900 
0x37CA2318, 38092266479512368, 226136138, 226136147, 9, 1440x900 
0x37CA2318, 38092266480165088, 226136204, 226136213, 9, 1440x900 
0x37CA2318, 38092266480835832, 226136272, 226136281, 9, 1440x900 
0x37CA2318, 38092266481498368, 226136337, 226136346, 9, 1440x900 
0x37CA2318, 38092266482159008, 226136408, 226136416, 8, 1440x900 
0x37CA2318, 38092266482818720, 226136473, 226136481, 8, 1440x900 
0x37CA2318, 38092266483473552, 226136538, 226136547, 9, 1440x900 
0x37CA2318, 38092266484144448, 226136603, 226136612, 9, 1440x900 
0x37CA2318, 38092266484806216, 226136672, 226136680, 8, 1440x900 
0x37CA2318, 38092266485459840, 226136733, 226136742, 9, 1440x900 
0x37CA2318, 38092266486120152, 226136802, 226136810, 8, 1440x900 
0x37CA2318, 38092266486798936, 226136868, 226136877, 9, 1440x900 
0x37CA2318, 38092266487449912, 226136932, 226136940, 8, 1440x900 
0x37CA2318, 38092266488102688, 226136997, 226137005, 8, 1440x900 
0x37CA2318, 38092266488773576, 226137063, 226137071, 8, 1440x900 
0x37CA2318, 38092266489433920, 226137133, 226137141, 8, 1440x900 
0x37CA2318, 38092266490094440, 226137198, 226137207, 9, 1440x900 
0x37CA2318, 38092266490754016, 226137268, 226137276, 8, 1440x900 
0x37CA2318, 38092266491414752, 226137334, 226137342, 8, 1440x900 
0x37CA2318, 38092266492069544, 226137397, 226137405, 8, 1440x900 
0x37CA2318, 38092266492740568, 226137463, 226137472, 9, 1440x900 
0x37CA2318, 38092266493403072, 226137528, 226137536, 8, 1440x900 
0x37CA2318, 38092266494064424, 226137597, 226137606, 9, 1440x900 
0x37CA2318, 38092266494716832, 226137662, 226137670, 8, 1440x900 
0x37CA2318, 38092266495392216, 226137728, 226137736, 8, 1440x900 
0x37CA2318, 38092266496042088, 226137793, 226137801, 8, 1440x900 
0x37CA2318, 38092266496702776, 226137858, 226137867, 9, 1440x900 
0x37CA2318, 38092266497373368, 226137923, 226137931, 8, 1440x900 
0x37CA2318, 38092266498016024, 226137988, 226137996, 8, 1440x900 
0x37CA2318, 38092266498685432, 226138058, 226138066, 8, 1440x900 
0x37CA2318, 38092266499346208, 226138127, 226138135, 8, 1440x900 
0x37CA2318, 38092266499998640, 226138188, 226138196, 8, 1440x900 
0x37CA2318, 38092266500673392, 226138257, 226138266, 9, 1440x900 
0x37CA2318, 38092266501327752, 226138323, 226138332, 9, 1440x900 
0x37CA2318, 38092266501994984, 226138388, 226138397, 9, 1440x900 
0x37CA2318, 38092266502652256, 226138453, 226138461, 8, 1440x900 
0x37CA2318, 38092266503314016, 226138522, 226138531, 9, 1440x900 
0x37CA2318, 38092266503982864, 226138587, 226138596, 9, 1440x900 
0x37CA2318, 38092266504632344, 226138648, 226138656, 8, 1440x900 
0x37CA2318, 38092266505295072, 226138723, 226138731, 8, 1440x900 
0x37CA2318, 38092266505962832, 226138782, 226138790, 8, 1440x900 
0x37CA2318, 38092266506614592, 226138850, 226138859, 9, 1440x900 
0x37CA2318, 38092266507285096, 226138919, 226138928, 9, 1440x900 
0x37CA2318, 38092266507929968, 226138978, 226138987, 9, 1440x900 
0x37CA2318, 38092266508605904, 226139052, 226139060, 8, 1440x900 
0x37CA2318, 38092266509260176, 226139113, 226139122, 9, 1440x900 
0x37CA2318, 38092266509911456, 226139182, 226139190, 8, 1440x900 
0x37CA2318, 38092266510575648, 226139248, 226139256, 8, 1440x900 
0x37CA2318, 38092266511243664, 226139313, 226139321, 8, 1440x900 
0x37CA2318, 38092266511911952, 226139377, 226139386, 9, 1440x900 
0x37CA2318, 38092266512563384, 226139443, 226139452, 9, 1440x900 
0x37CA2318, 38092266513224472, 226139510, 226139518, 8, 1440x900 
0x37CA2318, 38092266513886152, 226139577, 226139585, 8, 1440x900 
0x37CA2318, 38092266514541536, 226139643, 226139652, 9, 1440x900 
0x37CA2318, 38092266515212528, 226139708, 226139717, 9, 1440x900 
0x37CA2318, 38092266515866312, 226139773, 226139780, 7, 1440x900 
0x37CA2318, 38092266516523280, 226139843, 226139852, 9, 1440x900 
0x37CA2318, 38092266517202976, 226139913, 226139921, 8, 1440x900 
0x37CA2318, 38092266517852352, 226139973, 226139982, 9, 1440x900 
0x37CA2318, 38092266518521248, 226140037, 226140045, 8, 1440x900 
0x37CA2318, 38092266518986600, 226140082, 226140091, 9, 1440x900 
0x37CA2318, 38092266519850248, 226140172, 226140179, 7, 1440x900 
0x37CA2318, 38092266520519624, 226140237, 226140245, 8, 1440x900 
0x37CA2318, 38092266521171784, 226140303, 226140312, 9, 1440x900 
0x37CA2318, 38092266521831848, 226140372, 226140380, 8, 1440x900 
0x37CA2318, 38092266522493712, 226140438, 226140446, 8, 1440x900 
0x37CA2318, 38092266523154784, 226140504, 226140512, 8, 1440x900 
0x37CA2318, 38092266523807416, 226140568, 226140577, 9, 1440x900 
0x37CA2318, 38092266524474704, 226140638, 226140646, 8, 1440x900 
0x37CA2318, 38092266525134840, 226140703, 226140711, 8, 1440x900 
0x37CA2318, 38092266525790968, 226140767, 226140776, 9, 1440x900 
0x37CA2318, 38092266526461856, 226140838, 226140847, 9, 1440x900 
0x37CA2318, 38092266527131384, 226140903, 226140911, 8, 1440x900 
0x37CA2318, 38092266527783624, 226140970, 226140979, 9, 1440x900 
0x37CA2318, 38092266528442624, 226141028, 226141037, 9, 1440x900 
0x37CA2318, 38092266528909216, 226141077, 226141084, 7, 1440x900 
0x37CA2318, 38092266529768088, 226141162, 226141171, 9, 1440x900 
0x37CA2318, 38092266530432096, 226141228, 226141236, 8, 1440x900 
0x37CA2318, 38092266531085864, 226141296, 226141304, 8, 1440x900 
0x37CA2318, 38092266531758088, 226141363, 226141370, 7, 1440x900 
0x37CA2318, 38092266532411944, 226141432, 226141440, 8, 1440x900 
0x37CA2318, 38092266533090016, 226141498, 226141507, 9, 1440x900 
0x37CA2318, 38092266533749544, 226141563, 226141571, 8, 1440x900 
0x37CA2318, 38092266534409664, 226141629, 226141638, 9, 1440x900 
0x37CA2318, 38092266535064240, 226141693, 226141703, 10, 1440x900 
0x37CA2318, 38092266535718480, 226141763, 226141771, 8, 1440x900 
0x37CA2318, 38092266536389184, 226141826, 226141834, 8, 1440x900 
0x37CA2318, 38092266537049880, 226141893, 226141900, 7, 1440x900 
0x37CA2318, 38092266537710200, 226141957, 226141965, 8, 1440x900 
0x37CA2318, 38092266538372848, 226142023, 226142031, 8, 1440x900 
0x37CA2318, 38092266539036448, 226142093, 226142101, 8, 1440x900 
0x37CA2318, 38092266539705184, 226142157, 226142166, 9, 1440x900 
0x37CA2318, 38092266540359664, 226142223, 226142232, 9, 1440x900 
0x37CA2318, 38092266541010376, 226142288, 226142297, 9, 1440x900 
0x37CA2318, 38092266541679984, 226142358, 226142366, 8, 1440x900 
0x37CA2318, 38092266542345992, 226142423, 226142431, 8, 1440x900 
0x37CA2318, 38092266543670984, 226142557, 226142565, 8, 1440x900 
0x37CA2318, 38092266544331344, 226142623, 226142632, 9, 1440x900 
0x37CA2318, 38092266544983840, 226142688, 226142696, 8, 1440x900 
0x37CA2318, 38092266545652968, 226142757, 226142765, 8, 1440x900 
0x37CA2318, 38092266546312888, 226142822, 226142830, 8, 1440x900 
0x37CA2318, 38092266547022592, 226142891, 226142900, 9, 1440x900 
0x37CA2318, 38092266547683904, 226142953, 226142962, 9, 1440x900 
0x37CA2318, 38092266548354400, 226143023, 226143030, 7, 1440x900 
0x37CA2318, 38092266549015928, 226143087, 226143095, 8, 1440x900 
0x37CA2318, 38092266549686256, 226143157, 226143166, 9, 1440x900 
0x37CA2318, 38092266550336976, 226143222, 226143230, 8, 1440x900 
0x37CA2318, 38092266550995784, 226143287, 226143294, 7, 1440x900 
0x37CA2318, 38092266551668192, 226143358, 226143367, 9, 1440x900 
0x37CA2318, 38092266552329456, 226143422, 226143431, 9, 1440x900 
0x37CA2318, 38092266552990680, 226143487, 226143495, 8, 1440x900 
0x37CA2318, 38092266553651040, 226143553, 226143562, 9, 1440x900 
0x37CA2318, 38092266554301632, 226143616, 226143624, 8, 1440x900 
0x37CA2318, 38092266554971680, 226143688, 226143703, 15, 1440x900 
0x37CA2318, 38092266555433704, 226143728, 226143738, 10, 1440x900 
0x37CA2318, 38092266556093792, 226143793, 226143802, 9, 1440x900 
0x37CA2318, 38092266556952896, 226143883, 226143890, 7, 1440x900 
0x37CA2318, 38092266557621632, 226143953, 226143961, 8, 1440x900 
0x37CA2318, 38092266558282728, 226144018, 226144027, 9, 1440x900 
0x37CA2318, 38092266558934576, 226144078, 226144086, 8, 1440x900 
0x37CA2318, 38092266559586840, 226144147, 226144156, 9, 1440x900 
0x37CA2318, 38092266560264528, 226144213, 226144223, 10, 1440x900 
0x37CA2318, 38092266560917048, 226144283, 226144291, 8, 1440x900 
0x37CA2318, 38092266561577728, 226144348, 226144357, 9, 1440x900 
0x37CA2318, 38092266562229024, 226144413, 226144421, 8, 1440x900 
0x37CA2318, 38092266562908232, 226144482, 226144490, 8, 1440x900 
0x37CA2318, 38092266563559512, 226144547, 226144555, 8, 1440x900 
0x37CA2318, 38092266564219968, 226144613, 226144621, 8, 1440x900 
0x37CA2318, 38092266564879768, 226144678, 226144686, 8, 1440x900 
0x37CA2318, 38092266565540128, 226144743, 226144751, 8, 1440x900 
0x37CA2318, 38092266566202208, 226144807, 226144816, 9, 1440x900 
0x37CA2318, 38092266566871672, 226144875, 226144883, 8, 1440x900 
0x37CA2318, 38092266567529136, 226144942, 226144950, 8, 1440x900 
0x37CA2318, 38092266568180416, 226145008, 226145016, 8, 1440x900 
0x37CA2318, 38092266568851792, 226145077, 226145085, 8, 1440x900 
0x37CA2318, 38092266569496096, 226145136, 226145144, 8, 1440x900 
0x37CA2318, 38092266570168336, 226145208, 226145216, 8, 1440x900 
0x37CA2318, 38092266570829600, 226145273, 226145281, 8, 1440x900 
0x37CA2318, 38092266571485240, 226145339, 226145348, 9, 1440x900 
0x37CA2318, 38092266572147536, 226145403, 226145411, 8, 1440x900 
0x37CA2318, 38092266572817144, 226145472, 226145480, 8, 1440x900 
0x37CA2318, 38092266573461664, 226145533, 226145542, 9, 1440x900 
0x37CA2318, 38092266574129560, 226145603, 226145611, 8, 1440x900 
0x37CA2318, 38092266574790424, 226145667, 226145676, 9, 1440x900 
0x37CA2318, 38092266575452288, 226145733, 226145741, 8, 1440x900 
0x37CA2318, 38092266576108536, 226145797, 226145807, 10, 1440x900 
0x37CA2318, 38092266576764544, 226145869, 226145877, 8, 1440x900 
0x37CA2318, 38092266577441760, 226145933, 226145941, 8, 1440x900 
0x37CA2318, 38092266578111656, 226145998, 226146007, 9, 1440x900 
0x37CA2318, 38092266578771560, 226146069, 226146078, 9, 1440x900 
0x37CA2318, 38092266579417096, 226146132, 226146140, 8, 1440x900 
0x37CA2318, 38092266580087984, 226146198, 226146207, 9, 1440x900 
0x37CA2318, 38092266580754360, 226146264, 226146272, 8, 1440x900 
0x37CA2318, 38092266581407208, 226146328, 226146337, 9, 1440x900 
0x37CA2318, 38092266582061560, 226146393, 226146403, 10, 1440x900 
0x37CA2318, 38092266582722560, 226146458, 226146468, 10, 1440x900 
0x37CA2318, 38092266583388432, 226146528, 226146536, 8, 1440x900 
0x37CA2318, 38092266584049208, 226146592, 226146601, 9, 1440x900 
0x37CA2318, 38092266584710224, 226146658, 226146667, 9, 1440x900 
0x37CA2318, 38092266585363968, 226146728, 226146736, 8, 1440x900 
0x37CA2318, 38092266586025384, 226146792, 226146800, 8, 1440x900 
0x37CA2318, 38092266586689504, 226146857, 226146866, 9, 1440x900 
0x37CA2318, 38092266587351264, 226146927, 226146935, 8, 1440x900 
0x37CA2318, 38092266588011912, 226146992, 226147000, 8, 1440x900 
0x37CA2318, 38092266588673104, 226147058, 226147066, 8, 1440x900 
0x37CA2318, 38092266589332408, 226147122, 226147130, 8, 1440x900 
0x37CA2318, 38092266589994896, 226147188, 226147196, 8, 1440x900 
0x37CA2318, 38092266590656752, 226147253, 226147262, 9, 1440x900 
0x37CA2318, 38092266591314040, 226147317, 226147326, 9, 1440x900 
0x37CA2318, 38092266591981864, 226147388, 226147396, 8, 1440x900 
0x37CA2318, 38092266592634312, 226147452, 226147460, 8, 1440x900 
0x37CA2318, 38092266593301696, 226147517, 226147526, 9, 1440x900 
0x37CA2318, 38092266593962128, 226147588, 226147596, 8, 1440x900 
0x37CA2318, 38092266594615256, 226147653, 226147661, 8, 1440x900 
0x37CA2318, 38092266595275296, 226147718, 226147726, 8, 1440x900 
0x37CA2318, 38092266595936672, 226147783, 226147791, 8, 1440x900 
0x37CA2318, 38092266596598448, 226147852, 226147860, 8, 1440x900 
0x37CA2318, 38092266597260072, 226147913, 226147922, 9, 1440x900 
0x37CA2318, 38092266597921768, 226147983, 226147991, 8, 1440x900 
0x37CA2318, 38092266598583936, 226148047, 226148055, 8, 1440x900 
0x37CA2318, 38092266599235080, 226148114, 226148122, 8, 1440x900 
0x37CA2318, 38092266599896640, 226148177, 226148184, 7, 1440x900 
0x37CA2318, 38092266600567344, 226148244, 226148253, 9, 1440x900 
0x37CA2318, 38092266601276648, 226148312, 226148321, 9, 1440x900 
0x37CA2318, 38092266601936448, 226148378, 226148386, 8, 1440x900 
0x37CA2318, 38092266602606080, 226148448, 226148455, 7, 1440x900 
0x37CA2318, 38092266603262280, 226148512, 226148522, 10, 1440x900 
0x37CA2318, 38092266603930856, 226148583, 226148592, 9, 1440x900 
0x37CA2318, 38092266604587000, 226148647, 226148655, 8, 1440x900 
0x37CA2318, 38092266605248160, 226148712, 226148720, 8, 1440x900 
0x37CA2318, 38092266605908608, 226148777, 226148785, 8, 1440x900 
0x37CA2318, 38092266606567432, 226148843, 226148852, 9, 1440x900 
0x37CA2318, 38092266607236320, 226148913, 226148921, 8, 1440x900 
0x37CA2318, 38092266607905488, 226148978, 226148985, 7, 1440x900 
0x37CA2318, 38092266608565360, 226149042, 226149050, 8, 1440x900 
0x37CA2318, 38092266609225800, 226149106, 226149115, 9, 1440x900 
0x37CA2318, 38092266609884928, 226149172, 226149181, 9, 1440x900 
0x37CA2318, 38092266610554128, 226149239, 226149248, 9, 1440x900 
0x37CA2318, 38092266611213568, 226149308, 226149315, 7, 1440x900 
0x37CA2318, 38092266611883216, 226149376, 226149382, 6, 1440x900 
0x37CA2318, 38092266612542744, 226149442, 226149449, 7, 1440x900 
0x37CA2318, 38092266613212368, 226149507, 226149515, 8, 1440x900 
0x37CA2318, 38092266613862176, 226149572, 226149579, 7, 1440x900 
0x37CA2318, 38092266614541688, 226149639, 226149648, 9, 1440x900 
0x37CA2318, 38092266615201344, 226149704, 226149712, 8, 1440x900 
0x37CA2318, 38092266615860936, 226149773, 226149780, 7, 1440x900 
0x37CA2318, 38092266616530624, 226149842, 226149850, 8, 1440x900 
0x37CA2318, 38092266617181184, 226149903, 226149912, 9, 1440x900 
0x37CA2318, 38092266617850784, 226149972, 226149980, 8, 1440x900 
0x37CA2318, 38092266618495952, 226150037, 226150044, 7, 1440x900 
0x37CA2318, 38092266619157920, 226150102, 226150109, 7, 1440x900 
0x37CA2318, 38092266619828488, 226150171, 226150179, 8, 1440x900 
0x37CA2318, 38092266620489376, 226150236, 226150244, 8, 1440x900 
0x37CA2318, 38092266621150552, 226150303, 226150311, 8, 1440x900 
0x37CA2318, 38092266621804992, 226150373, 226150381, 8, 1440x900 
0x37CA2318, 38092266622474232, 226150434, 226150443, 9, 1440x900 
0x37CA2318, 38092266623142408, 226150503, 226150511, 8, 1440x900 
0x37CA2318, 38092266623804984, 226150567, 226150576, 9, 1440x900 
0x37CA2318, 38092266624458240, 226150638, 226150647, 9, 1440x900 
0x37CA2318, 38092266625121832, 226150698, 226150706, 8, 1440x900 
0x37CA2318, 38092266625780832, 226150768, 226150776, 8, 1440x900 
0x37CA2318, 38092266626447872, 226150833, 226150842, 9, 1440x900 
0x37CA2318, 38092266627109160, 226150898, 226150907, 9, 1440x900 
0x37CA2318, 38092266627769984, 226150968, 226150976, 8, 1440x900 
0x37CA2318, 38092266628421312, 226151032, 226151040, 8, 1440x900 
0x37CA2318, 38092266629091920, 226151097, 226151106, 9, 1440x900 
0x37CA2318, 38092266629759864, 226151168, 226151176, 8, 1440x900 
0x37CA2318, 38092266630410480, 226151227, 226151235, 8, 1440x900 
0x37CA2318, 38092266631080848, 226151298, 226151306, 8, 1440x900 
0x37CA2318, 38092266631731248, 226151363, 226151371, 8, 1440x900 
0x37CA2318, 38092266632390416, 226151423, 226151432, 9, 1440x900 
0x37CA2318, 38092266633052880, 226151493, 226151502, 9, 1440x900 
0x37CA2318, 38092266633703688, 226151558, 226151566, 8, 1440x900 
0x37CA2318, 38092266634374064, 226151628, 226151636, 8, 1440x900 
0x37CA2318, 38092266635037696, 226151693, 226151701, 8, 1440x900 
0x37CA2318, 38092266635689952, 226151758, 226151767, 9, 1440x900 
0x37CA2318, 38092266636366784, 226151828, 226151836, 8, 1440x900 
0x37CA2318, 38092266637680256, 226151958, 226151966, 8, 1440x900 
0x37CA2318, 38092266638351304, 226152023, 226152032, 9, 1440x900 
0x37CA2318, 38092266639006168, 226152093, 226152101, 8, 1440x900 
0x37CA2318, 38092266639666120, 226152158, 226152166, 8, 1440x900 
0x37CA2318, 38092266640327096, 226152222, 226152230, 8, 1440x900 
0x37CA2318, 38092266640984184, 226152287, 226152295, 8, 1440x900 
0x37CA2318, 38092266641659640, 226152353, 226152362, 9, 1440x900 
0x37CA2318, 38092266642312088, 226152418, 226152427, 9, 1440x900 
0x37CA2318, 38092266642983136, 226152488, 226152497, 9, 1440x900 
0x37CA2318, 38092266643642120, 226152552, 226152560, 8, 1440x900 
0x37CA2318, 38092266644293184, 226152617, 226152625, 8, 1440x900 
0x37CA2318, 38092266644966392, 226152683, 226152692, 9, 1440x900 
0x37CA2318, 38092266645618424, 226152752, 226152760, 8, 1440x900 
0x37CA2318, 38092266646290520, 226152818, 226152827, 9, 1440x900 
0x37CA2318, 38092266646955568, 226152882, 226152892, 10, 1440x900 
0x37CA2318, 38092266647617128, 226152948, 226152957, 9, 1440x900 
0x37CA2318, 38092266648277896, 226153018, 226153026, 8, 1440x900 
0x37CA2318, 38092266648930216, 226153078, 226153086, 8, 1440x900 
0x37CA2318, 38092266649601448, 226153147, 226153155, 8, 1440x900 
0x37CA2318, 38092266650262080, 226153213, 226153224, 11, 1440x900 
0x37CA2318, 38092266650916384, 226153282, 226153291, 9, 1440x900 
0x37CA2318, 38092266651587688, 226153347, 226153355, 8, 1440x900 
0x37CA2318, 38092266652247584, 226153413, 226153423, 10, 1440x900 
0x37CA2318, 38092266652905712, 226153477, 226153484, 7, 1440x900 
0x37CA2318, 38092266653560376, 226153547, 226153555, 8, 1440x900 
0x37CA2318, 38092266654218848, 226153608, 226153617, 9, 1440x900 
0x37CA2318, 38092266654869904, 226153672, 226153680, 8, 1440x900 
0x37CA2318, 38092266655541336, 226153743, 226153752, 9, 1440x900 
0x37CA2318, 38092266656208512, 226153808, 226153817, 9, 1440x900 
0x37CA2318, 38092266656857840, 226153873, 226153882, 9, 1440x900 
0x37CA2318, 38092266657530320, 226153943, 226153952, 9, 1440x900 
0x37CA2318, 38092266658182224, 226154008, 226154016, 8, 1440x900 
0x37CA2318, 38092266658843696, 226154077, 226154085, 8, 1440x900 
0x37CA2318, 38092266659506648, 226154142, 226154151, 9, 1440x900 
0x37CA2318, 38092266660166080, 226154208, 226154217, 9, 1440x900 
0x37CA2318, 38092266660834568, 226154272, 226154280, 8, 1440x900 
0x37CA2318, 38092266661494880, 226154338, 226154346, 8, 1440x900 
0x37CA2318, 38092266662145688, 226154402, 226154411, 9, 1440x900 
0x37CA2318, 38092266662807600, 226154468, 226154477, 9, 1440x900 
0x37CA2318, 38092266663467896, 226154538, 226154546, 8, 1440x900 
0x37CA2318, 38092266664128920, 226154602, 226154610, 8, 1440x900 
0x37CA2318, 38092266664781128, 226154667, 226154675, 8, 1440x900 
0x37CA2318, 38092266665460536, 226154733, 226154743, 10, 1440x900 
0x37CA2318, 38092266666111440, 226154798, 226154807, 9, 1440x900 
0x37CA2318, 38092266666769664, 226154868, 226154876, 8, 1440x900 
0x37CA2318, 38092266667431960, 226154933, 226154941, 8, 1440x900 
0x37CA2318, 38092266668102992, 226154998, 226155007, 9, 1440x900 
0x37CA2318, 38092266668759832, 226155067, 226155075, 8, 1440x900 
0x37CA2318, 38092266669420808, 226155132, 226155141, 9, 1440x900 
0x37CA2318, 38092266670083016, 226155198, 226155206, 8, 1440x900 
0x37CA2318, 38092266670751760, 226155263, 226155271, 8, 1440x900 
0x37CA2318, 38092266671401904, 226155328, 226155338, 10, 1440x900 
0x37CA2318, 38092266672063160, 226155392, 226155400, 8, 1440x900 
0x37CA2318, 38092266672723408, 226155457, 226155465, 8, 1440x900 
0x37CA2318, 38092266673382992, 226155523, 226155531, 8, 1440x900 
0x37CA2318, 38092266674036400, 226155588, 226155596, 8, 1440x900 
0x37CA2318, 38092266674707680, 226155658, 226155665, 7, 1440x900 
0x37CA2318, 38092266675358728, 226155723, 226155731, 8, 1440x900 
0x37CA2318, 38092266676020416, 226155787, 226155795, 8, 1440x900 
0x37CA2318, 38092266676690592, 226155858, 226155866, 8, 1440x900 
0x37CA2318, 38092266677342608, 226155923, 226155931, 8, 1440x900 
0x37CA2318, 38092266678013552, 226155988, 226155996, 8, 1440x900 
0x37CA2318, 38092266678682928, 226156054, 226156062, 8, 1440x900 
0x37CA2318, 38092266679334760, 226156123, 226156131, 8, 1440x900 
0x37CA2318, 38092266679996704, 226156192, 226156200, 8, 1440x900 
0x37CA2318, 38092266680649432, 226156258, 226156267, 9, 1440x900 
0x37CA2318, 38092266681328624, 226156318, 226156326, 8, 1440x900 
0x37CA2318, 38092266681990792, 226156387, 226156395, 8, 1440x900 
0x37CA2318, 38092266682650320, 226156458, 226156466, 8, 1440x900 
0x37CA2318, 38092266683301312, 226156522, 226156530, 8, 1440x900 
0x37CA2318, 38092266683962056, 226156583, 226156592, 9, 1440x900 
0x37CA2318, 38092266684625920, 226156652, 226156660, 8, 1440x900 
0x37CA2318, 38092266685292536, 226156718, 226156727, 9, 1440x900 
0x37CA2318, 38092266685960944, 226156782, 226156789, 7, 1440x900 
0x37CA2318, 38092266686620872, 226156847, 226156855, 8, 1440x900 
0x37CA2318, 38092266687280480, 226156913, 226156920, 7, 1440x900 
0x37CA2318, 38092266687942784, 226156981, 226156989, 8, 1440x900 
0x37CA2318, 38092266688601928, 226157047, 226157054, 7, 1440x900 
0x37CA2318, 38092266689265832, 226157113, 226157122, 9, 1440x900 
0x37CA2318, 38092266689924576, 226157178, 226157186, 8, 1440x900 
0x37CA2318, 38092266690586520, 226157246, 226157254, 8, 1440x900 
0x37CA2318, 38092266691243312, 226157308, 226157317, 9, 1440x900 
0x37CA2318, 38092266691907168, 226157377, 226157385, 8, 1440x900 
0x37CA2318, 38092266692569896, 226157453, 226157461, 8, 1440x900 
0x37CA2318, 38092266693228656, 226157507, 226157515, 8, 1440x900 
0x37CA2318, 38092266693891856, 226157582, 226157590, 8, 1440x900 
0x37CA2318, 38092266694552736, 226157643, 226157652, 9, 1440x900 
0x37CA2318, 38092266695216648, 226157714, 226157723, 9, 1440x900 
0x37CA2318, 38092266695885104, 226157773, 226157781, 8, 1440x900 
0x37CA2318, 38092266696535632, 226157841, 226157851, 10, 1440x900 
0x37CA2318, 38092266697201704, 226157907, 226157914, 7, 1440x900 
0x37CA2318, 38092266697871936, 226157976, 226157984, 8, 1440x900 
0x37CA2318, 38092266698522568, 226158037, 226158045, 8, 1440x900 
0x37CA2318, 38092266699176320, 226158103, 226158111, 8, 1440x900 
0x37CA2318, 38092266699845984, 226158171, 226158179, 8, 1440x900 
0x37CA2318, 38092266700509728, 226158237, 226158244, 7, 1440x900 
0x37CA2318, 38092266701168016, 226158302, 226158311, 9, 1440x900 
0x37CA2318, 38092266701837328, 226158372, 226158380, 8, 1440x900 
0x37CA2318, 38092266702497496, 226158437, 226158445, 8, 1440x900 
0x37CA2318, 38092266703148224, 226158502, 226158509, 7, 1440x900 
0x37CA2318, 38092266703809472, 226158567, 226158575, 8, 1440x900 
0x37CA2318, 38092266704479112, 226158633, 226158642, 9, 1440x900 
0x37CA2318, 38092266705130072, 226158702, 226158710, 8, 1440x900 
0x37CA2318, 38092266705795992, 226158767, 226158776, 9, 1440x900 
0x37CA2318, 38092266706446824, 226158833, 226158842, 9, 1440x900 
0x37CA2318, 38092266707126088, 226158902, 226158911, 9, 1440x900 
0x37CA2318, 38092266707770648, 226158963, 226158971, 8, 1440x900 
0x37CA2318, 38092266708441368, 226159032, 226159040, 8, 1440x900 
0x37CA2318, 38092266709102736, 226159097, 226159105, 8, 1440x900 
0x37CA2318, 38092266709763976, 226159163, 226159172, 9, 1440x900 
0x37CA2318, 38092266710424704, 226159229, 226159239, 10, 1440x900 
0x37CA2318, 38092266711084736, 226159299, 226159307, 8, 1440x900 
0x37CA2318, 38092266711745736, 226159362, 226159371, 9, 1440x900 
0x37CA2318, 38092266712408112, 226159433, 226159441, 8, 1440x900 
0x37CA2318, 38092266713060064, 226159493, 226159502, 9, 1440x900 
0x37CA2318, 38092266713736752, 226159563, 226159571, 8, 1440x900 
0x37CA2318, 38092266714388280, 226159627, 226159635, 8, 1440x900 
0x37CA2318, 38092266715040776, 226159692, 226159700, 8, 1440x900 
0x37CA2318, 38092266715701448, 226159758, 226159767, 9, 1440x900 
0x37CA2318, 38092266716374208, 226159828, 226159836, 8, 1440x900 
0x37CA2318, 38092266717033416, 226159892, 226159901, 9, 1440x900 
0x37CA2318, 38092266717695760, 226159958, 226159966, 8, 1440x900 
0x37CA2318, 38092266719017352, 226160092, 226160101, 9, 1440x900 
0x37CA2318, 38092266719677648, 226160158, 226160166, 8, 1440x900 
0x37CA2318, 38092266720339496, 226160222, 226160231, 9, 1440x900 
0x37CA2318, 38092266720999792, 226160287, 226160296, 9, 1440x900 
0x37CA2318, 38092266721661680, 226160356, 226160364, 8, 1440x900 
0x37CA2318, 38092266722321736, 226160423, 226160431, 8, 1440x900 
0x37CA2318, 38092266722873032, 226160475, 226160484, 9, 1440x900 
0x37CA2318, 38092266723459640, 226160532, 226160540, 8, 1440x900 
0x37CA2318, 38092266724119872, 226160598, 226160606, 8, 1440x900 
0x37CA2318, 38092266724778048, 226160663, 226160672, 9, 1440x900 
0x37CA2318, 38092266725528112, 226160737, 226160745, 8, 1440x900 
0x37CA2318, 38092266726091952, 226160796, 226160803, 7, 1440x900 
0x37CA2318, 38092266726759448, 226160862, 226160870, 8, 1440x900 
0x37CA2318, 38092266727419320, 226160928, 226160935, 7, 1440x900 
0x37CA2318, 38092266728080888, 226160993, 226161002, 9, 1440x900 
0x37CA2318, 38092266728940048, 226161081, 226161089, 8, 1440x900 
0x37CA2318, 38092266729592008, 226161143, 226161151, 8, 1440x900 
0x37CA2318, 38092266730262712, 226161212, 226161220, 8, 1440x900 
0x37CA2318, 38092266730869344, 226161277, 226161285, 8, 1440x900 
0x37CA2318, 38092266731583600, 226161357, 226161368, 11, 1440x900 
0x37CA2318, 38092266732860048, 226161472, 226161489, 17, 1440x900 
0x37CA2318, 38092266733167768, 226161544, 226161555, 11, 1440x900 
0x37CA2318, 38092266733775840, 226161563, 226161577, 14, 1440x900 
0x37CA2318, 38092266734346992, 226161622, 226161630, 8, 1440x900 
0x37CA2318, 38092266735069856, 226161697, 226161705, 8, 1440x900 
0x37CA2318, 38092266735706224, 226161757, 226161765, 8, 1440x900 
0x37CA2318, 38092266736346144, 226161819, 226161827, 8, 1440x900 
0x37CA2318, 38092266737003400, 226161888, 226161895, 7, 1440x900 
0x37CA2318, 38092266737671760, 226161952, 226161959, 7, 1440x900 
0x37CA2318, 38092266738325040, 226162017, 226162025, 8, 1440x900 
0x37CA2318, 38092266738989040, 226162086, 226162094, 8, 1440x900 
0x37CA2318, 38092266739846736, 226162173, 226162182, 9, 1440x900 
0x37CA2318, 38092266740467832, 226162232, 226162241, 9, 1440x900 
0x37CA2318, 38092266741136488, 226162301, 226162324, 23, 1440x900 
0x37CA2318, 38092266741657128, 226162352, 226162360, 8, 1440x900 
0x37CA2318, 38092266742284304, 226162412, 226162421, 9, 1440x900 
0x37CA2318, 38092266743145952, 226162502, 226162509, 7, 1440x900 
0x37CA2318, 38092266743797784, 226162566, 226162573, 7, 1440x900 
0x37CA2318, 38092266744456824, 226162630, 226162656, 26, 1440x900 
0x37CA2318, 38092266744970136, 226162682, 226162689, 7, 1440x900 
0x37CA2318, 38092266745598936, 226162746, 226162753, 7, 1440x900 
0x37CA2318, 38092266746261600, 226162812, 226162819, 7, 1440x900 
0x37CA2318, 38092266747119952, 226162897, 226162905, 8, 1440x900 
0x37CA2318, 38092266747777752, 226162968, 226162976, 8, 1440x900 
0x37CA2318, 38092266748241672, 226163008, 226163015, 7, 1440x900 
0x37CA2318, 38092266748906176, 226163077, 226163084, 7, 1440x900 
0x37CA2318, 38092266749567392, 226163147, 226163155, 8, 1440x900 
0x37CA2318, 38092266750241632, 226163212, 226163220, 8, 1440x900 
0x37CA2318, 38092266750900904, 226163277, 226163285, 8, 1440x900 
0x37CA2318, 38092266751563400, 226163348, 226163356, 8, 1440x900 
0x37CA2318, 38092266752230832, 226163412, 226163419, 7, 1440x900 
0x37CA2318, 38092266752882312, 226163479, 226163487, 8, 1440x900 
0x37CA2318, 38092266753541680, 226163543, 226163551, 8, 1440x900 
0x37CA2318, 38092266754201752, 226163607, 226163616, 9, 1440x900 
0x37CA2318, 38092266755520656, 226163738, 226163747, 9, 1440x900 
0x37CA2318, 38092266756180688, 226163802, 226163810, 8, 1440x900 
0x37CA2318, 38092266756841712, 226163872, 226163879, 7, 1440x900 
0x37CA2318, 38092266757495856, 226163937, 226163945, 8, 1440x900 
0x37CA2318, 38092266758158976, 226164003, 226164012, 9, 1440x900 
0x37CA2318, 38092266758830296, 226164073, 226164082, 9, 1440x900 
0x37CA2318, 38092266759492784, 226164138, 226164146, 8, 1440x900 
0x37CA2318, 38092266760150064, 226164201, 226164209, 8, 1440x900 
0x37CA2318, 38092266760814368, 226164269, 226164279, 10, 1440x900 
0x37CA2318, 38092266761469000, 226164333, 226164340, 7, 1440x900 
0x37CA2318, 38092266762401480, 226164428, 226164436, 8, 1440x900 
0x37CA2318, 38092266762787872, 226164463, 226164471, 8, 1440x900 
0x37CA2318, 38092266763445024, 226164531, 226164539, 8, 1440x900 
0x37CA2318, 38092266764306696, 226164617, 226164624, 7, 1440x900 
0x37CA2318, 38092266764959552, 226164682, 226164690, 8, 1440x900 
0x37CA2318, 38092266765428256, 226164727, 226164735, 8, 1440x900 
0x37CA2318, 38092266766092696, 226164796, 226164804, 8, 1440x900 
0x37CA2318, 38092266766746112, 226164863, 226164870, 7, 1440x900 
0x37CA2318, 38092266767598456, 226164947, 226164957, 10, 1440x900 
0x37CA2318, 38092266768291360, 226165032, 226165040, 8, 1440x900 
0x37CA2318, 38092266768787144, 226165063, 226165071, 8, 1440x900 
0x37CA2318, 38092266769396144, 226165123, 226165132, 9, 1440x900 
0x37CA2318, 38092266770055832, 226165192, 226165199, 7, 1440x900 
0x37CA2318, 38092266770724960, 226165258, 226165265, 7, 1440x900 
0x37CA2318, 38092266771404200, 226165328, 226165335, 7, 1440x900 
0x37CA2318, 38092266772049160, 226165389, 226165397, 8, 1440x900 
0x37CA2318, 38092266772714992, 226165458, 226165466, 8, 1440x900 
0x37CA2318, 38092266773375200, 226165523, 226165530, 7, 1440x900 
0x37CA2318, 38092266774040792, 226165592, 226165602, 10, 1440x900 
0x37CA2318, 38092266774859488, 226165673, 226165696, 23, 1440x900 
0x37CA2318, 38092266775477880, 226165742, 226165768, 26, 1440x900 
0x37CA2318, 38092266776128096, 226165798, 226165824, 26, 1440x900 
0x37CA2318, 38092266776708688, 226165870, 226165879, 9, 1440x900 
0x37CA2318, 38092266777460456, 226165930, 226165941, 11, 1440x900 
0x37CA2318, 38092266778025736, 226166005, 226166012, 7, 1440x900 
0x37CA2318, 38092266778795008, 226166064, 226166073, 9, 1440x900 
0x37CA2318, 38092266779356552, 226166121, 226166146, 25, 1440x900 
0x37CA2318, 38092266780174456, 226166205, 226166226, 21, 1440x900 
0x37CA2318, 38092266780856288, 226166270, 226166280, 10, 1440x900 
0x37CA2318, 38092266781443928, 226166339, 226166352, 13, 1440x900 
0x37CA2318, 38092266782190280, 226166403, 226166412, 9, 1440x900 
0x37CA2318, 38092266782744464, 226166459, 226166484, 25, 1440x900 
0x37CA2318, 38092266783451752, 226166530, 226166549, 19, 1440x900 
0x37CA2318, 38092266784078312, 226166594, 226166601, 7, 1440x900 
0x37CA2318, 38092266784761808, 226166662, 226166669, 7, 1440x900 
0x37CA2318, 38092266785335368, 226166717, 226166724, 7, 1440x900 
0x37CA2318, 38092266785993288, 226166784, 226166791, 7, 1440x900 
0x37CA2318, 38092266786665320, 226166854, 226166861, 7, 1440x900 
0x37CA2318, 38092266787327208, 226166918, 226166925, 7, 1440x900 
0x37CA2318, 38092266787986112, 226166986, 226166992, 6, 1440x900 
0x37CA2318, 38092266788912000, 226167077, 226167084, 7, 1440x900 
0x37CA2318, 38092266789440440, 226167132, 226167138, 6, 1440x900 
0x37CA2318, 38092266789964856, 226167183, 226167189, 6, 1440x900 
0x37CA2318, 38092266790624264, 226167247, 226167255, 8, 1440x900 
0x37CA2318, 38092266791448768, 226167332, 226167338, 6, 1440x900 
0x37CA2318, 38092266791944928, 226167382, 226167388, 6, 1440x900 
0x37CA2318, 38092266792611224, 226167448, 226167455, 7, 1440x900 
0x37CA2318, 38092266793481368, 226167542, 226167556, 14, 1440x900 
0x37CA2318, 38092266794012024, 226167587, 226167611, 24, 1440x900 
0x37CA2318, 38092266794797056, 226167664, 226167676, 12, 1440x900 
0x37CA2318, 38092266795284008, 226167714, 226167723, 9, 1440x900 
0x37CA2318, 38092266795937920, 226167779, 226167786, 7, 1440x900 
0x37CA2318, 38092266796600968, 226167847, 226167854, 7, 1440x900 
0x37CA2318, 38092266797225448, 226167908, 226167915, 7, 1440x900 
0x37CA2318, 38092266797918248, 226167979, 226167987, 8, 1440x900 
0x37CA2318, 38092266798548368, 226168038, 226168046, 8, 1440x900 
0x37CA2318, 38092266799218128, 226168113, 226168122, 9, 1440x900 
0x37CA2318, 38092266800033568, 226168220, 226168228, 8, 1440x900 
0x37CA2318, 38092266800527168, 226168237, 226168245, 8, 1440x900 
0x37CA2318, 38092266801186152, 226168303, 226168311, 8, 1440x900 
0x37CA2318, 38092266802041208, 226168392, 226168412, 20, 1440x900 
0x37CA2318, 38092266802517320, 226168437, 226168445, 8, 1440x900 
0x37CA2318, 38092266803177832, 226168502, 226168510, 8, 1440x900 
0x37CA2318, 38092266803846464, 226168568, 226168576, 8, 1440x900 
0x37CA2318, 38092266804507800, 226168637, 226168645, 8, 1440x900 
0x37CA2318, 38092266805168512, 226168702, 226168710, 8, 1440x900 
0x37CA2318, 38092266805828384, 226168768, 226168777, 9, 1440x900 
0x37CA2318, 38092266806485608, 226168836, 226168843, 7, 1440x900 
0x37CA2318, 38092266807148392, 226168899, 226168907, 8, 1440x900 
0x37CA2318, 38092266807808992, 226168968, 226168974, 6, 1440x900 
0x37CA2318, 38092266808468728, 226169033, 226169041, 8, 1440x900 
0x37CA2318, 38092266809161424, 226169101, 226169110, 9, 1440x900 
0x37CA2318, 38092266809818808, 226169167, 226169176, 9, 1440x900 
0x37CA2318, 38092266810454480, 226169234, 226169241, 7, 1440x900 
0x37CA2318, 38092266811114464, 226169297, 226169306, 9, 1440x900 
0x37CA2318, 38092266811774480, 226169363, 226169371, 8, 1440x900 
0x37CA2318, 38092266812434080, 226169430, 226169438, 8, 1440x900 
0x37CA2318, 38092266813094904, 226169496, 226169503, 7, 1440x900 
0x37CA2318, 38092266813751328, 226169562, 226169569, 7, 1440x900 
0x37CA2318, 38092266814420752, 226169632, 226169639, 7, 1440x900 
0x37CA2318, 38092266815082176, 226169698, 226169707, 9, 1440x900 
0x37CA2318, 38092266815742904, 226169763, 226169771, 8, 1440x900 
0x37CA2318, 38092266816411136, 226169832, 226169840, 8, 1440x900 
0x37CA2318, 38092266817727912, 226169962, 226169971, 9, 1440x900 
0x37CA2318, 38092266818388256, 226170023, 226170031, 8, 1440x900 
0x37CA2318, 38092266819039872, 226170093, 226170100, 7, 1440x900 
0x37CA2318, 38092266819700776, 226170156, 226170163, 7, 1440x900 
0x37CA2318, 38092266820500952, 226170237, 226170245, 8, 1440x900 
0x37CA2318, 38092266821023720, 226170288, 226170296, 8, 1440x900 
0x37CA2318, 38092266821687720, 226170358, 226170367, 9, 1440x900 
0x37CA2318, 38092266822358456, 226170424, 226170433, 9, 1440x900 
0x37CA2318, 38092266823009312, 226170487, 226170495, 8, 1440x900 
0x37CA2318, 38092266823676912, 226170558, 226170566, 8, 1440x900 
0x37CA2318, 38092266824336000, 226170622, 226170631, 9, 1440x900 
0x37CA2318, 38092266825002008, 226170687, 226170696, 9, 1440x900 
0x37CA2318, 38092266825660640, 226170757, 226170765, 8, 1440x900 
0x37CA2318, 38092266826322784, 226170823, 226170831, 8, 1440x900 
0x37CA2318, 38092266826982384, 226170888, 226170896, 8, 1440x900 
0x37CA2318, 38092266827644424, 226170953, 226170961, 8, 1440x900 
0x37CA2318, 38092266828303896, 226171018, 226171027, 9, 1440x900 
0x37CA2318, 38092266828962216, 226171088, 226171096, 8, 1440x900 
0x37CA2318, 38092266829630712, 226171153, 226171161, 8, 1440x900 
0x37CA2318, 38092266830290576, 226171222, 226171230, 8, 1440x900 
0x37CA2318, 38092266830954488, 226171287, 226171295, 8, 1440x900 
0x37CA2318, 38092266831613600, 226171352, 226171360, 8, 1440x900 
0x37CA2318, 38092266832269232, 226171412, 226171420, 8, 1440x900 
0x37CA2318, 38092266832928392, 226171478, 226171486, 8, 1440x900 
0x37CA2318, 38092266833596112, 226171547, 226171556, 9, 1440x900 
0x37CA2318, 38092266834284200, 226171619, 226171629, 10, 1440x900 
0x37CA2318, 38092266834980048, 226171683, 226171691, 8, 1440x900 
0x37CA2318, 38092266835602816, 226171746, 226171760, 14, 1440x900 
0x37CA2318, 38092266836267624, 226171812, 226171819, 7, 1440x900 
0x37CA2318, 38092266836924416, 226171877, 226171885, 8, 1440x900 
0x37CA2318, 38092266837595512, 226171943, 226171951, 8, 1440x900 
0x37CA2318, 38092266838254576, 226172012, 226172019, 7, 1440x900 
0x37CA2318, 38092266838921224, 226172078, 226172086, 8, 1440x900 
0x37CA2318, 38092266839574008, 226172142, 226172150, 8, 1440x900 
0x37CA2318, 38092266840203400, 226172207, 226172216, 9, 1440x900 
0x37CA2318, 38092266840896608, 226172277, 226172284, 7, 1440x900 
0x37CA2318, 38092266841561632, 226172342, 226172349, 7, 1440x900 
0x37CA2318, 38092266842223400, 226172408, 226172417, 9, 1440x900 
0x37CA2318, 38092266842883376, 226172473, 226172482, 9, 1440x900 
0x37CA2318, 38092266843544008, 226172542, 226172551, 9, 1440x900 
0x37CA2318, 38092266844203112, 226172607, 226172615, 8, 1440x900 
0x37CA2318, 38092266844927864, 226172678, 226172686, 8, 1440x900 
0x37CA2318, 38092266845596248, 226172747, 226172754, 7, 1440x900 
0x37CA2318, 38092266846161200, 226172807, 226172815, 8, 1440x900 
0x37CA2318, 38092266846892056, 226172877, 226172885, 8, 1440x900 
0x37CA2318, 38092266847515592, 226172937, 226172944, 7, 1440x900 
0x37CA2318, 38092266848171544, 226173002, 226173009, 7, 1440x900 
0x37CA2318, 38092266848837000, 226173072, 226173080, 8, 1440x900 
0x37CA2318, 38092266849547584, 226173147, 226173154, 7, 1440x900 
0x37CA2318, 38092266850192736, 226173207, 226173215, 8, 1440x900 
0x37CA2318, 38092266850886648, 226173278, 226173287, 9, 1440x900 
0x37CA2318, 38092266851512704, 226173338, 226173345, 7, 1440x900 
0x37CA2318, 38092266852173808, 226173402, 226173409, 7, 1440x900 
0x37CA2318, 38092266852840120, 226173469, 226173477, 8, 1440x900 
0x37CA2318, 38092266853500968, 226173538, 226173545, 7, 1440x900 
0x37CA2318, 38092266854159480, 226173601, 226173613, 12, 1440x900 
0x37CA2318, 38092266854820464, 226173678, 226173685, 7, 1440x900 
0x37CA2318, 38092266855536216, 226173742, 226173753, 11, 1440x900 
0x37CA2318, 38092266856139808, 226173797, 226173806, 9, 1440x900 
0x37CA2318, 38092266856769688, 226173862, 226173870, 8, 1440x900 
0x37CA2318, 38092266857429120, 226173928, 226173936, 8, 1440x900 
0x37CA2318, 38092266858089824, 226173992, 226173999, 7, 1440x900 
0x37CA2318, 38092266858750584, 226174058, 226174067, 9, 1440x900 
0x37CA2318, 38092266859410800, 226174127, 226174134, 7, 1440x900 
0x37CA2318, 38092266860071088, 226174192, 226174199, 7, 1440x900 
0x37CA2318, 38092266860735056, 226174258, 226174266, 8, 1440x900 
0x37CA2318, 38092266861396808, 226174327, 226174335, 8, 1440x900 
0x37CA2318, 38092266862056904, 226174392, 226174400, 8, 1440x900 
0x37CA2318, 38092266862724688, 226174458, 226174465, 7, 1440x900 
0x37CA2318, 38092266863383672, 226174523, 226174531, 8, 1440x900 
0x37CA2318, 38092266864044352, 226174588, 226174597, 9, 1440x900 
0x37CA2318, 38092266864704616, 226174657, 226174664, 7, 1440x900 
0x37CA2318, 38092266865363704, 226174722, 226174730, 8, 1440x900 
0x37CA2318, 38092266866023688, 226174787, 226174795, 8, 1440x900 
0x37CA2318, 38092266866691520, 226174853, 226174861, 8, 1440x900 
0x37CA2318, 38092266867356824, 226174922, 226174929, 7, 1440x900 
0x37CA2318, 38092266868028456, 226174987, 226174995, 8, 1440x900 
0x37CA2318, 38092266868691608, 226175053, 226175061, 8, 1440x900 
0x37CA2318, 38092266869332264, 226175117, 226175125, 8, 1440x900 
0x37CA2318, 38092266869992256, 226175187, 226175194, 7, 1440x900 
0x37CA2318, 38092266870652488, 226175252, 226175258, 6, 1440x900 
0x37CA2318, 38092266871312216, 226175318, 226175325, 7, 1440x900 
0x37CA2318, 38092266871972480, 226175382, 226175390, 8, 1440x900 
0x37CA2318, 38092266872632048, 226175447, 226175455, 8, 1440x900 
0x37CA2318, 38092266873292688, 226175513, 226175521, 8, 1440x900 
0x37CA2318, 38092266873955648, 226175582, 226175590, 8, 1440x900 
0x37CA2318, 38092266874618792, 226175648, 226175656, 8, 1440x900 
0x37CA2318, 38092266875287144, 226175718, 226175727, 9, 1440x900 
0x37CA2318, 38092266875943504, 226175783, 226175792, 9, 1440x900 
0x37CA2318, 38092266876602928, 226175848, 226175857, 9, 1440x900 
0x37CA2318, 38092266877264408, 226175918, 226175926, 8, 1440x900 
0x37CA2318, 38092266877923824, 226175983, 226175992, 9, 1440x900 
0x37CA2318, 38092266878577720, 226176047, 226176055, 8, 1440x900 
0x37CA2318, 38092266879239184, 226176111, 226176119, 8, 1440x900 
0x37CA2318, 38092266879907176, 226176177, 226176185, 8, 1440x900 
0x37CA2318, 38092266880571808, 226176247, 226176254, 7, 1440x900 
0x37CA2318, 38092266881224088, 226176307, 226176315, 8, 1440x900 
0x37CA2318, 38092266881882304, 226176373, 226176380, 7, 1440x900 
0x37CA2318, 38092266882542272, 226176442, 226176449, 7, 1440x900 
0x37CA2318, 38092266883202520, 226176508, 226176515, 7, 1440x900 
0x37CA2318, 38092266883862304, 226176573, 226176580, 7, 1440x900 
0x37CA2318, 38092266884530296, 226176638, 226176646, 8, 1440x900 
0x37CA2318, 38092266885190080, 226176703, 226176711, 8, 1440x900 
0x37CA2318, 38092266885856816, 226176777, 226176785, 8, 1440x900 
0x37CA2318, 38092266886519296, 226176838, 226176845, 7, 1440x900 
0x37CA2318, 38092266887180864, 226176906, 226176914, 8, 1440x900 
0x37CA2318, 38092266887844112, 226176972, 226176980, 8, 1440x900 
0x37CA2318, 38092266888503224, 226177038, 226177045, 7, 1440x900 
0x37CA2318, 38092266889169160, 226177103, 226177112, 9, 1440x900 
0x37CA2318, 38092266890587168, 226177248, 226177255, 7, 1440x900 
0x37CA2318, 38092266891172248, 226177303, 226177310, 7, 1440x900 
0x37CA2318, 38092266891995224, 226177387, 226177394, 7, 1440x900 
0x37CA2318, 38092266892655280, 226177453, 226177460, 7, 1440x900 
0x37CA2318, 38092266893501672, 226177550, 226177576, 26, 1440x900 
0x37CA2318, 38092266893934640, 226177588, 226177610, 22, 1440x900 
0x37CA2318, 38092266894514688, 226177638, 226177645, 7, 1440x900 
0x37CA2318, 38092266895136368, 226177698, 226177705, 7, 1440x900 
0x37CA2318, 38092266895798184, 226177769, 226177776, 7, 1440x900 
0x37CA2318, 38092266896462248, 226177838, 226177847, 9, 1440x900 
0x37CA2318, 38092266897124304, 226177904, 226177916, 12, 1440x900 
0x37CA2318, 38092266897810192, 226177969, 226177975, 6, 1440x900 
0x37CA2318, 38092266898443592, 226178028, 226178036, 8, 1440x900 
0x37CA2318, 38092266899127056, 226178097, 226178105, 8, 1440x900 
0x37CA2318, 38092266899762864, 226178162, 226178169, 7, 1440x900 
0x37CA2318, 38092266900425200, 226178228, 226178235, 7, 1440x900 
0x37CA2318, 38092266901088712, 226178298, 226178306, 8, 1440x900 
0x37CA2318, 38092266901754208, 226178362, 226178371, 9, 1440x900 
0x37CA2318, 38092266902407472, 226178433, 226178441, 8, 1440x900 
0x37CA2318, 38092266903069624, 226178492, 226178500, 8, 1440x900 
0x37CA2318, 38092266903735512, 226178562, 226178571, 9, 1440x900 
0x37CA2318, 38092266904399136, 226178627, 226178636, 9, 1440x900 
0x37CA2318, 38092266905054352, 226178692, 226178699, 7, 1440x900 
0x37CA2318, 38092266905729808, 226178761, 226178769, 8, 1440x900 
0x37CA2318, 38092266906372832, 226178823, 226178831, 8, 1440x900 
0x37CA2318, 38092266907033752, 226178887, 226178895, 8, 1440x900 
0x37CA2318, 38092266907688360, 226178957, 226178965, 8, 1440x900 
0x37CA2318, 38092266908349096, 226179022, 226179028, 6, 1440x900 
0x37CA2318, 38092266909008688, 226179087, 226179094, 7, 1440x900 
0x37CA2318, 38092266909669088, 226179153, 226179160, 7, 1440x900 
0x37CA2318, 38092266910327744, 226179217, 226179225, 8, 1440x900 
0x37CA2318, 38092266910994296, 226179283, 226179291, 8, 1440x900 
0x37CA2318, 38092266911652624, 226179349, 226179357, 8, 1440x900 
0x37CA2318, 38092266912307872, 226179417, 226179424, 7, 1440x900 
0x37CA2318, 38092266912978064, 226179483, 226179491, 8, 1440x900 
0x37CA2318, 38092266913646128, 226179551, 226179558, 7, 1440x900 
0x37CA2318, 38092266914298024, 226179617, 226179624, 7, 1440x900 
0x37CA2318, 38092266914971264, 226179684, 226179693, 9, 1440x900 
0x37CA2318, 38092266915834008, 226179773, 226179781, 8, 1440x900 
0x37CA2318, 38092266916488344, 226179837, 226179846, 9, 1440x900 
0x37CA2318, 38092266917150400, 226179903, 226179910, 7, 1440x900 
0x37CA2318, 38092266917803320, 226179966, 226179974, 8, 1440x900 
0x37CA2318, 38092266918271472, 226180014, 226180020, 6, 1440x900 
0x37CA2318, 38092266918935984, 226180082, 226180090, 8, 1440x900 
0x37CA2318, 38092266919594864, 226180147, 226180154, 7, 1440x900 
0x37CA2318, 38092266920256544, 226180213, 226180220, 7, 1440x900 
0x37CA2318, 38092266920916976, 226180277, 226180285, 8, 1440x900 
0x37CA2318, 38092266921587216, 226180348, 226180355, 7, 1440x900 
0x37CA2318, 38092266922235928, 226180413, 226180421, 8, 1440x900 
0x37CA2318, 38092266922891064, 226180473, 226180481, 8, 1440x900 
0x37CA2318, 38092266923562224, 226180543, 226180551, 8, 1440x900 
0x37CA2318, 38092266924276832, 226180612, 226180620, 8, 1440x900 
0x37CA2318, 38092266924925328, 226180678, 226180686, 8, 1440x900 
0x37CA2318, 38092266925587160, 226180746, 226180753, 7, 1440x900 
0x37CA2318, 38092266926244504, 226180808, 226180816, 8, 1440x900 
0x37CA2318, 38092266926908064, 226180878, 226180885, 7, 1440x900 
0x37CA2318, 38092266927568936, 226180943, 226180951, 8, 1440x900 
0x37CA2318, 38092266928238072, 226181013, 226181020, 7, 1440x900 
0x37CA2318, 38092266928897840, 226181078, 226181085, 7, 1440x900 
0x37CA2318, 38092266929562712, 226181143, 226181152, 9, 1440x900 
0x37CA2318, 38092266930223000, 226181213, 226181221, 8, 1440x900 
0x37CA2318, 38092266930885736, 226181278, 226181286, 8, 1440x900 
0x37CA2318, 38092266931542648, 226181343, 226181351, 8, 1440x900 
0x37CA2318, 38092266932213384, 226181413, 226181421, 8, 1440x900 
0x37CA2318, 38092266932868016, 226181472, 226181481, 9, 1440x900 
0x37CA2318, 38092266933532408, 226181543, 226181550, 7, 1440x900 
0x37CA2318, 38092266934192328, 226181608, 226181616, 8, 1440x900 
0x37CA2318, 38092266934857160, 226181673, 226181682, 9, 1440x900 
0x37CA2318, 38092266935515568, 226181742, 226181750, 8, 1440x900 
0x37CA2318, 38092266936176728, 226181808, 226181816, 8, 1440x900 
0x37CA2318, 38092266936835840, 226181873, 226181881, 8, 1440x900 
0x37CA2318, 38092266938162832, 226182002, 226182009, 7, 1440x900 
0x37CA2318, 38092266938825032, 226182073, 226182081, 8, 1440x900 
0x37CA2318, 38092266939484056, 226182139, 226182147, 8, 1440x900 
0x37CA2318, 38092266940144640, 226182202, 226182211, 9, 1440x900 
0x37CA2318, 38092266940802024, 226182267, 226182274, 7, 1440x900 
0x37CA2318, 38092266941498912, 226182334, 226182343, 9, 1440x900 
0x37CA2318, 38092266942158064, 226182402, 226182409, 7, 1440x900 
0x37CA2318, 38092266942780200, 226182463, 226182471, 8, 1440x900 
0x37CA2318, 38092266943445008, 226182537, 226182547, 10, 1440x900 
0x37CA2318, 38092266944104232, 226182597, 226182604, 7, 1440x900 
0x37CA2318, 38092266944760024, 226182663, 226182670, 7, 1440x900 
0x37CA2318, 38092266945421224, 226182727, 226182735, 8, 1440x900 
0x37CA2318, 38092266946086312, 226182798, 226182806, 8, 1440x900 
0x37CA2318, 38092266946746304, 226182863, 226182871, 8, 1440x900 
0x37CA2318, 38092266947405696, 226182932, 226182940, 8, 1440x900 
0x37CA2318, 38092266948196488, 226183007, 226183014, 7, 1440x900 
0x37CA2318, 38092266948763136, 226183062, 226183069, 7, 1440x900 
0x37CA2318, 38092266949426952, 226183128, 226183136, 8, 1440x900 
0x37CA2318, 38092266950091968, 226183198, 226183207, 9, 1440x900 
0x37CA2318, 38092266950751408, 226183264, 226183271, 7, 1440x900 
0x37CA2318, 38092266951430000, 226183334, 226183341, 7, 1440x900 
0x37CA2318, 38092266952071840, 226183393, 226183399, 6, 1440x900 
0x37CA2318, 38092266952735880, 226183461, 226183468, 7, 1440x900 
0x37CA2318, 38092266953395880, 226183527, 226183535, 8, 1440x900 
0x37CA2318, 38092266954055864, 226183592, 226183601, 9, 1440x900 
0x37CA2318, 38092266954715952, 226183657, 226183665, 8, 1440x900 
0x37CA2318, 38092266955373424, 226183723, 226183730, 7, 1440x900 
0x37CA2318, 38092266956034576, 226183788, 226183796, 8, 1440x900 
0x37CA2318, 38092266956699128, 226183856, 226183863, 7, 1440x900 
0x37CA2318, 38092266957359208, 226183922, 226183929, 7, 1440x900 
0x37CA2318, 38092266958019808, 226183987, 226183994, 7, 1440x900 
0x37CA2318, 38092266958688528, 226184057, 226184065, 8, 1440x900 
0x37CA2318, 38092266959351952, 226184122, 226184131, 9, 1440x900 
0x37CA2318, 38092266960028296, 226184190, 226184199, 9, 1440x900 
0x37CA2318, 38092266960678232, 226184253, 226184260, 7, 1440x900 
0x37CA2318, 38092266961344304, 226184322, 226184330, 8, 1440x900 
0x37CA2318, 38092266962007152, 226184387, 226184395, 8, 1440x900 
0x37CA2318, 38092266962659832, 226184452, 226184459, 7, 1440x900 
0x37CA2318, 38092266963319584, 226184519, 226184527, 8, 1440x900 
0x37CA2318, 38092266963979568, 226184584, 226184591, 7, 1440x900 
0x37CA2318, 38092266964642208, 226184648, 226184655, 7, 1440x900 
0x37CA2318, 38092266965300752, 226184718, 226184725, 7, 1440x900 
0x37CA2318, 38092266965960848, 226184786, 226184794, 8, 1440x900 
0x37CA2318, 38092266966641064, 226184854, 226184861, 7, 1440x900 
0x37CA2318, 38092266967282344, 226184916, 226184923, 7, 1440x900 
0x37CA2318, 38092266967941936, 226184981, 226184988, 7, 1440x900 
0x37CA2318, 38092266968601600, 226185046, 226185053, 7, 1440x900 
0x37CA2318, 38092266969266400, 226185114, 226185121, 7, 1440x900 
0x37CA2318, 38092266969924880, 226185178, 226185185, 7, 1440x900 
0x37CA2318, 38092266970582960, 226185243, 226185251, 8, 1440x900 
0x37CA2318, 38092266971243856, 226185308, 226185316, 8, 1440x900 
0x37CA2318, 38092266971904632, 226185377, 226185384, 7, 1440x900 
0x37CA2318, 38092266972564624, 226185442, 226185449, 7, 1440x900 
0x37CA2318, 38092266973228864, 226185513, 226185523, 10, 1440x900 
0x37CA2318, 38092266973886200, 226185574, 226185582, 8, 1440x900 
0x37CA2318, 38092266974544128, 226185639, 226185647, 8, 1440x900 
0x37CA2318, 38092266975204280, 226185707, 226185714, 7, 1440x900 
0x37CA2318, 38092266975877320, 226185773, 226185781, 8, 1440x900 
0x37CA2318, 38092266976546528, 226185842, 226185850, 8, 1440x900 
0x37CA2318, 38092266977208472, 226185908, 226185915, 7, 1440x900 
0x37CA2318, 38092266977865800, 226185973, 226185981, 8, 1440x900 
0x37CA2318, 38092266978529760, 226186043, 226186051, 8, 1440x900 
0x37CA2318, 38092266979189224, 226186108, 226186116, 8, 1440x900 
0x37CA2318, 38092266979846448, 226186171, 226186178, 7, 1440x900 
0x37CA2318, 38092266980516608, 226186238, 226186246, 8, 1440x900 
0x37CA2318, 38092266981163472, 226186302, 226186310, 8, 1440x900 
0x37CA2318, 38092266981827160, 226186371, 226186379, 8, 1440x900 
0x37CA2318, 38092266982486000, 226186437, 226186445, 8, 1440x900 
0x37CA2318, 38092266983147048, 226186502, 226186510, 8, 1440x900 
0x37CA2318, 38092266983807096, 226186569, 226186576, 7, 1440x900 
0x37CA2318, 38092266984477080, 226186636, 226186643, 7, 1440x900 
0x37CA2318, 38092266985135544, 226186703, 226186710, 7, 1440x900 
0x37CA2318, 38092266985798960, 226186773, 226186781, 8, 1440x900 
0x37CA2318, 38092266986452840, 226186832, 226186839, 7, 1440x900 
0x37CA2318, 38092266987113432, 226186897, 226186905, 8, 1440x900 
0x37CA2318, 38092266987773304, 226186963, 226186970, 7, 1440x900 
0x37CA2318, 38092266988438744, 226187034, 226187041, 7, 1440x900 
0x37CA2318, 38092266989099552, 226187097, 226187105, 8, 1440x900 
0x37CA2318, 38092266989761728, 226187168, 226187176, 8, 1440x900 
0x37CA2318, 38092266990586384, 226187260, 226187267, 7, 1440x900 
0x37CA2318, 38092266991075808, 226187293, 226187301, 8, 1440x900 
0x37CA2318, 38092266991733416, 226187357, 226187365, 8, 1440x900 
0x37CA2318, 38092266992397408, 226187427, 226187434, 7, 1440x900 
0x37CA2318, 38092266993058008, 226187492, 226187499, 7, 1440x900 
0x37CA2318, 38092266993724864, 226187558, 226187565, 7, 1440x900 
0x37CA2318, 38092266994384736, 226187626, 226187633, 7, 1440x900 
0x37CA2318, 38092266995049584, 226187697, 226187705, 8, 1440x900 
0x37CA2318, 38092266995709376, 226187763, 226187772, 9, 1440x900 
0x37CA2318, 38092266996370832, 226187838, 226187850, 12, 1440x900 
0x37CA2318, 38092266997037376, 226187888, 226187897, 9, 1440x900 
0x37CA2318, 38092266997696104, 226187956, 226187963, 7, 1440x900 
0x37CA2318, 38092266998357928, 226188022, 226188029, 7, 1440x900 
0x37CA2318, 38092266999016472, 226188088, 226188094, 6, 1440x900 
0x37CA2318, 38092266999678136, 226188153, 226188160, 7, 1440x900 
0x37CA2318, 38092267000339400, 226188221, 226188227, 6, 1440x900 
0x37CA2318, 38092267000998368, 226188288, 226188295, 7, 1440x900 
0x37CA2318, 38092267002184520, 226188407, 226188416, 9, 1440x900 
0x37CA2318, 38092267002337048, 226188422, 226188430, 8, 1440x900 
0x37CA2318, 38092267002977080, 226188482, 226188490, 8, 1440x900 
0x37CA2318, 38092267003697296, 226188557, 226188565, 8, 1440x900 
0x37CA2318, 38092267004509488, 226188637, 226188644, 7, 1440x900 
0x37CA2318, 38092267004973968, 226188687, 226188694, 7, 1440x900 
0x37CA2318, 38092267005817664, 226188768, 226188776, 8, 1440x900 
0x37CA2318, 38092267006487352, 226188833, 226188841, 8, 1440x900 
0x37CA2318, 38092267007156768, 226188900, 226188908, 8, 1440x900 
0x37CA2318, 38092267007807448, 226188967, 226188974, 7, 1440x900 
0x37CA2318, 38092267008469352, 226189033, 226189040, 7, 1440x900 
0x37CA2318, 38092267008940280, 226189082, 226189091, 9, 1440x900 
0x37CA2318, 38092267009600328, 226189148, 226189156, 8, 1440x900 
0x37CA2318, 38092267010260392, 226189218, 226189226, 8, 1440x900 
0x37CA2318, 38092267011103824, 226189297, 226189305, 8, 1440x900 
0x37CA2318, 38092267011779200, 226189364, 226189373, 9, 1440x900 
0x37CA2318, 38092267012448720, 226189433, 226189441, 8, 1440x900 
0x37CA2318, 38092267013102016, 226189497, 226189505, 8, 1440x900 
0x37CA2318, 38092267013761064, 226189567, 226189575, 8, 1440x900 
0x37CA2318, 38092267014231568, 226189613, 226189621, 8, 1440x900 
0x37CA2318, 38092267014891776, 226189677, 226189685, 8, 1440x900 
0x37CA2318, 38092267015555504, 226189748, 226189756, 8, 1440x900 
0x37CA2318, 38092267016396904, 226189828, 226189837, 9, 1440x900 
0x37CA2318, 38092267017065680, 226189898, 226189906, 8, 1440x900 
0x37CA2318, 38092267017716536, 226189958, 226189967, 9, 1440x900 
0x37CA2318, 38092267018385808, 226190028, 226190036, 8, 1440x900 
0x37CA2318, 38092267019049608, 226190092, 226190100, 8, 1440x900 
0x37CA2318, 38092267020185776, 226190208, 226190216, 8, 1440x900 
0x37CA2318, 38092267020842848, 226190272, 226190280, 8, 1440x900 
0x37CA2318, 38092267021692496, 226190358, 226190366, 8, 1440x900 
0x37CA2318, 38092267022363016, 226190427, 226190435, 8, 1440x900 
0x37CA2318, 38092267023003712, 226190488, 226190496, 8, 1440x900 
0x37CA2318, 38092267023666232, 226190557, 226190566, 9, 1440x900 
0x37CA2318, 38092267024346088, 226190622, 226190630, 8, 1440x900 
0x37CA2318, 38092267024805056, 226190667, 226190674, 7, 1440x900 
0x37CA2318, 38092267025471720, 226190735, 226190743, 8, 1440x900 
0x37CA2318, 38092267026131952, 226190801, 226190809, 8, 1440x900 
0x37CA2318, 38092267026990832, 226190887, 226190893, 6, 1440x900 
0x37CA2318, 38092267027660480, 226190952, 226190958, 6, 1440x900 
0x37CA2318, 38092267028320320, 226191018, 226191025, 7, 1440x900 
0x37CA2318, 38092267028979800, 226191082, 226191089, 7, 1440x900 
0x37CA2318, 38092267029639736, 226191151, 226191158, 7, 1440x900 
0x37CA2318, 38092267030108528, 226191197, 226191204, 7, 1440x900 
0x37CA2318, 38092267030775496, 226191263, 226191271, 8, 1440x900 
0x37CA2318, 38092267031440784, 226191333, 226191341, 8, 1440x900 
0x37CA2318, 38092267032291136, 226191419, 226191428, 9, 1440x900 
0x37CA2318, 38092267032958896, 226191482, 226191490, 8, 1440x900 
0x37CA2318, 38092267033415024, 226191527, 226191534, 7, 1440x900 
0x37CA2318, 38092267034075776, 226191592, 226191600, 8, 1440x900 
0x37CA2318, 38092267034931992, 226191683, 226191690, 7, 1440x900 
0x37CA2318, 38092267035400880, 226191727, 226191734, 7, 1440x900 
0x37CA2318, 38092267036068160, 226191797, 226191805, 8, 1440x900 
0x37CA2318, 38092267036725360, 226191862, 226191870, 8, 1440x900 
0x37CA2318, 38092267037577736, 226191948, 226191956, 8, 1440x900 
0x37CA2318, 38092267038237752, 226192013, 226192021, 8, 1440x900 
0x37CA2318, 38092267038898440, 226192077, 226192084, 7, 1440x900 
0x37CA2318, 38092267039571008, 226192148, 226192156, 8, 1440x900 
0x37CA2318, 38092267040219688, 226192212, 226192220, 8, 1440x900 
0x37CA2318, 38092267040688992, 226192257, 226192264, 7, 1440x900 
0x37CA2318, 38092267041353424, 226192327, 226192335, 8, 1440x900 
0x37CA2318, 38092267042010288, 226192387, 226192395, 8, 1440x900 
0x37CA2318, 38092267042879584, 226192474, 226192481, 7, 1440x900 
0x37CA2318, 38092267043529944, 226192537, 226192546, 9, 1440x900 
0x37CA2318, 38092267044190224, 226192603, 226192611, 8, 1440x900 
0x37CA2318, 38092267044859936, 226192672, 226192678, 6, 1440x900 
0x37CA2318, 38092267045392832, 226192723, 226192731, 8, 1440x900 
0x37CA2318, 38092267045975112, 226192782, 226192790, 8, 1440x900 
0x37CA2318, 38092267046639120, 226192852, 226192859, 7, 1440x900 
0x37CA2318, 38092267047307496, 226192917, 226192924, 7, 1440x900 
0x37CA2318, 38092267048170312, 226193007, 226193015, 8, 1440x900 
0x37CA2318, 38092267048829600, 226193073, 226193081, 8, 1440x900 
0x37CA2318, 38092267049490560, 226193138, 226193146, 8, 1440x900 
0x37CA2318, 38092267050140848, 226193202, 226193210, 8, 1440x900 
0x37CA2318, 38092267050745040, 226193261, 226193268, 7, 1440x900 
0x37CA2318, 38092267051268432, 226193312, 226193319, 7, 1440x900 
0x37CA2318, 38092267051935800, 226193383, 226193392, 9, 1440x900 
0x37CA2318, 38092267052596176, 226193448, 226193456, 8, 1440x900 
0x37CA2318, 38092267053446056, 226193534, 226193542, 8, 1440x900 
0x37CA2318, 38092267054110576, 226193597, 226193604, 7, 1440x900 
0x37CA2318, 38092267054774752, 226193668, 226193676, 8, 1440x900 
0x37CA2318, 38092267055431824, 226193733, 226193741, 8, 1440x900 
0x37CA2318, 38092267055937168, 226193783, 226193791, 8, 1440x900 
0x37CA2318, 38092267056573160, 226193848, 226193855, 7, 1440x900 
0x37CA2318, 38092267057235664, 226193912, 226193920, 8, 1440x900 
0x37CA2318, 38092267057894336, 226193977, 226193985, 8, 1440x900 
0x37CA2318, 38092267058734512, 226194067, 226194075, 8, 1440x900 
0x37CA2318, 38092267059396456, 226194128, 226194136, 8, 1440x900 
0x37CA2318, 38092267060056976, 226194197, 226194205, 8, 1440x900 
0x37CA2318, 38092267060729688, 226194263, 226194270, 7, 1440x900 
0x37CA2318, 38092267061276088, 226194317, 226194325, 8, 1440x900 
0x37CA2318, 38092267061856496, 226194373, 226194381, 8, 1440x900 
0x37CA2318, 38092267062516128, 226194439, 226194447, 8, 1440x900 
0x37CA2318, 38092267063184384, 226194507, 226194515, 8, 1440x900 
0x37CA2318, 38092267064028232, 226194592, 226194600, 8, 1440x900 
0x37CA2318, 38092267064699128, 226194658, 226194666, 8, 1440x900 
0x37CA2318, 38092267065359696, 226194727, 226194735, 8, 1440x900 
0x37CA2318, 38092267066020736, 226194788, 226194797, 9, 1440x900 
0x37CA2318, 38092267066496464, 226194839, 226194848, 9, 1440x900 
0x37CA2318, 38092267067149552, 226194902, 226194910, 8, 1440x900 
0x37CA2318, 38092267067812376, 226194972, 226194980, 8, 1440x900 
0x37CA2318, 38092267068473240, 226195033, 226195042, 9, 1440x900 
0x37CA2318, 38092267069313584, 226195118, 226195126, 8, 1440x900 
0x37CA2318, 38092267069983216, 226195187, 226195195, 8, 1440x900 
0x37CA2318, 38092267070646640, 226195253, 226195261, 8, 1440x900 
0x37CA2318, 38092267071299688, 226195317, 226195325, 8, 1440x900 
0x37CA2318, 38092267071790704, 226195368, 226195376, 8, 1440x900 
0x37CA2318, 38092267072441216, 226195433, 226195441, 8, 1440x900 
0x37CA2318, 38092267073111720, 226195502, 226195510, 8, 1440x900 
0x37CA2318, 38092267073769752, 226195567, 226195575, 8, 1440x900 
0x37CA2318, 38092267074626616, 226195653, 226195661, 8, 1440x900 
0x37CA2318, 38092267075279424, 226195717, 226195725, 8, 1440x900 
0x37CA2318, 38092267075941568, 226195783, 226195790, 7, 1440x900 
0x37CA2318, 38092267076610800, 226195848, 226195856, 8, 1440x900 
0x37CA2318, 38092267077071728, 226195896, 226195904, 8, 1440x900 
0x37CA2318, 38092267077735072, 226195964, 226195974, 10, 1440x900 
0x37CA2318, 38092267078400512, 226196028, 226196036, 8, 1440x900 
0x37CA2318, 38092267079058592, 226196097, 226196105, 8, 1440x900 
0x37CA2318, 38092267079911648, 226196183, 226196191, 8, 1440x900 
0x37CA2318, 38092267080568632, 226196248, 226196256, 8, 1440x900 
0x37CA2318, 38092267081229040, 226196312, 226196320, 8, 1440x900 
0x37CA2318, 38092267081889568, 226196377, 226196386, 9, 1440x900 
0x37CA2318, 38092267083022216, 226196488, 226196497, 9, 1440x900 
0x37CA2318, 38092267083687504, 226196557, 226196565, 8, 1440x900 
0x37CA2318, 38092267084552648, 226196642, 226196650, 8, 1440x900 
0x37CA2318, 38092267085204464, 226196708, 226196717, 9, 1440x900 
0x37CA2318, 38092267085859312, 226196778, 226196786, 8, 1440x900 
0x37CA2318, 38092267086529576, 226196838, 226196846, 8, 1440x900 
0x37CA2318, 38092267087189928, 226196908, 226196916, 8, 1440x900 
0x37CA2318, 38092267087661416, 226196957, 226196965, 8, 1440x900 
0x37CA2318, 38092267088321096, 226197022, 226197030, 8, 1440x900 
0x37CA2318, 38092267088981712, 226197087, 226197095, 8, 1440x900 
0x37CA2318, 38092267089835544, 226197173, 226197181, 8, 1440x900 
0x37CA2318, 38092267090496088, 226197237, 226197245, 8, 1440x900 
0x37CA2318, 38092267091157320, 226197307, 226197315, 8, 1440x900 
0x37CA2318, 38092267091810576, 226197368, 226197376, 8, 1440x900 
0x37CA2318, 38092267092473752, 226197434, 226197443, 9, 1440x900 
0x37CA2318, 38092267092946280, 226197483, 226197492, 9, 1440x900 
0x37CA2318, 38092267093605320, 226197549, 226197558, 9, 1440x900 
0x37CA2318, 38092267094267024, 226197615, 226197623, 8, 1440x900 
0x37CA2318, 38092267095115344, 226197699, 226197707, 8, 1440x900 
0x37CA2318, 38092267095766000, 226197768, 226197776, 8, 1440x900 
0x37CA2318, 38092267096430128, 226197833, 226197841, 8, 1440x900 
0x37CA2318, 38092267097096000, 226197897, 226197905, 8, 1440x900 
0x37CA2318, 38092267097747408, 226197962, 226197969, 7, 1440x900 
0x37CA2318, 38092267098225040, 226198008, 226198017, 9, 1440x900 
0x37CA2318, 38092267098886512, 226198077, 226198085, 8, 1440x900 
0x37CA2318, 38092267099544632, 226198141, 226198148, 7, 1440x900 
0x37CA2318, 38092267100417472, 226198232, 226198240, 8, 1440x900 
0x37CA2318, 38092267101070000, 226198297, 226198305, 8, 1440x900 
0x37CA2318, 38092267101739536, 226198363, 226198371, 8, 1440x900 
0x37CA2318, 38092267102398560, 226198427, 226198435, 8, 1440x900 
0x37CA2318, 38092267103058408, 226198492, 226198499, 7, 1440x900 
0x37CA2318, 38092267103523752, 226198538, 226198545, 7, 1440x900 
0x37CA2318, 38092267104183320, 226198603, 226198610, 7, 1440x900 
0x37CA2318, 38092267104850224, 226198672, 226198679, 7, 1440x900 
0x37CA2318, 38092267105513984, 226198742, 226198750, 8, 1440x900 
0x37CA2318, 38092267106354784, 226198824, 226198832, 8, 1440x900 
0x37CA2318, 38092267107026912, 226198893, 226198901, 8, 1440x900 
0x37CA2318, 38092267107684808, 226198957, 226198964, 7, 1440x900 
0x37CA2318, 38092267108355440, 226199022, 226199028, 6, 1440x900 
0x37CA2318, 38092267109023656, 226199093, 226199101, 8, 1440x900 
0x37CA2318, 38092267109685456, 226199154, 226199162, 8, 1440x900 
0x37CA2318, 38092267110336304, 226199218, 226199226, 8, 1440x900 
0x37CA2318, 38092267110997792, 226199288, 226199296, 8, 1440x900 
0x37CA2318, 38092267111658608, 226199353, 226199361, 8, 1440x900 
0x37CA2318, 38092267112318392, 226199423, 226199431, 8, 1440x900 
0x37CA2318, 38092267112989576, 226199487, 226199495, 8, 1440x900 
0x37CA2318, 38092267113653216, 226199553, 226199561, 8, 1440x900 
0x37CA2318, 38092267114320840, 226199628, 226199636, 8, 1440x900 
0x37CA2318, 38092267114989416, 226199688, 226199695, 7, 1440x900 
0x37CA2318, 38092267115482296, 226199732, 226199740, 8, 1440x900 
0x37CA2318, 38092267116306192, 226199817, 226199824, 7, 1440x900 
0x37CA2318, 38092267116769248, 226199863, 226199869, 6, 1440x900 
0x37CA2318, 38092267117617248, 226199947, 226199955, 8, 1440x900 
0x37CA2318, 38092267118287472, 226200013, 226200021, 8, 1440x900 
0x37CA2318, 38092267118943328, 226200083, 226200090, 7, 1440x900 
0x37CA2318, 38092267119594728, 226200149, 226200157, 8, 1440x900 
0x37CA2318, 38092267120165488, 226200202, 226200210, 8, 1440x900 
0x37CA2318, 38092267120944024, 226200283, 226200291, 8, 1440x900 
0x37CA2318, 38092267121390600, 226200322, 226200330, 8, 1440x900 
0x37CA2318, 38092267122253832, 226200413, 226200420, 7, 1440x900 
0x37CA2318, 38092267122940504, 226200480, 226200490, 10, 1440x900 
0x37CA2318, 38092267123580144, 226200545, 226200553, 8, 1440x900 
0x37CA2318, 38092267124232608, 226200608, 226200616, 8, 1440x900 
0x37CA2318, 38092267124886704, 226200673, 226200681, 8, 1440x900 
0x37CA2318, 38092267125548328, 226200743, 226200752, 9, 1440x900 
0x37CA2318, 38092267126198632, 226200805, 226200815, 10, 1440x900 
0x37CA2318, 38092267126877712, 226200872, 226200880, 8, 1440x900 
0x37CA2318, 38092267127527632, 226200937, 226200945, 8, 1440x900 
0x37CA2318, 38092267128186984, 226201003, 226201011, 8, 1440x900 
0x37CA2318, 38092267128852360, 226201071, 226201078, 7, 1440x900 
0x37CA2318, 38092267129511768, 226201137, 226201145, 8, 1440x900 
0x37CA2318, 38092267130178152, 226201203, 226201211, 8, 1440x900 
0x37CA2318, 38092267130838856, 226201268, 226201277, 9, 1440x900 
0x37CA2318, 38092267131507008, 226201337, 226201343, 6, 1440x900 
0x37CA2318, 38092267132176424, 226201402, 226201410, 8, 1440x900 
0x37CA2318, 38092267132836336, 226201468, 226201475, 7, 1440x900 
0x37CA2318, 38092267133498720, 226201537, 226201545, 8, 1440x900 
0x37CA2318, 38092267134159272, 226201602, 226201609, 7, 1440x900 
0x37CA2318, 38092267134827296, 226201667, 226201675, 8, 1440x900 
0x37CA2318, 38092267135481056, 226201736, 226201743, 7, 1440x900 
0x37CA2318, 38092267136141112, 226201801, 226201808, 7, 1440x900 
0x37CA2318, 38092267136803280, 226201867, 226201874, 7, 1440x900 
0x37CA2318, 38092267137463672, 226201932, 226201939, 7, 1440x900 
0x37CA2318, 38092267138116464, 226202002, 226202010, 8, 1440x900 
0x37CA2318, 38092267138784680, 226202068, 226202075, 7, 1440x900 
0x37CA2318, 38092267139445696, 226202132, 226202139, 7, 1440x900 
0x37CA2318, 38092267140116072, 226202202, 226202210, 8, 1440x900 
0x37CA2318, 38092267140765392, 226202262, 226202269, 7, 1440x900 
0x37CA2318, 38092267141426120, 226202333, 226202341, 8, 1440x900 
0x37CA2318, 38092267142091472, 226202398, 226202407, 9, 1440x900 
0x37CA2318, 38092267142560192, 226202447, 226202455, 8, 1440x900 
0x37CA2318, 38092267143412992, 226202528, 226202536, 8, 1440x900 
0x37CA2318, 38092267144081136, 226202597, 226202604, 7, 1440x900 
0x37CA2318, 38092267144732568, 226202663, 226202671, 8, 1440x900 
0x37CA2318, 38092267145393160, 226202728, 226202736, 8, 1440x900 
0x37CA2318, 38092267146052688, 226202793, 226202801, 8, 1440x900 
0x37CA2318, 38092267146712824, 226202862, 226202870, 8, 1440x900 
0x37CA2318, 38092267147374480, 226202927, 226202935, 8, 1440x900 
0x37CA2318, 38092267148038248, 226202992, 226203000, 8, 1440x900 
0x37CA2318, 38092267148694504, 226203058, 226203066, 8, 1440x900 
0x37CA2318, 38092267149358176, 226203123, 226203131, 8, 1440x900 
0x37CA2318, 38092267150017808, 226203192, 226203200, 8, 1440x900 
0x37CA2318, 38092267150668176, 226203253, 226203260, 7, 1440x900 
0x37CA2318, 38092267151331984, 226203324, 226203332, 8, 1440x900 
0x37CA2318, 38092267151997672, 226203387, 226203396, 9, 1440x900 
0x37CA2318, 38092267152658520, 226203453, 226203462, 9, 1440x900 
0x37CA2318, 38092267153312248, 226203522, 226203530, 8, 1440x900 
0x37CA2318, 38092267153984976, 226203587, 226203595, 8, 1440x900 
0x37CA2318, 38092267154644688, 226203652, 226203659, 7, 1440x900 
0x37CA2318, 38092267155772664, 226203763, 226203770, 7, 1440x900 
0x37CA2318, 38092267156620720, 226203847, 226203855, 8, 1440x900 
0x37CA2318, 38092267157292504, 226203913, 226203921, 8, 1440x900 
0x37CA2318, 38092267157946368, 226203983, 226203991, 8, 1440x900 
0x37CA2318, 38092267158607208, 226204052, 226204060, 8, 1440x900 
0x37CA2318, 38092267159270728, 226204117, 226204125, 8, 1440x900 
0x37CA2318, 38092267159928152, 226204183, 226204191, 8, 1440x900 
0x37CA2318, 38092267160591200, 226204248, 226204255, 7, 1440x900 
0x37CA2318, 38092267161249240, 226204317, 226204325, 8, 1440x900 
0x37CA2318, 38092267161911136, 226204383, 226204391, 8, 1440x900 
0x37CA2318, 38092267162580664, 226204448, 226204456, 8, 1440x900 
0x37CA2318, 38092267163232680, 226204511, 226204518, 7, 1440x900 
0x37CA2318, 38092267163892696, 226204573, 226204582, 9, 1440x900 
0x37CA2318, 38092267164544552, 226204639, 226204647, 8, 1440x900 
0x37CA2318, 38092267165215504, 226204708, 226204717, 9, 1440x900 
0x37CA2318, 38092267165874816, 226204778, 226204786, 8, 1440x900 
0x37CA2318, 38092267166546176, 226204848, 226204856, 8, 1440x900 
0x37CA2318, 38092267167205520, 226204913, 226204921, 8, 1440x900 
0x37CA2318, 38092267167866584, 226204977, 226204985, 8, 1440x900 
0x37CA2318, 38092267168519480, 226205038, 226205047, 9, 1440x900 
0x37CA2318, 38092267169182624, 226205108, 226205116, 8, 1440x900 
0x37CA2318, 38092267169835024, 226205174, 226205182, 8, 1440x900 
0x37CA2318, 38092267170497296, 226205242, 226205250, 8, 1440x900 
0x37CA2318, 38092267171166864, 226205303, 226205310, 7, 1440x900 
0x37CA2318, 38092267171818480, 226205373, 226205381, 8, 1440x900 
0x37CA2318, 38092267172480864, 226205438, 226205446, 8, 1440x900 
0x37CA2318, 38092267173142680, 226205503, 226205511, 8, 1440x900 
0x37CA2318, 38092267173804632, 226205569, 226205577, 8, 1440x900 
0x37CA2318, 38092267174473528, 226205637, 226205645, 8, 1440x900 
0x37CA2318, 38092267175124864, 226205703, 226205711, 8, 1440x900 
0x37CA2318, 38092267175786048, 226205769, 226205777, 8, 1440x900 
0x37CA2318, 38092267176445952, 226205832, 226205840, 8, 1440x900 
0x37CA2318, 38092267177098024, 226205898, 226205906, 8, 1440x900 
0x37CA2318, 38092267177760024, 226205963, 226205972, 9, 1440x900 
0x37CA2318, 38092267178435888, 226206033, 226206041, 8, 1440x900 
0x37CA2318, 38092267179097272, 226206096, 226206103, 7, 1440x900 
0x37CA2318, 38092267179758640, 226206162, 226206170, 8, 1440x900 
0x37CA2318, 38092267180419888, 226206228, 226206237, 9, 1440x900 
0x37CA2318, 38092267181079984, 226206298, 226206306, 8, 1440x900 
0x37CA2318, 38092267181741080, 226206362, 226206370, 8, 1440x900 
0x37CA2318, 38092267182400592, 226206427, 226206435, 8, 1440x900 
0x37CA2318, 38092267183062264, 226206492, 226206501, 9, 1440x900 
0x37CA2318, 38092267183722704, 226206562, 226206570, 8, 1440x900 
0x37CA2318, 38092267184383168, 226206628, 226206637, 9, 1440x900 
0x37CA2318, 38092267185047184, 226206698, 226206706, 8, 1440x900 
0x37CA2318, 38092267185715904, 226206757, 226206765, 8, 1440x900 
0x37CA2318, 38092267186367384, 226206822, 226206830, 8, 1440x900 
0x37CA2318, 38092267187028504, 226206892, 226206900, 8, 1440x900 
0x37CA2318, 38092267187680144, 226206953, 226206961, 8, 1440x900 
0x37CA2318, 38092267188351160, 226207021, 226207029, 8, 1440x900 
0x37CA2318, 38092267189004008, 226207086, 226207094, 8, 1440x900 
0x37CA2318, 38092267189684160, 226207158, 226207166, 8, 1440x900 
0x37CA2318, 38092267190334168, 226207223, 226207231, 8, 1440x900 
0x37CA2318, 38092267190996376, 226207288, 226207296, 8, 1440x900 
0x37CA2318, 38092267191664520, 226207358, 226207366, 8, 1440x900 
0x37CA2318, 38092267192308256, 226207418, 226207427, 9, 1440x900 
0x37CA2318, 38092267192987440, 226207488, 226207496, 8, 1440x900 
0x37CA2318, 38092267193639344, 226207553, 226207561, 8, 1440x900 
0x37CA2318, 38092267194292680, 226207618, 226207626, 8, 1440x900 
0x37CA2318, 38092267194966080, 226207683, 226207692, 9, 1440x900 
0x37CA2318, 38092267195624632, 226207754, 226207761, 7, 1440x900 
0x37CA2318, 38092267196286960, 226207817, 226207825, 8, 1440x900 
0x37CA2318, 38092267196940144, 226207882, 226207890, 8, 1440x900 
0x37CA2318, 38092267197606504, 226207952, 226207960, 8, 1440x900 
0x37CA2318, 38092267198271344, 226208018, 226208026, 8, 1440x900 
0x37CA2318, 38092267198930496, 226208082, 226208090, 8, 1440x900 
0x37CA2318, 38092267199593288, 226208148, 226208155, 7, 1440x900 
0x37CA2318, 38092267200256264, 226208213, 226208222, 9, 1440x900 
0x37CA2318, 38092267200906368, 226208277, 226208284, 7, 1440x900 
0x37CA2318, 38092267201575272, 226208348, 226208356, 8, 1440x900 
0x37CA2318, 38092267202238424, 226208413, 226208421, 8, 1440x900 
0x37CA2318, 38092267202907088, 226208478, 226208485, 7, 1440x900 
0x37CA2318, 38092267203567928, 226208543, 226208550, 7, 1440x900 
0x37CA2318, 38092267204218928, 226208608, 226208615, 7, 1440x900 
0x37CA2318, 38092267204874584, 226208673, 226208681, 8, 1440x900 
0x37CA2318, 38092267205537160, 226208742, 226208750, 8, 1440x900 
0x37CA2318, 38092267206200536, 226208807, 226208815, 8, 1440x900 
0x37CA2318, 38092267206861952, 226208877, 226208885, 8, 1440x900 
0x37CA2318, 38092267207529888, 226208937, 226208944, 7, 1440x900 
0x37CA2318, 38092267208199368, 226209007, 226209014, 7, 1440x900 
0x37CA2318, 38092267208859032, 226209072, 226209079, 7, 1440x900 
0x37CA2318, 38092267209528504, 226209137, 226209145, 8, 1440x900 
0x37CA2318, 38092267210188632, 226209203, 226209211, 8, 1440x900 
0x37CA2318, 38092267210848248, 226209272, 226209279, 7, 1440x900 
0x37CA2318, 38092267211499608, 226209336, 226209343, 7, 1440x900 
0x37CA2318, 38092267212164920, 226209402, 226209410, 8, 1440x900 
0x37CA2318, 38092267212815120, 226209467, 226209474, 7, 1440x900 
0x37CA2318, 38092267213481880, 226209535, 226209544, 9, 1440x900 
0x37CA2318, 38092267214142144, 226209601, 226209608, 7, 1440x900 
0x37CA2318, 38092267214811528, 226209667, 226209674, 7, 1440x900 
0x37CA2318, 38092267215462568, 226209732, 226209739, 7, 1440x900 
0x37CA2318, 38092267216123616, 226209798, 226209805, 7, 1440x900 
0x37CA2318, 38092267216793184, 226209863, 226209869, 6, 1440x900 
0x37CA2318, 38092267217452904, 226209932, 226209939, 7, 1440x900 
0x37CA2318, 38092267218122424, 226209997, 226210004, 7, 1440x900 
0x37CA2318, 38092267218781976, 226210062, 226210070, 8, 1440x900 
0x37CA2318, 38092267219451664, 226210129, 226210138, 9, 1440x900 
0x37CA2318, 38092267220101584, 226210197, 226210204, 7, 1440x900 
0x37CA2318, 38092267220775432, 226210263, 226210270, 7, 1440x900 
0x37CA2318, 38092267221427784, 226210332, 226210339, 7, 1440x900 
0x37CA2318, 38092267222089376, 226210397, 226210405, 8, 1440x900 
0x37CA2318, 38092267222757232, 226210468, 226210476, 8, 1440x900 
0x37CA2318, 38092267224061536, 226210593, 226210601, 8, 1440x900 
0x37CA2318, 38092267224543480, 226210642, 226210651, 9, 1440x900 
0x37CA2318, 38092267225392792, 226210732, 226210740, 8, 1440x900 
0x37CA2318, 38092267226053368, 226210793, 226210801, 8, 1440x900 
0x37CA2318, 38092267226705840, 226210862, 226210870, 8, 1440x900 
0x37CA2318, 38092267227384792, 226210928, 226210936, 8, 1440x900 
0x37CA2318, 38092267228035432, 226210993, 226211000, 7, 1440x900 
0x37CA2318, 38092267228695792, 226211062, 226211070, 8, 1440x900 
0x37CA2318, 38092267229356216, 226211127, 226211135, 8, 1440x900 
0x37CA2318, 38092267230020976, 226211193, 226211201, 8, 1440x900 
0x37CA2318, 38092267230691424, 226211258, 226211266, 8, 1440x900 
0x37CA2318, 38092267231343392, 226211322, 226211331, 9, 1440x900 
0x37CA2318, 38092267232004968, 226211389, 226211397, 8, 1440x900 
0x37CA2318, 38092267232655968, 226211453, 226211461, 8, 1440x900 
0x37CA2318, 38092267233318056, 226211518, 226211527, 9, 1440x900 
0x37CA2318, 38092267233980784, 226211587, 226211595, 8, 1440x900 
0x37CA2318, 38092267234637424, 226211652, 226211660, 8, 1440x900 
0x37CA2318, 38092267235298272, 226211717, 226211725, 8, 1440x900 
0x37CA2318, 38092267235970240, 226211787, 226211795, 8, 1440x900 
0x37CA2318, 38092267236629952, 226211852, 226211860, 8, 1440x900 
0x37CA2318, 38092267237289448, 226211917, 226211925, 8, 1440x900 
0x37CA2318, 38092267237950104, 226211983, 226211991, 8, 1440x900 
0x37CA2318, 38092267238611184, 226212052, 226212060, 8, 1440x900 
0x37CA2318, 38092267239279448, 226212117, 226212125, 8, 1440x900 
0x37CA2318, 38092267239937104, 226212181, 226212188, 7, 1440x900 
0x37CA2318, 38092267240598704, 226212252, 226212260, 8, 1440x900 
0x37CA2318, 38092267241250688, 226212313, 226212321, 8, 1440x900 
0x37CA2318, 38092267241910144, 226212378, 226212386, 8, 1440x900 
0x37CA2318, 38092267242588832, 226212448, 226212456, 8, 1440x900 
0x37CA2318, 38092267243238984, 226212513, 226212521, 8, 1440x900 
0x37CA2318, 38092267243903296, 226212582, 226212590, 8, 1440x900 
0x37CA2318, 38092267244555056, 226212647, 226212655, 8, 1440x900 
0x37CA2318, 38092267245226976, 226212712, 226212719, 7, 1440x900 
0x37CA2318, 38092267245893568, 226212778, 226212786, 8, 1440x900 
0x37CA2318, 38092267246564280, 226212847, 226212856, 9, 1440x900 
0x37CA2318, 38092267247217568, 226212909, 226212917, 8, 1440x900 
0x37CA2318, 38092267247878272, 226212977, 226212985, 8, 1440x900 
0x37CA2318, 38092267248539456, 226213043, 226213051, 8, 1440x900 
0x37CA2318, 38092267249197192, 226213107, 226213115, 8, 1440x900 
0x37CA2318, 38092267249858520, 226213173, 226213181, 8, 1440x900 
0x37CA2318, 38092267250521080, 226213238, 226213247, 9, 1440x900 
0x37CA2318, 38092267251180800, 226213308, 226213316, 8, 1440x900 
0x37CA2318, 38092267251849728, 226213373, 226213381, 8, 1440x900 
0x37CA2318, 38092267252506632, 226213442, 226213450, 8, 1440x900 
0x37CA2318, 38092267253170488, 226213508, 226213516, 8, 1440x900 
0x37CA2318, 38092267253822224, 226213572, 226213580, 8, 1440x900 
0x37CA2318, 38092267254491296, 226213637, 226213645, 8, 1440x900 
0x37CA2318, 38092267255153080, 226213703, 226213711, 8, 1440x900 
0x37CA2318, 38092267255813024, 226213767, 226213776, 9, 1440x900 
0x37CA2318, 38092267256480400, 226213837, 226213846, 9, 1440x900 
0x37CA2318, 38092267257140400, 226213903, 226213912, 9, 1440x900 
0x37CA2318, 38092267257801872, 226213968, 226213976, 8, 1440x900 
0x37CA2318, 38092267258461712, 226214037, 226214045, 8, 1440x900 
0x37CA2318, 38092267259122392, 226214102, 226214110, 8, 1440x900 
0x37CA2318, 38092267259774112, 226214169, 226214177, 8, 1440x900 
0x37CA2318, 38092267260445256, 226214233, 226214241, 8, 1440x900 
0x37CA2318, 38092267261106496, 226214302, 226214310, 8, 1440x900 
0x37CA2318, 38092267261767744, 226214363, 226214372, 9, 1440x900 
0x37CA2318, 38092267262422096, 226214432, 226214440, 8, 1440x900 
0x37CA2318, 38092267263083072, 226214497, 226214505, 8, 1440x900 
0x37CA2318, 38092267263743808, 226214562, 226214570, 8, 1440x900 
0x37CA2318, 38092267264413440, 226214628, 226214636, 8, 1440x900 
0x37CA2318, 38092267265066848, 226214698, 226214706, 8, 1440x900 
0x37CA2318, 38092267265727136, 226214762, 226214770, 8, 1440x900 
0x37CA2318, 38092267266388384, 226214827, 226214835, 8, 1440x900 
0x37CA2318, 38092267267048784, 226214892, 226214899, 7, 1440x900 
0x37CA2318, 38092267267700840, 226214957, 226214964, 7, 1440x900 
0x37CA2318, 38092267268377592, 226215028, 226215036, 8, 1440x900 
0x37CA2318, 38092267269025448, 226215093, 226215101, 8, 1440x900 
0x37CA2318, 38092267269688848, 226215158, 226215166, 8, 1440x900 
0x37CA2318, 38092267270346760, 226215227, 226215234, 7, 1440x900 
0x37CA2318, 38092267271009096, 226215292, 226215300, 8, 1440x900 
0x37CA2318, 38092267271669024, 226215353, 226215362, 9, 1440x900 
0x37CA2318, 38092267272325472, 226215423, 226215431, 8, 1440x900 
0x37CA2318, 38092267273001928, 226215492, 226215500, 8, 1440x900 
0x37CA2318, 38092267273654952, 226215553, 226215561, 8, 1440x900 
0x37CA2318, 38092267274327272, 226215623, 226215631, 8, 1440x900 
0x37CA2318, 38092267274975816, 226215687, 226215695, 8, 1440x900 
0x37CA2318, 38092267275629072, 226215753, 226215761, 8, 1440x900 
0x37CA2318, 38092267276300888, 226215822, 226215830, 8, 1440x900 
0x37CA2318, 38092267276969912, 226215886, 226215893, 7, 1440x900 
0x37CA2318, 38092267277622272, 226215948, 226215955, 7, 1440x900 
0x37CA2318, 38092267278292536, 226216018, 226216025, 7, 1440x900 
0x37CA2318, 38092267278952136, 226216083, 226216091, 8, 1440x900 
0x37CA2318, 38092267279599792, 226216149, 226216157, 8, 1440x900 
0x37CA2318, 38092267280265384, 226216219, 226216227, 8, 1440x900 
0x37CA2318, 38092267280920536, 226216283, 226216291, 8, 1440x900 
0x37CA2318, 38092267281594464, 226216349, 226216357, 8, 1440x900 
0x37CA2318, 38092267282251520, 226216413, 226216421, 8, 1440x900 
0x37CA2318, 38092267282921184, 226216478, 226216487, 9, 1440x900 
0x37CA2318, 38092267283571904, 226216543, 226216552, 9, 1440x900 
0x37CA2318, 38092267284232736, 226216613, 226216621, 8, 1440x900 
0x37CA2318, 38092267284890656, 226216677, 226216685, 8, 1440x900 
0x37CA2318, 38092267285554472, 226216743, 226216752, 9, 1440x900 
0x37CA2318, 38092267286214696, 226216808, 226216817, 9, 1440x900 
0x37CA2318, 38092267286877608, 226216878, 226216886, 8, 1440x900 
0x37CA2318, 38092267287547512, 226216948, 226216956, 8, 1440x900 
0x37CA2318, 38092267288198232, 226217007, 226217015, 8, 1440x900 
0x37CA2318, 38092267288859056, 226217073, 226217082, 9, 1440x900 
0x37CA2318, 38092267289520080, 226217143, 226217151, 8, 1440x900 
0x37CA2318, 38092267290188888, 226217207, 226217215, 8, 1440x900 
0x37CA2318, 38092267290839632, 226217273, 226217281, 8, 1440x900 
0x37CA2318, 38092267291509736, 226217342, 226217350, 8, 1440x900 
0x37CA2318, 38092267292169672, 226217408, 226217416, 8, 1440x900 
0x37CA2318, 38092267292828464, 226217472, 226217480, 8, 1440x900 
0x37CA2318, 38092267293480512, 226217538, 226217546, 8, 1440x900 
0x37CA2318, 38092267294137872, 226217602, 226217610, 8, 1440x900 
0x37CA2318, 38092267294811504, 226217668, 226217676, 8, 1440x900 
0x37CA2318, 38092267295469208, 226217737, 226217745, 8, 1440x900 
0x37CA2318, 38092267296123872, 226217802, 226217811, 9, 1440x900 
0x37CA2318, 38092267296787088, 226217868, 226217875, 7, 1440x900 
0x37CA2318, 38092267297444032, 226217933, 226217942, 9, 1440x900 
0x37CA2318, 38092267298122616, 226218003, 226218010, 7, 1440x900 
0x37CA2318, 38092267298781256, 226218063, 226218071, 8, 1440x900 
0x37CA2318, 38092267299432160, 226218127, 226218135, 8, 1440x900 
0x37CA2318, 38092267300104400, 226218198, 226218206, 8, 1440x900 
0x37CA2318, 38092267300766192, 226218268, 226218276, 8, 1440x900 
0x37CA2318, 38092267301426416, 226218328, 226218336, 8, 1440x900 
0x37CA2318, 38092267302079720, 226218397, 226218405, 8, 1440x900 
0x37CA2318, 38092267302751224, 226218462, 226218470, 8, 1440x900 
0x37CA2318, 38092267303413752, 226218528, 226218536, 8, 1440x900 
0x37CA2318, 38092267304073520, 226218598, 226218606, 8, 1440x900 
0x37CA2318, 38092267305380624, 226218728, 226218736, 8, 1440x900 
0x37CA2318, 38092267306050280, 226218793, 226218801, 8, 1440x900 
0x37CA2318, 38092267306707504, 226218858, 226218866, 8, 1440x900 
0x37CA2318, 38092267307371864, 226218927, 226218935, 8, 1440x900 
0x37CA2318, 38092267308032360, 226218993, 226219001, 8, 1440x900 
0x37CA2318, 38092267308689528, 226219058, 226219067, 9, 1440x900 
0x37CA2318, 38092267309352352, 226219123, 226219131, 8, 1440x900 
0x37CA2318, 38092267310016336, 226219193, 226219201, 8, 1440x900 
0x37CA2318, 38092267310678144, 226219258, 226219266, 8, 1440x900 
0x37CA2318, 38092267311329872, 226219318, 226219326, 8, 1440x900 
0x37CA2318, 38092267312008800, 226219392, 226219399, 7, 1440x900 
0x37CA2318, 38092267312662904, 226219453, 226219461, 8, 1440x900 
0x37CA2318, 38092267313323112, 226219518, 226219525, 7, 1440x900 
0x37CA2318, 38092267313975664, 226219588, 226219595, 7, 1440x900 
0x37CA2318, 38092267314637128, 226219652, 226219660, 8, 1440x900 
0x37CA2318, 38092267315313480, 226219718, 226219726, 8, 1440x900 
0x37CA2318, 38092267315967560, 226219787, 226219795, 8, 1440x900 
0x37CA2318, 38092267316629016, 226219852, 226219860, 8, 1440x900 
0x37CA2318, 38092267317290768, 226219918, 226219926, 8, 1440x900 
0x37CA2318, 38092267317942288, 226219983, 226219991, 8, 1440x900 
0x37CA2318, 38092267318606456, 226220052, 226220060, 8, 1440x900 
0x37CA2318, 38092267319272176, 226220118, 226220126, 8, 1440x900 
0x37CA2318, 38092267319936096, 226220184, 226220192, 8, 1440x900 
0x37CA2318, 38092267320589000, 226220248, 226220256, 8, 1440x900 
0x37CA2318, 38092267321260872, 226220313, 226220322, 9, 1440x900 
0x37CA2318, 38092267321913688, 226220382, 226220390, 8, 1440x900 
0x37CA2318, 38092267322570656, 226220448, 226220456, 8, 1440x900 
0x37CA2318, 38092267323227400, 226220512, 226220520, 8, 1440x900 
0x37CA2318, 38092267323888560, 226220578, 226220586, 8, 1440x900 
0x37CA2318, 38092267324561992, 226220642, 226220651, 9, 1440x900 
0x37CA2318, 38092267325225392, 226220713, 226220721, 8, 1440x900 
0x37CA2318, 38092267325887720, 226220778, 226220786, 8, 1440x900 
0x37CA2318, 38092267326537512, 226220847, 226220855, 8, 1440x900 
0x37CA2318, 38092267327191712, 226220907, 226220915, 8, 1440x900 
0x37CA2318, 38092267327853992, 226220977, 226220984, 7, 1440x900 
0x37CA2318, 38092267328518368, 226221037, 226221045, 8, 1440x900 
0x37CA2318, 38092267329181064, 226221108, 226221116, 8, 1440x900 
0x37CA2318, 38092267329844480, 226221173, 226221182, 9, 1440x900 
0x37CA2318, 38092267330496896, 226221237, 226221245, 8, 1440x900 
0x37CA2318, 38092267331157520, 226221302, 226221309, 7, 1440x900 
0x37CA2318, 38092267331820992, 226221372, 226221380, 8, 1440x900 
0x37CA2318, 38092267332480144, 226221437, 226221445, 8, 1440x900 
0x37CA2318, 38092267333144280, 226221502, 226221511, 9, 1440x900 
0x37CA2318, 38092267333813872, 226221568, 226221576, 8, 1440x900 
0x37CA2318, 38092267334473064, 226221633, 226221642, 9, 1440x900 
0x37CA2318, 38092267335123304, 226221703, 226221711, 8, 1440x900 
0x37CA2318, 38092267335782464, 226221768, 226221776, 8, 1440x900 
0x37CA2318, 38092267336454800, 226221832, 226221841, 9, 1440x900 
0x37CA2318, 38092267337106760, 226221902, 226221910, 8, 1440x900 
0x37CA2318, 38092267337766080, 226221963, 226221972, 9, 1440x900 
0x37CA2318, 38092267338427960, 226222032, 226222040, 8, 1440x900 
0x37CA2318, 38092267339086640, 226222098, 226222106, 8, 1440x900 
0x37CA2318, 38092267339756824, 226222163, 226222171, 8, 1440x900 
0x37CA2318, 38092267340418488, 226222229, 226222237, 8, 1440x900 
0x37CA2318, 38092267341074824, 226222298, 226222305, 7, 1440x900 
0x37CA2318, 38092267341736072, 226222362, 226222370, 8, 1440x900 
0x37CA2318, 38092267342407312, 226222432, 226222440, 8, 1440x900 
0x37CA2318, 38092267343058800, 226222493, 226222501, 8, 1440x900 
0x37CA2318, 38092267343728784, 226222562, 226222570, 8, 1440x900 
0x37CA2318, 38092267344387856, 226222627, 226222635, 8, 1440x900 
0x37CA2318, 38092267345039704, 226222692, 226222700, 8, 1440x900 
0x37CA2318, 38092267345701624, 226222757, 226222766, 9, 1440x900 
0x37CA2318, 38092267346370816, 226222827, 226222835, 8, 1440x900 
0x37CA2318, 38092267347020632, 226222893, 226222901, 8, 1440x900 
0x37CA2318, 38092267347683744, 226222958, 226222966, 8, 1440x900 
0x37CA2318, 38092267348335704, 226223023, 226223031, 8, 1440x900 
0x37CA2318, 38092267349016112, 226223093, 226223101, 8, 1440x900 
0x37CA2318, 38092267349666384, 226223158, 226223166, 8, 1440x900 
0x37CA2318, 38092267350319464, 226223223, 226223231, 8, 1440x900 
0x37CA2318, 38092267350983432, 226223288, 226223297, 9, 1440x900 
0x37CA2318, 38092267351649824, 226223353, 226223361, 8, 1440x900 
0x37CA2318, 38092267352308720, 226223416, 226223423, 7, 1440x900 
0x37CA2318, 38092267352964312, 226223487, 226223495, 8, 1440x900 
0x37CA2318, 38092267353631968, 226223553, 226223561, 8, 1440x900 
0x37CA2318, 38092267354298808, 226223622, 226223630, 8, 1440x900 
0x37CA2318, 38092267354955320, 226223683, 226223691, 8, 1440x900 
0x37CA2318, 38092267355612136, 226223748, 226223756, 8, 1440x900 
0x37CA2318, 38092267356269920, 226223817, 226223825, 8, 1440x900 
0x37CA2318, 38092267356930752, 226223883, 226223891, 8, 1440x900 
0x37CA2318, 38092267357604336, 226223947, 226223955, 8, 1440x900 
0x37CA2318, 38092267358265800, 226224013, 226224022, 9, 1440x900 
0x37CA2318, 38092267358929504, 226224082, 226224090, 8, 1440x900 
0x37CA2318, 38092267359591264, 226224147, 226224155, 8, 1440x900 
0x37CA2318, 38092267360243104, 226224212, 226224220, 8, 1440x900 
0x37CA2318, 38092267360906488, 226224278, 226224286, 8, 1440x900 
0x37CA2318, 38092267361561352, 226224343, 226224351, 8, 1440x900 
0x37CA2318, 38092267362241120, 226224413, 226224421, 8, 1440x900 
0x37CA2318, 38092267362892544, 226224477, 226224485, 8, 1440x900 
0x37CA2318, 38092267363554832, 226224543, 226224551, 8, 1440x900 
0x37CA2318, 38092267364217376, 226224613, 226224621, 8, 1440x900 
0x37CA2318, 38092267364872208, 226224677, 226224685, 8, 1440x900 
0x37CA2318, 38092267365534744, 226224742, 226224750, 8, 1440x900 
0x37CA2318, 38092267366197240, 226224808, 226224816, 8, 1440x900 
0x37CA2318, 38092267366852440, 226224873, 226224881, 8, 1440x900 
0x37CA2318, 38092267367516256, 226224942, 226224950, 8, 1440x900 
0x37CA2318, 38092267368183488, 226225007, 226225015, 8, 1440x900 
0x37CA2318, 38092267368836288, 226225074, 226225082, 8, 1440x900 
0x37CA2318, 38092267369502144, 226225138, 226225147, 9, 1440x900 
0x37CA2318, 38092267370167608, 226225207, 226225215, 8, 1440x900 
0x37CA2318, 38092267370829352, 226225272, 226225280, 8, 1440x900 
0x37CA2318, 38092267371482568, 226225338, 226225346, 8, 1440x900 
0x37CA2318, 38092267372143040, 226225402, 226225410, 8, 1440x900 
0x37CA2318, 38092267372803888, 226225468, 226225475, 7, 1440x900 
0x37CA2318, 38092267373464696, 226225533, 226225539, 6, 1440x900 
0x37CA2318, 38092267374130920, 226225602, 226225610, 8, 1440x900 
0x37CA2318, 38092267374783640, 226225663, 226225672, 9, 1440x900 
0x37CA2318, 38092267375444904, 226225732, 226225740, 8, 1440x900 
0x37CA2318, 38092267376105776, 226225802, 226225810, 8, 1440x900 
0x37CA2318, 38092267376767000, 226225868, 226225875, 7, 1440x900 
0x37CA2318, 38092267377434368, 226225933, 226225940, 7, 1440x900 
0x37CA2318, 38092267378094968, 226225997, 226226005, 8, 1440x900 
0x37CA2318, 38092267378749016, 226226062, 226226071, 9, 1440x900 
0x37CA2318, 38092267379410104, 226226132, 226226140, 8, 1440x900 
0x37CA2318, 38092267380064224, 226226197, 226226206, 9, 1440x900 
0x37CA2318, 38092267380735904, 226226262, 226226271, 9, 1440x900 
0x37CA2318, 38092267382054704, 226226393, 226226401, 8, 1440x900 
0x37CA2318, 38092267382713856, 226226458, 226226466, 8, 1440x900 
0x37CA2318, 38092267383373816, 226226523, 226226530, 7, 1440x900 
0x37CA2318, 38092267384035328, 226226591, 226226599, 8, 1440x900 
0x37CA2318, 38092267384705208, 226226658, 226226666, 8, 1440x900 
0x37CA2318, 38092267385354680, 226226723, 226226731, 8, 1440x900 
0x37CA2318, 38092267386017576, 226226789, 226226797, 8, 1440x900 
0x37CA2318, 38092267386675328, 226226858, 226226866, 8, 1440x900 
0x37CA2318, 38092267387339080, 226226923, 226226931, 8, 1440x900 
0x37CA2318, 38092267387998880, 226226993, 226227001, 8, 1440x900 
0x37CA2318, 38092267388651352, 226227052, 226227059, 7, 1440x900 
0x37CA2318, 38092267389320936, 226227122, 226227130, 8, 1440x900 
0x37CA2318, 38092267389972392, 226227183, 226227192, 9, 1440x900 
0x37CA2318, 38092267390643528, 226227252, 226227260, 8, 1440x900 
0x37CA2318, 38092267391295568, 226227317, 226227326, 9, 1440x900 
0x37CA2318, 38092267391958960, 226227382, 226227391, 9, 1440x900 
0x37CA2318, 38092267392619656, 226227448, 226227457, 9, 1440x900 
0x37CA2318, 38092267393279880, 226227518, 226227526, 8, 1440x900 
0x37CA2318, 38092267393944000, 226227582, 226227591, 9, 1440x900 
0x37CA2318, 38092267394596184, 226227652, 226227660, 8, 1440x900 
0x37CA2318, 38092267395259440, 226227713, 226227722, 9, 1440x900 
0x37CA2318, 38092267395920960, 226227782, 226227790, 8, 1440x900 
0x37CA2318, 38092267396591424, 226227848, 226227856, 8, 1440x900 
0x37CA2318, 38092267397249216, 226227913, 226227921, 8, 1440x900 
0x37CA2318, 38092267397911760, 226227978, 226227987, 9, 1440x900 
0x37CA2318, 38092267398580696, 226228047, 226228055, 8, 1440x900 
0x37CA2318, 38092267399242144, 226228113, 226228121, 8, 1440x900 
0x37CA2318, 38092267399893744, 226228177, 226228185, 8, 1440x900 
0x37CA2318, 38092267400547056, 226228243, 226228251, 8, 1440x900 
0x37CA2318, 38092267401225528, 226228312, 226228320, 8, 1440x900 
0x37CA2318, 38092267401880552, 226228378, 226228386, 8, 1440x900 
0x37CA2318, 38092267402542368, 226228443, 226228451, 8, 1440x900 
0x37CA2318, 38092267403194920, 226228508, 226228515, 7, 1440x900 
0x37CA2318, 38092267403864536, 226228573, 226228581, 8, 1440x900 
0x37CA2318, 38092267404522680, 226228643, 226228651, 8, 1440x900 
0x37CA2318, 38092267405178496, 226228708, 226228715, 7, 1440x900 
0x37CA2318, 38092267405844464, 226228773, 226228781, 8, 1440x900 
0x37CA2318, 38092267406505832, 226228843, 226228851, 8, 1440x900 
0x37CA2318, 38092267407175704, 226228903, 226228911, 8, 1440x900 
0x37CA2318, 38092267407826856, 226228973, 226228981, 8, 1440x900 
0x37CA2318, 38092267408489824, 226229038, 226229047, 9, 1440x900 
0x37CA2318, 38092267409155544, 226229107, 226229114, 7, 1440x900 
0x37CA2318, 38092267409807280, 226229167, 226229174, 7, 1440x900 
0x37CA2318, 38092267410466856, 226229238, 226229246, 8, 1440x900 
0x37CA2318, 38092267411128368, 226229303, 226229311, 8, 1440x900 
0x37CA2318, 38092267411781328, 226229368, 226229376, 8, 1440x900 
0x37CA2318, 38092267412450984, 226229432, 226229440, 8, 1440x900 
0x37CA2318, 38092267413113248, 226229498, 226229507, 9, 1440x900 
0x37CA2318, 38092267413781464, 226229568, 226229576, 8, 1440x900 
0x37CA2318, 38092267414435128, 226229634, 226229642, 8, 1440x900 
0x37CA2318, 38092267415092304, 226229698, 226229706, 8, 1440x900 
0x37CA2318, 38092267415763072, 226229767, 226229775, 8, 1440x900 
0x37CA2318, 38092267416423736, 226229833, 226229841, 8, 1440x900 
0x37CA2318, 38092267417086072, 226229897, 226229905, 8, 1440x900 
0x37CA2318, 38092267417733328, 226229962, 226229970, 8, 1440x900 
0x37CA2318, 38092267418399784, 226230027, 226230035, 8, 1440x900 
0x37CA2318, 38092267419053120, 226230092, 226230100, 8, 1440x900 
0x37CA2318, 38092267419722424, 226230162, 226230170, 8, 1440x900 
0x37CA2318, 38092267420382992, 226230228, 226230236, 8, 1440x900 
0x37CA2318, 38092267421036112, 226230293, 226230300, 7, 1440x900 
0x37CA2318, 38092267421709728, 226230357, 226230366, 9, 1440x900 
0x37CA2318, 38092267422369384, 226230423, 226230432, 9, 1440x900 
0x37CA2318, 38092267423039232, 226230492, 226230500, 8, 1440x900 
0x37CA2318, 38092267423690304, 226230558, 226230566, 8, 1440x900 
0x37CA2318, 38092267424352160, 226230622, 226230630, 8, 1440x900 
0x37CA2318, 38092267425021272, 226230693, 226230701, 8, 1440x900 
0x37CA2318, 38092267425672896, 226230757, 226230765, 8, 1440x900 
0x37CA2318, 38092267426333160, 226230822, 226230830, 8, 1440x900 
0x37CA2318, 38092267426993264, 226230887, 226230895, 8, 1440x900 
0x37CA2318, 38092267427662528, 226230953, 226230960, 7, 1440x900 
0x37CA2318, 38092267428320488, 226231018, 226231024, 6, 1440x900 
0x37CA2318, 38092267428982600, 226231083, 226231090, 7, 1440x900 
0x37CA2318, 38092267429642960, 226231153, 226231161, 8, 1440x900 
0x37CA2318, 38092267430297400, 226231217, 226231225, 8, 1440x900 
0x37CA2318, 38092267430955800, 226231283, 226231291, 8, 1440x900 
0x37CA2318, 38092267431608544, 226231352, 226231360, 8, 1440x900 
0x37CA2318, 38092267432278600, 226231418, 226231425, 7, 1440x900 
0x37CA2318, 38092267432941312, 226231482, 226231490, 8, 1440x900 
0x37CA2318, 38092267433593856, 226231549, 226231558, 9, 1440x900 
0x37CA2318, 38092267434257560, 226231613, 226231621, 8, 1440x900 
0x37CA2318, 38092267434925152, 226231683, 226231691, 8, 1440x900 
0x37CA2318, 38092267435580904, 226231748, 226231756, 8, 1440x900 
0x37CA2318, 38092267436237936, 226231812, 226231820, 8, 1440x900 
0x37CA2318, 38092267436908752, 226231878, 226231886, 8, 1440x900 
0x37CA2318, 38092267437564360, 226231943, 226231951, 8, 1440x900 
0x37CA2318, 38092267438241896, 226232012, 226232020, 8, 1440x900 
0x37CA2318, 38092267438895344, 226232078, 226232086, 8, 1440x900 
0x37CA2318, 38092267439549544, 226232142, 226232149, 7, 1440x900 
0x37CA2318, 38092267440211680, 226232207, 226232214, 7, 1440x900 
0x37CA2318, 38092267440876896, 226232277, 226232285, 8, 1440x900 
0x37CA2318, 38092267441536704, 226232343, 226232351, 8, 1440x900 
0x37CA2318, 38092267442196096, 226232407, 226232415, 8, 1440x900 
0x37CA2318, 38092267442856888, 226232473, 226232481, 8, 1440x900 
0x37CA2318, 38092267443517304, 226232538, 226232547, 9, 1440x900 
0x37CA2318, 38092267444178680, 226232608, 226232616, 8, 1440x900 
0x37CA2318, 38092267444840376, 226232673, 226232681, 8, 1440x900 
0x37CA2318, 38092267445510800, 226232742, 226232750, 8, 1440x900 
0x37CA2318, 38092267446161376, 226232807, 226232815, 8, 1440x900 
0x37CA2318, 38092267446831520, 226232873, 226232881, 8, 1440x900 
0x37CA2318, 38092267447490984, 226232937, 226232945, 8, 1440x900 
0x37CA2318, 38092267448142240, 226233002, 226233010, 8, 1440x900 
0x37CA2318, 38092267448802208, 226233069, 226233077, 8, 1440x900 
0x37CA2318, 38092267449465520, 226233137, 226233145, 8, 1440x900 
0x37CA2318, 38092267450120376, 226233202, 226233210, 8, 1440x900 
0x37CA2318, 38092267450791112, 226233268, 226233276, 8, 1440x900 
0x37CA2318, 38092267451443344, 226233332, 226233340, 8, 1440x900 
0x37CA2318, 38092267452114776, 226233403, 226233412, 9, 1440x900 
0x37CA2318, 38092267452764720, 226233468, 226233475, 7, 1440x900 
0x37CA2318, 38092267453425632, 226233533, 226233541, 8, 1440x900 
0x37CA2318, 38092267454086512, 226233597, 226233605, 8, 1440x900 
0x37CA2318, 38092267454741776, 226233667, 226233676, 9, 1440x900 
0x37CA2318, 38092267455891032, 226233777, 226233784, 7, 1440x900 
0x37CA2318, 38092267456746408, 226233863, 226233871, 8, 1440x900 
0x37CA2318, 38092267457399560, 226233928, 226233936, 8, 1440x900 
0x37CA2318, 38092267458076256, 226233998, 226234006, 8, 1440x900 
0x37CA2318, 38092267458745640, 226234062, 226234069, 7, 1440x900 
0x37CA2318, 38092267459394576, 226234129, 226234137, 8, 1440x900 
0x37CA2318, 38092267460065024, 226234198, 226234206, 8, 1440x900 
0x37CA2318, 38092267460726600, 226234258, 226234266, 8, 1440x900 
0x37CA2318, 38092267461384240, 226234328, 226234335, 7, 1440x900 
0x37CA2318, 38092267462047456, 226234392, 226234401, 9, 1440x900 
0x37CA2318, 38092267462708136, 226234462, 226234470, 8, 1440x900 
0x37CA2318, 38092267463361344, 226234523, 226234531, 8, 1440x900 
0x37CA2318, 38092267464035664, 226234592, 226234600, 8, 1440x900 
0x37CA2318, 38092267464700120, 226234662, 226234670, 8, 1440x900 
0x37CA2318, 38092267465370080, 226234728, 226234736, 8, 1440x900 
0x37CA2318, 38092267466030480, 226234793, 226234801, 8, 1440x900 
0x37CA2318, 38092267466682640, 226234857, 226234865, 8, 1440x900 
0x37CA2318, 38092267467342728, 226234922, 226234930, 8, 1440x900 
0x37CA2318, 38092267468003832, 226234987, 226234995, 8, 1440x900 
0x37CA2318, 38092267468668128, 226235053, 226235062, 9, 1440x900 
0x37CA2318, 38092267469328544, 226235122, 226235130, 8, 1440x900 
0x37CA2318, 38092267469990048, 226235187, 226235195, 8, 1440x900 
0x37CA2318, 38092267470652096, 226235253, 226235261, 8, 1440x900 
0x37CA2318, 38092267471302584, 226235317, 226235324, 7, 1440x900 
0x37CA2318, 38092267471973584, 226235383, 226235390, 7, 1440x900 
0x37CA2318, 38092267472636968, 226235451, 226235458, 7, 1440x900 
0x37CA2318, 38092267473291872, 226235517, 226235525, 8, 1440x900 
0x37CA2318, 38092267473950536, 226235582, 226235591, 9, 1440x900 
0x37CA2318, 38092267474612456, 226235652, 226235660, 8, 1440x900 
0x37CA2318, 38092267475273096, 226235718, 226235726, 8, 1440x900 
0x37CA2318, 38092267475935496, 226235787, 226235795, 8, 1440x900 
0x37CA2318, 38092267476589288, 226235848, 226235856, 8, 1440x900 
0x37CA2318, 38092267477259136, 226235917, 226235925, 8, 1440x900 
0x37CA2318, 38092267477913392, 226235977, 226235985, 8, 1440x900 
0x37CA2318, 38092267478576088, 226236046, 226236054, 8, 1440x900 
0x37CA2318, 38092267479244248, 226236113, 226236122, 9, 1440x900 
0x37CA2318, 38092267479906216, 226236182, 226236189, 7, 1440x900 
0x37CA2318, 38092267480568776, 226236248, 226236256, 8, 1440x900 
0x37CA2318, 38092267481237968, 226236312, 226236320, 8, 1440x900 
0x37CA2318, 38092267481898504, 226236378, 226236387, 9, 1440x900 
0x37CA2318, 38092267482558448, 226236447, 226236455, 8, 1440x900 
0x37CA2318, 38092267483219048, 226236512, 226236520, 8, 1440x900 
0x37CA2318, 38092267483878040, 226236578, 226236586, 8, 1440x900 
0x37CA2318, 38092267484531488, 226236642, 226236650, 8, 1440x900 
0x37CA2318, 38092267485191936, 226236707, 226236715, 8, 1440x900 
0x37CA2318, 38092267485861600, 226236772, 226236780, 8, 1440x900 
0x37CA2318, 38092267486515552, 226236843, 226236851, 8, 1440x900 
0x37CA2318, 38092267487175856, 226236903, 226236911, 8, 1440x900 
0x37CA2318, 38092267487838152, 226236972, 226236980, 8, 1440x900 
0x37CA2318, 38092267488500272, 226237037, 226237044, 7, 1440x900 
0x37CA2318, 38092267489168792, 226237104, 226237112, 8, 1440x900 
0x37CA2318, 38092267489820536, 226237168, 226237175, 7, 1440x900 
0x37CA2318, 38092267490482840, 226237233, 226237241, 8, 1440x900 
0x37CA2318, 38092267491134888, 226237298, 226237306, 8, 1440x900 
0x37CA2318, 38092267491804160, 226237368, 226237375, 7, 1440x900 
0x37CA2318, 38092267492456248, 226237432, 226237439, 7, 1440x900 
0x37CA2318, 38092267493119168, 226237498, 226237504, 6, 1440x900 
0x37CA2318, 38092267493782864, 226237567, 226237575, 8, 1440x900 
0x37CA2318, 38092267494448808, 226237633, 226237641, 8, 1440x900 
0x37CA2318, 38092267495093104, 226237697, 226237706, 9, 1440x900 
0x37CA2318, 38092267495760624, 226237762, 226237771, 9, 1440x900 
0x37CA2318, 38092267496415656, 226237828, 226237837, 9, 1440x900 
0x37CA2318, 38092267497094744, 226237899, 226237907, 8, 1440x900 
0x37CA2318, 38092267497746880, 226237963, 226237971, 8, 1440x900 
0x37CA2318, 38092267498399464, 226238027, 226238035, 8, 1440x900 
0x37CA2318, 38092267499072800, 226238098, 226238106, 8, 1440x900 
0x37CA2318, 38092267499734240, 226238164, 226238172, 8, 1440x900 
0x37CA2318, 38092267500385936, 226238228, 226238236, 8, 1440x900 
0x37CA2318, 38092267501056144, 226238297, 226238305, 8, 1440x900 
0x37CA2318, 38092267501707432, 226238362, 226238370, 8, 1440x900 
0x37CA2318, 38092267502369544, 226238428, 226238436, 8, 1440x900 
0x37CA2318, 38092267503039048, 226238492, 226238500, 8, 1440x900 
0x37CA2318, 38092267503689384, 226238553, 226238561, 8, 1440x900 
0x37CA2318, 38092267504353248, 226238622, 226238630, 8, 1440x900 
0x37CA2318, 38092267505018400, 226238692, 226238700, 8, 1440x900 
0x37CA2318, 38092267505674512, 226238753, 226238761, 8, 1440x900 
0x37CA2318, 38092267506328592, 226238818, 226238825, 7, 1440x900 
0x37CA2318, 38092267506999792, 226238887, 226238895, 8, 1440x900 
0x37CA2318, 38092267507656144, 226238953, 226238962, 9, 1440x900 
0x37CA2318, 38092267508322448, 226239023, 226239031, 8, 1440x900 
0x37CA2318, 38092267508977944, 226239087, 226239095, 8, 1440x900 
0x37CA2318, 38092267509640488, 226239152, 226239160, 8, 1440x900 
0x37CA2318, 38092267510301376, 226239218, 226239225, 7, 1440x900 
0x37CA2318, 38092267510963144, 226239287, 226239295, 8, 1440x900 
0x37CA2318, 38092267511616320, 226239353, 226239361, 8, 1440x900 
0x37CA2318, 38092267512278048, 226239417, 226239425, 8, 1440x900 
0x37CA2318, 38092267512948056, 226239483, 226239491, 8, 1440x900 
0x37CA2318, 38092267513608144, 226239549, 226239556, 7, 1440x900 
0x37CA2318, 38092267514276440, 226239613, 226239621, 8, 1440x900 
0x37CA2318, 38092267514928112, 226239682, 226239690, 8, 1440x900 
0x37CA2318, 38092267515595088, 226239748, 226239756, 8, 1440x900 
0x37CA2318, 38092267516248208, 226239817, 226239825, 8, 1440x900 
0x37CA2318, 38092267516913008, 226239878, 226239886, 8, 1440x900 
0x37CA2318, 38092267517564368, 226239948, 226239956, 8, 1440x900 
0x37CA2318, 38092267518240328, 226240013, 226240021, 8, 1440x900 
0x37CA2318, 38092267518894072, 226240079, 226240087, 8, 1440x900 
0x37CA2318, 38092267519555192, 226240147, 226240155, 8, 1440x900 
0x37CA2318, 38092267520216624, 226240213, 226240221, 8, 1440x900 
0x37CA2318, 38092267520884304, 226240277, 226240285, 8, 1440x900 
0x37CA2318, 38092267521542720, 226240342, 226240351, 9, 1440x900 
0x37CA2318, 38092267522204424, 226240408, 226240416, 8, 1440x900 
0x37CA2318, 38092267522871448, 226240477, 226240485, 8, 1440x900 
0x37CA2318, 38092267523528240, 226240543, 226240551, 8, 1440x900 
0x37CA2318, 38092267524193520, 226240607, 226240615, 8, 1440x900 
0x37CA2318, 38092267524850584, 226240673, 226240681, 8, 1440x900 
0x37CA2318, 38092267525503088, 226240738, 226240747, 9, 1440x900 
0x37CA2318, 38092267526172792, 226240802, 226240810, 8, 1440x900 
0x37CA2318, 38092267526833728, 226240873, 226240880, 7, 1440x900 
0x37CA2318, 38092267527502048, 226240937, 226240944, 7, 1440x900 
0x37CA2318, 38092267528171648, 226241002, 226241009, 7, 1440x900 
0x37CA2318, 38092267528822480, 226241068, 226241076, 8, 1440x900 
0x37CA2318, 38092267529492616, 226241139, 226241148, 9, 1440x900 
0x37CA2318, 38092267530135976, 226241203, 226241210, 7, 1440x900 
0x37CA2318, 38092267530802136, 226241268, 226241276, 8, 1440x900 
0x37CA2318, 38092267531464488, 226241333, 226241342, 9, 1440x900 
0x37CA2318, 38092267532121608, 226241402, 226241410, 8, 1440x900 
0x37CA2318, 38092267532797712, 226241468, 226241476, 8, 1440x900 
0x37CA2318, 38092267533450992, 226241532, 226241540, 8, 1440x900 
0x37CA2318, 38092267534110416, 226241598, 226241606, 8, 1440x900 
0x37CA2318, 38092267534781488, 226241668, 226241676, 8, 1440x900 
0x37CA2318, 38092267535451072, 226241732, 226241739, 7, 1440x900 
0x37CA2318, 38092267536102688, 226241797, 226241804, 7, 1440x900 
0x37CA2318, 38092267536768448, 226241862, 226241871, 9, 1440x900 
0x37CA2318, 38092267537423168, 226241933, 226241941, 8, 1440x900 
0x37CA2318, 38092267538082496, 226241996, 226242003, 7, 1440x900 
0x37CA2318, 38092267539402496, 226242128, 226242136, 8, 1440x900 
0x37CA2318, 38092267540065256, 226242194, 226242202, 8, 1440x900 
0x37CA2318, 38092267540724880, 226242263, 226242271, 8, 1440x900 
0x37CA2318, 38092267541385880, 226242328, 226242336, 8, 1440x900 
0x37CA2318, 38092267542045984, 226242393, 226242402, 9, 1440x900 
0x37CA2318, 38092267542699568, 226242457, 226242466, 9, 1440x900 
0x37CA2318, 38092267543365776, 226242527, 226242535, 8, 1440x900 
0x37CA2318, 38092267544027520, 226242592, 226242600, 8, 1440x900 
0x37CA2318, 38092267544679752, 226242658, 226242666, 8, 1440x900 
0x37CA2318, 38092267545341416, 226242722, 226242731, 9, 1440x900 
0x37CA2318, 38092267546017152, 226242787, 226242795, 8, 1440x900 
0x37CA2318, 38092267546670016, 226242857, 226242865, 8, 1440x900 
0x37CA2318, 38092267547331576, 226242922, 226242930, 8, 1440x900 
0x37CA2318, 38092267547990208, 226242988, 226242996, 8, 1440x900 
0x37CA2318, 38092267548651432, 226243052, 226243060, 8, 1440x900 
0x37CA2318, 38092267549317952, 226243122, 226243130, 8, 1440x900 
0x37CA2318, 38092267549976704, 226243187, 226243194, 7, 1440x900 
0x37CA2318, 38092267550635232, 226243254, 226243262, 8, 1440x900 
0x37CA2318, 38092267551308144, 226243318, 226243327, 9, 1440x900 
0x37CA2318, 38092267551968112, 226243383, 226243390, 7, 1440x900 
0x37CA2318, 38092267552638192, 226243453, 226243461, 8, 1440x900 
0x37CA2318, 38092267553298112, 226243517, 226243526, 9, 1440x900 
0x37CA2318, 38092267553947880, 226243587, 226243595, 8, 1440x900 
0x37CA2318, 38092267554608880, 226243652, 226243660, 8, 1440x900 
0x37CA2318, 38092267555270368, 226243718, 226243726, 8, 1440x900 
0x37CA2318, 38092267555929960, 226243778, 226243786, 8, 1440x900 
0x37CA2318, 38092267556591912, 226243847, 226243856, 9, 1440x900 
0x37CA2318, 38092267557258952, 226243913, 226243922, 9, 1440x900 
0x37CA2318, 38092267557910032, 226243978, 226243986, 8, 1440x900 
0x37CA2318, 38092267558572496, 226244048, 226244056, 8, 1440x900 
0x37CA2318, 38092267559230232, 226244113, 226244121, 8, 1440x900 
0x37CA2318, 38092267559901792, 226244178, 226244186, 8, 1440x900 
0x37CA2318, 38092267560550784, 226244242, 226244250, 8, 1440x900 
0x37CA2318, 38092267561212272, 226244308, 226244317, 9, 1440x900 
0x37CA2318, 38092267561879576, 226244378, 226244386, 8, 1440x900 
0x37CA2318, 38092267562532696, 226244443, 226244451, 8, 1440x900 
0x37CA2318, 38092267563195680, 226244508, 226244516, 8, 1440x900 
0x37CA2318, 38092267563853320, 226244577, 226244585, 8, 1440x900 
0x37CA2318, 38092267564515048, 226244642, 226244651, 9, 1440x900 
0x37CA2318, 38092267565175288, 226244708, 226244716, 8, 1440x900 
0x37CA2318, 38092267565837424, 226244773, 226244781, 8, 1440x900 
0x37CA2318, 38092267566496256, 226244837, 226244844, 7, 1440x900 
0x37CA2318, 38092267567157464, 226244901, 226244908, 7, 1440x900 
0x37CA2318, 38092267567819024, 226244967, 226244974, 7, 1440x900 
0x37CA2318, 38092267568489256, 226245037, 226245045, 8, 1440x900 
0x37CA2318, 38092267569138096, 226245102, 226245110, 8, 1440x900 
0x37CA2318, 38092267569799616, 226245173, 226245181, 8, 1440x900 
0x37CA2318, 38092267570461008, 226245232, 226245240, 8, 1440x900 
0x37CA2318, 38092267571118752, 226245298, 226245305, 7, 1440x900 
0x37CA2318, 38092267571780592, 226245363, 226245371, 8, 1440x900 
0x37CA2318, 38092267572439272, 226245432, 226245440, 8, 1440x900 
0x37CA2318, 38092267573118776, 226245499, 226245507, 8, 1440x900 
0x37CA2318, 38092267573766392, 226245563, 226245570, 7, 1440x900 
0x37CA2318, 38092267574442648, 226245633, 226245641, 8, 1440x900 
0x37CA2318, 38092267575092336, 226245697, 226245705, 8, 1440x900 
0x37CA2318, 38092267575754952, 226245764, 226245771, 7, 1440x900 
0x37CA2318, 38092267576415120, 226245830, 226245838, 8, 1440x900 
0x37CA2318, 38092267577075184, 226245893, 226245900, 7, 1440x900 
0x37CA2318, 38092267577728032, 226245962, 226245970, 8, 1440x900 
0x37CA2318, 38092267578398448, 226246027, 226246036, 9, 1440x900 
0x37CA2318, 38092267579069608, 226246093, 226246102, 9, 1440x900 
0x37CA2318, 38092267579721768, 226246162, 226246170, 8, 1440x900 
0x37CA2318, 38092267580382032, 226246228, 226246236, 8, 1440x900 
0x37CA2318, 38092267581045072, 226246293, 226246301, 8, 1440x900 
0x37CA2318, 38092267581699000, 226246362, 226246370, 8, 1440x900 
0x37CA2318, 38092267582361480, 226246423, 226246432, 9, 1440x900 
0x37CA2318, 38092267583026416, 226246493, 226246501, 8, 1440x900 
0x37CA2318, 38092267583677144, 226246558, 226246566, 8, 1440x900 
0x37CA2318, 38092267584347480, 226246622, 226246630, 8, 1440x900 
0x37CA2318, 38092267585001136, 226246688, 226246696, 8, 1440x900 
0x37CA2318, 38092267585664144, 226246758, 226246766, 8, 1440x900 
0x37CA2318, 38092267586327248, 226246823, 226246830, 7, 1440x900 
0x37CA2318, 38092267586990832, 226246888, 226246896, 8, 1440x900 
0x37CA2318, 38092267587650288, 226246952, 226246959, 7, 1440x900 
0x37CA2318, 38092267588310512, 226247017, 226247024, 7, 1440x900 
0x37CA2318, 38092267588971544, 226247088, 226247096, 8, 1440x900 
0x37CA2318, 38092267589622136, 226247152, 226247160, 8, 1440x900 
0x37CA2318, 38092267590292280, 226247218, 226247226, 8, 1440x900 
0x37CA2318, 38092267590950608, 226247283, 226247291, 8, 1440x900 
0x37CA2318, 38092267591609832, 226247347, 226247355, 8, 1440x900 
0x37CA2318, 38092267592281552, 226247418, 226247426, 8, 1440x900 
0x37CA2318, 38092267592932672, 226247483, 226247491, 8, 1440x900 
0x37CA2318, 38092267593601776, 226247553, 226247561, 8, 1440x900 
0x37CA2318, 38092267594256096, 226247617, 226247625, 8, 1440x900 
0x37CA2318, 38092267594915184, 226247683, 226247691, 8, 1440x900 
0x37CA2318, 38092267595575472, 226247748, 226247756, 8, 1440x900 
0x37CA2318, 38092267596239032, 226247813, 226247821, 8, 1440x900 
0x37CA2318, 38092267596908768, 226247883, 226247891, 8, 1440x900 
0x37CA2318, 38092267597569752, 226247948, 226247956, 8, 1440x900 
0x37CA2318, 38092267598228024, 226248008, 226248015, 7, 1440x900 
0x37CA2318, 38092267598880464, 226248077, 226248085, 8, 1440x900 
0x37CA2318, 38092267599541184, 226248143, 226248151, 8, 1440x900 
0x37CA2318, 38092267600201480, 226248207, 226248216, 9, 1440x900 
0x37CA2318, 38092267600862032, 226248273, 226248282, 9, 1440x900 
0x37CA2318, 38092267601526224, 226248341, 226248348, 7, 1440x900 
0x37CA2318, 38092267602657128, 226248453, 226248461, 8, 1440x900 
0x37CA2318, 38092267603502424, 226248537, 226248545, 8, 1440x900 
0x37CA2318, 38092267604172488, 226248604, 226248612, 8, 1440x900 
0x37CA2318, 38092267604823352, 226248672, 226248680, 8, 1440x900 
0x37CA2318, 38092267605485680, 226248738, 226248746, 8, 1440x900 
0x37CA2318, 38092267606154672, 226248808, 226248816, 8, 1440x900 
0x37CA2318, 38092267606804968, 226248868, 226248875, 7, 1440x900 
0x37CA2318, 38092267607466096, 226248933, 226248940, 7, 1440x900 
0x37CA2318, 38092267608125736, 226248998, 226249006, 8, 1440x900 
0x37CA2318, 38092267608795048, 226249068, 226249076, 8, 1440x900 
0x37CA2318, 38092267609447512, 226249138, 226249146, 8, 1440x900 
0x37CA2318, 38092267610105440, 226249203, 226249211, 8, 1440x900 
0x37CA2318, 38092267610774176, 226249264, 226249271, 7, 1440x900 
0x37CA2318, 38092267611434808, 226249333, 226249340, 7, 1440x900 
0x37CA2318, 38092267612102936, 226249397, 226249405, 8, 1440x900 
0x37CA2318, 38092267612765176, 226249464, 226249473, 9, 1440x900 
0x37CA2318, 38092267613415976, 226249528, 226249537, 9, 1440x900 
0x37CA2318, 38092267614077008, 226249598, 226249606, 8, 1440x900 
0x37CA2318, 38092267614737952, 226249663, 226249671, 8, 1440x900 
0x37CA2318, 38092267615407344, 226249729, 226249736, 7, 1440x900 
0x37CA2318, 38092267616058488, 226249797, 226249805, 8, 1440x900 
0x37CA2318, 38092267616725232, 226249863, 226249871, 8, 1440x900 
0x37CA2318, 38092267617386528, 226249928, 226249936, 8, 1440x900 
0x37CA2318, 38092267618045960, 226249992, 226250000, 8, 1440x900 
0x37CA2318, 38092267618706896, 226250058, 226250065, 7, 1440x900 
0x37CA2318, 38092267619375584, 226250127, 226250135, 8, 1440x900 
0x37CA2318, 38092267620027664, 226250191, 226250199, 8, 1440x900 
0x37CA2318, 38092267620680536, 226250257, 226250265, 8, 1440x900 
0x37CA2318, 38092267621358344, 226250327, 226250335, 8, 1440x900 
0x37CA2318, 38092267622010904, 226250387, 226250395, 8, 1440x900 
0x37CA2318, 38092267622672392, 226250458, 226250466, 8, 1440x900 
0x37CA2318, 38092267623333232, 226250523, 226250531, 8, 1440x900 
0x37CA2318, 38092267623994320, 226250588, 226250596, 8, 1440x900 
0x37CA2318, 38092267624653728, 226250659, 226250667, 8, 1440x900 
0x37CA2318, 38092267625314840, 226250722, 226250730, 8, 1440x900 
0x37CA2318, 38092267625975776, 226250787, 226250795, 8, 1440x900 
0x37CA2318, 38092267626635736, 226250853, 226250861, 8, 1440x900 
0x37CA2318, 38092267627286440, 226250918, 226250926, 8, 1440x900 
0x37CA2318, 38092267627956056, 226250982, 226250990, 8, 1440x900 
0x37CA2318, 38092267628619272, 226251053, 226251061, 8, 1440x900 
0x37CA2318, 38092267629278216, 226251113, 226251120, 7, 1440x900 
0x37CA2318, 38092267629931136, 226251182, 226251190, 8, 1440x900 
0x37CA2318, 38092267630598880, 226251248, 226251255, 7, 1440x900 
0x37CA2318, 38092267631261912, 226251313, 226251322, 9, 1440x900 
0x37CA2318, 38092267631914632, 226251383, 226251391, 8, 1440x900 
0x37CA2318, 38092267632583696, 226251447, 226251455, 8, 1440x900 
0x37CA2318, 38092267633236328, 226251512, 226251520, 8, 1440x900 
0x37CA2318, 38092267633898712, 226251582, 226251590, 8, 1440x900 
0x37CA2318, 38092267634564752, 226251648, 226251655, 7, 1440x900 
0x37CA2318, 38092267635215952, 226251713, 226251721, 8, 1440x900 
0x37CA2318, 38092267635892616, 226251777, 226251785, 8, 1440x900 
0x37CA2318, 38092267636546368, 226251844, 226251852, 8, 1440x900 
0x37CA2318, 38092267637201136, 226251908, 226251916, 8, 1440x900 
0x37CA2318, 38092267637863096, 226251977, 226251986, 9, 1440x900 
0x37CA2318, 38092267638523840, 226252043, 226252051, 8, 1440x900 
0x37CA2318, 38092267639189304, 226252103, 226252111, 8, 1440x900 
0x37CA2318, 38092267639849256, 226252171, 226252178, 7, 1440x900 
0x37CA2318, 38092267640510264, 226252238, 226252247, 9, 1440x900 
0x37CA2318, 38092267641164032, 226252307, 226252315, 8, 1440x900 
0x37CA2318, 38092267641834952, 226252373, 226252381, 8, 1440x900 
0x37CA2318, 38092267642494672, 226252439, 226252446, 7, 1440x900 
0x37CA2318, 38092267643154616, 226252507, 226252515, 8, 1440x900 
0x37CA2318, 38092267643814320, 226252574, 226252581, 7, 1440x900 
0x37CA2318, 38092267644486048, 226252638, 226252646, 8, 1440x900 
0x37CA2318, 38092267645138896, 226252703, 226252711, 8, 1440x900 
0x37CA2318, 38092267645798360, 226252768, 226252776, 8, 1440x900 
0x37CA2318, 38092267646460064, 226252838, 226252846, 8, 1440x900 
0x37CA2318, 38092267647130168, 226252902, 226252910, 8, 1440x900 
0x37CA2318, 38092267647774808, 226252968, 226252975, 7, 1440x900 
0x37CA2318, 38092267648445192, 226253032, 226253040, 8, 1440x900 
0x37CA2318, 38092267649106560, 226253098, 226253106, 8, 1440x900 
0x37CA2318, 38092267649767856, 226253163, 226253171, 8, 1440x900 
0x37CA2318, 38092267650419840, 226253227, 226253234, 7, 1440x900 
0x37CA2318, 38092267651083912, 226253294, 226253302, 8, 1440x900 
0x37CA2318, 38092267651755952, 226253362, 226253369, 7, 1440x900 
0x37CA2318, 38092267652407144, 226253427, 226253434, 7, 1440x900 
0x37CA2318, 38092267653082704, 226253498, 226253505, 7, 1440x900 
0x37CA2318, 38092267653743200, 226253563, 226253571, 8, 1440x900 
0x37CA2318, 38092267654401904, 226253628, 226253637, 9, 1440x900 
0x37CA2318, 38092267655065552, 226253693, 226253700, 7, 1440x900 
0x37CA2318, 38092267655732752, 226253762, 226253770, 8, 1440x900 
0x37CA2318, 38092267656394216, 226253824, 226253831, 7, 1440x900 
0x37CA2318, 38092267657056248, 226253893, 226253901, 8, 1440x900 
0x37CA2318, 38092267657724992, 226253965, 226253973, 8, 1440x900 
0x37CA2318, 38092267658383568, 226254024, 226254032, 8, 1440x900 
0x37CA2318, 38092267659044640, 226254092, 226254099, 7, 1440x900 
0x37CA2318, 38092267659705288, 226254156, 226254163, 7, 1440x900 
0x37CA2318, 38092267660367568, 226254223, 226254230, 7, 1440x900 
0x37CA2318, 38092267661018336, 226254288, 226254295, 7, 1440x900 
0x37CA2318, 38092267661695640, 226254356, 226254364, 8, 1440x900 
0x37CA2318, 38092267662341824, 226254422, 226254430, 8, 1440x900 
0x37CA2318, 38092267663004048, 226254493, 226254505, 12, 1440x900 
0x37CA2318, 38092267663676080, 226254558, 226254565, 7, 1440x900 
0x37CA2318, 38092267664337336, 226254623, 226254631, 8, 1440x900 
0x37CA2318, 38092267665007024, 226254692, 226254700, 8, 1440x900 
0x37CA2318, 38092267665660920, 226254758, 226254766, 8, 1440x900 
0x37CA2318, 38092267666329296, 226254823, 226254831, 8, 1440x900 
0x37CA2318, 38092267666980128, 226254887, 226254895, 8, 1440x900 
0x37CA2318, 38092267667649736, 226254953, 226254961, 8, 1440x900 
0x37CA2318, 38092267668302648, 226255022, 226255030, 8, 1440x900 
0x37CA2318, 38092267668964560, 226255088, 226255097, 9, 1440x900 
0x37CA2318, 38092267669618768, 226255153, 226255161, 8, 1440x900 
0x37CA2318, 38092267670280840, 226255218, 226255226, 8, 1440x900 
0x37CA2318, 38092267670949568, 226255283, 226255291, 8, 1440x900 
0x37CA2318, 38092267671610056, 226255348, 226255358, 10, 1440x900 
0x37CA2318, 38092267672270528, 226255412, 226255420, 8, 1440x900 
0x37CA2318, 38092267672940664, 226255482, 226255490, 8, 1440x900 
0x37CA2318, 38092267673600792, 226255547, 226255556, 9, 1440x900 
0x37CA2318, 38092267674250848, 226255612, 226255620, 8, 1440x900 
0x37CA2318, 38092267674912656, 226255678, 226255687, 9, 1440x900 
0x37CA2318, 38092267675581432, 226255747, 226255756, 9, 1440x900 
0x37CA2318, 38092267676242616, 226255813, 226255821, 8, 1440x900 
0x37CA2318, 38092267676912536, 226255882, 226255890, 8, 1440x900 
0x37CA2318, 38092267677565720, 226255948, 226255956, 8, 1440x900 
0x37CA2318, 38092267678217952, 226256012, 226256020, 8, 1440x900 
0x37CA2318, 38092267678888048, 226256078, 226256086, 8, 1440x900 
0x37CA2318, 38092267679550664, 226256144, 226256152, 8, 1440x900 
0x37CA2318, 38092267680219688, 226256212, 226256220, 8, 1440x900 
0x37CA2318, 38092267680881248, 226256277, 226256285, 8, 1440x900 
0x37CA2318, 38092267681533120, 226256343, 226256351, 8, 1440x900 
0x37CA2318, 38092267682192144, 226256408, 226256416, 8, 1440x900 
0x37CA2318, 38092267682853080, 226256471, 226256478, 7, 1440x900 
0x37CA2318, 38092267683513232, 226256538, 226256546, 8, 1440x900 
0x37CA2318, 38092267684182744, 226256607, 226256615, 8, 1440x900 
0x37CA2318, 38092267684845672, 226256672, 226256681, 9, 1440x900 
0x37CA2318, 38092267686164104, 226256802, 226256812, 10, 1440x900 
0x37CA2318, 38092267686833976, 226256872, 226256880, 8, 1440x900 
0x37CA2318, 38092267687486584, 226256938, 226256946, 8, 1440x900 
0x37CA2318, 38092267688147664, 226257003, 226257011, 8, 1440x900 
0x37CA2318, 38092267688808464, 226257069, 226257077, 8, 1440x900 
0x37CA2318, 38092267689476312, 226257138, 226257146, 8, 1440x900 
0x37CA2318, 38092267690133368, 226257203, 226257211, 8, 1440x900 
0x37CA2318, 38092267690793696, 226257267, 226257275, 8, 1440x900 
0x37CA2318, 38092267691445216, 226257332, 226257340, 8, 1440x900 
0x37CA2318, 38092267692110896, 226257403, 226257411, 8, 1440x900 
0x37CA2318, 38092267692770048, 226257467, 226257475, 8, 1440x900 
0x37CA2318, 38092267693429760, 226257528, 226257535, 7, 1440x900 
0x37CA2318, 38092267694088872, 226257597, 226257605, 8, 1440x900 
0x37CA2318, 38092267694750896, 226257662, 226257671, 9, 1440x900 
0x37CA2318, 38092267695412064, 226257728, 226257736, 8, 1440x900 
0x37CA2318, 38092267696065848, 226257794, 226257802, 8, 1440x900 
0x37CA2318, 38092267696743136, 226257863, 226257871, 8, 1440x900 
0x37CA2318, 38092267697394392, 226257927, 226257936, 9, 1440x900 
0x37CA2318, 38092267698054064, 226257993, 226258001, 8, 1440x900 
0x37CA2318, 38092267698716808, 226258063, 226258071, 8, 1440x900 
0x37CA2318, 38092267699376928, 226258127, 226258135, 8, 1440x900 
0x37CA2318, 38092267700038928, 226258193, 226258201, 8, 1440x900 
0x37CA2318, 38092267700692032, 226258258, 226258266, 8, 1440x900 
0x37CA2318, 38092267701371296, 226258327, 226258335, 8, 1440x900 
0x37CA2318, 38092267702022320, 226258392, 226258400, 8, 1440x900 
0x37CA2318, 38092267702691112, 226258457, 226258465, 8, 1440x900 
0x37CA2318, 38092267703351248, 226258523, 226258531, 8, 1440x900 
0x37CA2318, 38092267704010064, 226258588, 226258597, 9, 1440x900 
0x37CA2318, 38092267704669448, 226258653, 226258661, 8, 1440x900 
0x37CA2318, 38092267705333120, 226258723, 226258731, 8, 1440x900 
0x37CA2318, 38092267705984008, 226258788, 226258796, 8, 1440x900 
0x37CA2318, 38092267706653136, 226258857, 226258865, 8, 1440x900 
0x37CA2318, 38092267707307416, 226258923, 226258931, 8, 1440x900 
0x37CA2318, 38092267707968904, 226258983, 226258992, 9, 1440x900 
0x37CA2318, 38092267708620912, 226259052, 226259060, 8, 1440x900 
0x37CA2318, 38092267709288064, 226259118, 226259127, 9, 1440x900 
0x37CA2318, 38092267709948496, 226259182, 226259189, 7, 1440x900 
0x37CA2318, 38092267710610144, 226259248, 226259257, 9, 1440x900 
0x37CA2318, 38092267711262008, 226259317, 226259325, 8, 1440x900 
0x37CA2318, 38092267711932064, 226259383, 226259391, 8, 1440x900 
0x37CA2318, 38092267712596136, 226259448, 226259456, 8, 1440x900 
0x37CA2318, 38092267713253888, 226259512, 226259521, 9, 1440x900 
0x37CA2318, 38092267713906840, 226259582, 226259590, 8, 1440x900 
0x37CA2318, 38092267714572456, 226259648, 226259656, 8, 1440x900 
0x37CA2318, 38092267715233776, 226259708, 226259716, 8, 1440x900 
0x37CA2318, 38092267715897600, 226259777, 226259785, 8, 1440x900 
0x37CA2318, 38092267716549904, 226259847, 226259855, 8, 1440x900 
0x37CA2318, 38092267717221752, 226259913, 226259921, 8, 1440x900 
0x37CA2318, 38092267717881120, 226259978, 226259986, 8, 1440x900 
0x37CA2318, 38092267718543056, 226260043, 226260051, 8, 1440x900 
0x37CA2318, 38092267719192992, 226260108, 226260116, 8, 1440x900 
0x37CA2318, 38092267719852464, 226260172, 226260179, 7, 1440x900 
0x37CA2318, 38092267720529760, 226260242, 226260250, 8, 1440x900 
0x37CA2318, 38092267721181424, 226260306, 226260313, 7, 1440x900 
0x37CA2318, 38092267721836456, 226260371, 226260378, 7, 1440x900 
0x37CA2318, 38092267722535368, 226260438, 226260445, 7, 1440x900 
0x37CA2318, 38092267723157928, 226260503, 226260510, 7, 1440x900 
0x37CA2318, 38092267723836936, 226260573, 226260580, 7, 1440x900 
0x37CA2318, 38092267724505464, 226260637, 226260644, 7, 1440x900 
0x37CA2318, 38092267725156040, 226260702, 226260709, 7, 1440x900 
0x37CA2318, 38092267725816792, 226260767, 226260775, 8, 1440x900 
0x37CA2318, 38092267726486080, 226260837, 226260844, 7, 1440x900 
0x37CA2318, 38092267727136800, 226260902, 226260910, 8, 1440x900 
0x37CA2318, 38092267727801288, 226260966, 226260974, 8, 1440x900 
0x37CA2318, 38092267728466712, 226261038, 226261046, 8, 1440x900 
0x37CA2318, 38092267729118552, 226261103, 226261111, 8, 1440x900 
0x37CA2318, 38092267729786456, 226261167, 226261175, 8, 1440x900 
0x37CA2318, 38092267730455848, 226261233, 226261240, 7, 1440x900 
0x37CA2318, 38092267731114448, 226261298, 226261305, 7, 1440x900 
0x37CA2318, 38092267731767200, 226261363, 226261372, 9, 1440x900 
0x37CA2318, 38092267732421408, 226261433, 226261441, 8, 1440x900 
0x37CA2318, 38092267733091328, 226261498, 226261504, 6, 1440x900 
0x37CA2318, 38092267733558448, 226261542, 226261549, 7, 1440x900 
0x37CA2318, 38092267734403616, 226261627, 226261634, 7, 1440x900 
0x37CA2318, 38092267735074248, 226261693, 226261700, 7, 1440x900 
0x37CA2318, 38092267735725392, 226261758, 226261765, 7, 1440x900 
0x37CA2318, 38092267736396272, 226261827, 226261834, 7, 1440x900 
0x37CA2318, 38092267737065552, 226261897, 226261905, 8, 1440x900 
0x37CA2318, 38092267737725016, 226261960, 226261968, 8, 1440x900 
0x37CA2318, 38092267738387712, 226262028, 226262036, 8, 1440x900 
0x37CA2318, 38092267739037760, 226262093, 226262101, 8, 1440x900 
0x37CA2318, 38092267739699464, 226262158, 226262166, 8, 1440x900 
0x37CA2318, 38092267740357576, 226262227, 226262234, 7, 1440x900 
0x37CA2318, 38092267741020696, 226262292, 226262300, 8, 1440x900 
0x37CA2318, 38092267741679840, 226262358, 226262366, 8, 1440x900 
0x37CA2318, 38092267742337480, 226262423, 226262431, 8, 1440x900 
0x37CA2318, 38092267743667880, 226262553, 226262562, 9, 1440x900 
0x37CA2318, 38092267744328288, 226262623, 226262631, 8, 1440x900 
0x37CA2318, 38092267744987336, 226262687, 226262695, 8, 1440x900 
0x37CA2318, 38092267745639944, 226262753, 226262762, 9, 1440x900 
0x37CA2318, 38092267746301896, 226262818, 226262827, 9, 1440x900 
0x37CA2318, 38092267746962160, 226262882, 226262890, 8, 1440x900 
0x37CA2318, 38092267747614824, 226262948, 226262957, 9, 1440x900 
0x37CA2318, 38092267748285224, 226263018, 226263026, 8, 1440x900 
0x37CA2318, 38092267748949640, 226263083, 226263091, 8, 1440x900 
0x37CA2318, 38092267749608832, 226263152, 226263160, 8, 1440x900 
0x37CA2318, 38092267750263856, 226263214, 226263222, 8, 1440x900 
0x37CA2318, 38092267750923312, 226263278, 226263287, 9, 1440x900 
0x37CA2318, 38092267751594624, 226263347, 226263355, 8, 1440x900 
0x37CA2318, 38092267752257336, 226263418, 226263426, 8, 1440x900 
0x37CA2318, 38092267752911480, 226263477, 226263486, 9, 1440x900 
0x37CA2318, 38092267753577288, 226263547, 226263554, 7, 1440x900 
0x37CA2318, 38092267754228736, 226263612, 226263620, 8, 1440x900 
0x37CA2318, 38092267754909528, 226263680, 226263690, 10, 1440x900 
0x37CA2318, 38092267755567384, 226263743, 226263750, 7, 1440x900 
0x37CA2318, 38092267756029952, 226263788, 226263796, 8, 1440x900 
0x37CA2318, 38092267756876648, 226263872, 226263880, 8, 1440x900 
0x37CA2318, 38092267757550000, 226263947, 226263955, 8, 1440x900 
0x37CA2318, 38092267758217480, 226264013, 226264021, 8, 1440x900 
0x37CA2318, 38092267758869632, 226264077, 226264085, 8, 1440x900 
0x37CA2318, 38092267759529592, 226264143, 226264151, 8, 1440x900 
0x37CA2318, 38092267760191056, 226264208, 226264216, 8, 1440x900 
0x37CA2318, 38092267760860384, 226264276, 226264283, 7, 1440x900 
0x37CA2318, 38092267761511160, 226264340, 226264350, 10, 1440x900 
0x37CA2318, 38092267762179680, 226264402, 226264410, 8, 1440x900 
0x37CA2318, 38092267762840744, 226264468, 226264476, 8, 1440x900 
0x37CA2318, 38092267763501128, 226264538, 226264546, 8, 1440x900 
0x37CA2318, 38092267764151968, 226264602, 226264611, 9, 1440x900 
0x37CA2318, 38092267764816208, 226264674, 226264681, 7, 1440x900 
0x37CA2318, 38092267765475776, 226264738, 226264746, 8, 1440x900 
0x37CA2318, 38092267766131304, 226264802, 226264810, 8, 1440x900 
0x37CA2318, 38092267766793568, 226264868, 226264876, 8, 1440x900 
0x37CA2318, 38092267767454152, 226264933, 226264941, 8, 1440x900 
0x37CA2318, 38092267768107256, 226264997, 226265006, 9, 1440x900 
0x37CA2318, 38092267768768056, 226265068, 226265076, 8, 1440x900 
0x37CA2318, 38092267769437712, 226265132, 226265140, 8, 1440x900 
0x37CA2318, 38092267770088960, 226265197, 226265205, 8, 1440x900 
0x37CA2318, 38092267770754744, 226265264, 226265272, 8, 1440x900 
0x37CA2318, 38092267771405640, 226265327, 226265336, 9, 1440x900 
0x37CA2318, 38092267772068440, 226265398, 226265406, 8, 1440x900 
0x37CA2318, 38092267772746160, 226265468, 226265476, 8, 1440x900 
0x37CA2318, 38092267773399328, 226265528, 226265536, 8, 1440x900 
0x37CA2318, 38092267774064296, 226265598, 226265606, 8, 1440x900 
0x37CA2318, 38092267774725448, 226265663, 226265671, 8, 1440x900 
0x37CA2318, 38092267775392424, 226265728, 226265736, 8, 1440x900 
0x37CA2318, 38092267776042032, 226265788, 226265797, 9, 1440x900 
0x37CA2318, 38092267776704808, 226265856, 226265863, 7, 1440x900 
0x37CA2318, 38092267777358560, 226265922, 226265929, 7, 1440x900 
0x37CA2318, 38092267778030720, 226265992, 226266000, 8, 1440x900 
0x37CA2318, 38092267778700768, 226266057, 226266065, 8, 1440x900 
0x37CA2318, 38092267779359800, 226266123, 226266130, 7, 1440x900 
0x37CA2318, 38092267780006352, 226266188, 226266195, 7, 1440x900 
0x37CA2318, 38092267780685624, 226266257, 226266265, 8, 1440x900 
0x37CA2318, 38092267781336768, 226266318, 226266326, 8, 1440x900 
0x37CA2318, 38092267781999088, 226266387, 226266395, 8, 1440x900 
0x37CA2318, 38092267782660336, 226266452, 226266460, 8, 1440x900 
0x37CA2318, 38092267783329136, 226266523, 226266531, 8, 1440x900 
0x37CA2318, 38092267783980512, 226266588, 226266596, 8, 1440x900 
0x37CA2318, 38092267784642864, 226266653, 226266661, 8, 1440x900 
0x37CA2318, 38092267785302432, 226266717, 226266726, 9, 1440x900 
0x37CA2318, 38092267785962304, 226266787, 226266795, 8, 1440x900 
0x37CA2318, 38092267786632344, 226266853, 226266861, 8, 1440x900 
0x37CA2318, 38092267787282600, 226266918, 226266926, 8, 1440x900 
0x37CA2318, 38092267787944272, 226266982, 226266990, 8, 1440x900 
0x37CA2318, 38092267788614464, 226267048, 226267057, 9, 1440x900 
0x37CA2318, 38092267789266272, 226267118, 226267126, 8, 1440x900 
0x37CA2318, 38092267789925672, 226267183, 226267191, 8, 1440x900 
0x37CA2318, 38092267790588816, 226267253, 226267262, 9, 1440x900 
0x37CA2318, 38092267791249984, 226267312, 226267320, 8, 1440x900 
0x37CA2318, 38092267791900112, 226267377, 226267384, 7, 1440x900 
0x37CA2318, 38092267792579880, 226267443, 226267451, 8, 1440x900 
0x37CA2318, 38092267793232536, 226267508, 226267516, 8, 1440x900 
0x37CA2318, 38092267793900672, 226267577, 226267584, 7, 1440x900 
0x37CA2318, 38092267794552536, 226267642, 226267650, 8, 1440x900 
0x37CA2318, 38092267795209784, 226267708, 226267715, 7, 1440x900 
0x37CA2318, 38092267795871296, 226267773, 226267781, 8, 1440x900 
0x37CA2318, 38092267796532264, 226267838, 226267847, 9, 1440x900 
0x37CA2318, 38092267797658384, 226267952, 226267959, 7, 1440x900 
0x37CA2318, 38092267798519984, 226268039, 226268047, 8, 1440x900 
0x37CA2318, 38092267798982992, 226268087, 226268095, 8, 1440x900 
0x37CA2318, 38092267799636608, 226268149, 226268157, 8, 1440x900 
0x37CA2318, 38092267800300072, 226268223, 226268231, 8, 1440x900 
0x37CA2318, 38092267801157736, 226268303, 226268311, 8, 1440x900 
0x37CA2318, 38092267801817840, 226268373, 226268381, 8, 1440x900 
0x37CA2318, 38092267802283976, 226268418, 226268426, 8, 1440x900 
0x37CA2318, 38092267802944656, 226268483, 226268491, 8, 1440x900 
0x37CA2318, 38092267803799464, 226268568, 226268576, 8, 1440x900 
0x37CA2318, 38092267804274472, 226268617, 226268625, 8, 1440x900 
0x37CA2318, 38092267804927800, 226268682, 226268689, 7, 1440x900 
0x37CA2318, 38092267805592056, 226268747, 226268755, 8, 1440x900 
0x37CA2318, 38092267806251000, 226268813, 226268821, 8, 1440x900 
0x37CA2318, 38092267806912672, 226268882, 226268890, 8, 1440x900 
0x37CA2318, 38092267807761824, 226268967, 226268975, 8, 1440x900 
0x37CA2318, 38092267808236880, 226269013, 226269021, 8, 1440x900 
0x37CA2318, 38092267808903704, 226269082, 226269090, 8, 1440x900 
0x37CA2318, 38092267809557344, 226269142, 226269151, 9, 1440x900 
0x37CA2318, 38092267810399736, 226269226, 226269234, 8, 1440x900 
0x37CA2318, 38092267811070824, 226269297, 226269305, 8, 1440x900 
0x37CA2318, 38092267811740400, 226269362, 226269371, 9, 1440x900 
0x37CA2318, 38092267812394544, 226269428, 226269436, 8, 1440x900 
0x37CA2318, 38092267813047456, 226269492, 226269500, 8, 1440x900 
0x37CA2318, 38092267813529616, 226269542, 226269550, 8, 1440x900 
0x37CA2318, 38092267814189232, 226269607, 226269615, 8, 1440x900 
0x37CA2318, 38092267814850048, 226269673, 226269681, 8, 1440x900 
0x37CA2318, 38092267815693968, 226269758, 226269766, 8, 1440x900 
0x37CA2318, 38092267816357656, 226269823, 226269832, 9, 1440x900 
0x37CA2318, 38092267817017856, 226269892, 226269900, 8, 1440x900 
0x37CA2318, 38092267817677464, 226269958, 226269966, 8, 1440x900 
0x37CA2318, 38092267818342144, 226270022, 226270030, 8, 1440x900 
0x37CA2318, 38092267818816328, 226270070, 226270078, 8, 1440x900 
0x37CA2318, 38092267819474800, 226270137, 226270145, 8, 1440x900 
0x37CA2318, 38092267820137184, 226270202, 226270210, 8, 1440x900 
0x37CA2318, 38092267820985120, 226270288, 226270296, 8, 1440x900 
0x37CA2318, 38092267821648104, 226270352, 226270359, 7, 1440x900 
0x37CA2318, 38092267822308848, 226270417, 226270424, 7, 1440x900 
0x37CA2318, 38092267822969744, 226270488, 226270496, 8, 1440x900 
0x37CA2318, 38092267823639232, 226270552, 226270560, 8, 1440x900 
0x37CA2318, 38092267824104344, 226270598, 226270606, 8, 1440x900 
0x37CA2318, 38092267824761344, 226270666, 226270674, 8, 1440x900 
0x37CA2318, 38092267825420632, 226270728, 226270735, 7, 1440x900 
0x37CA2318, 38092267826273432, 226270817, 226270824, 7, 1440x900 
0x37CA2318, 38092267826935184, 226270883, 226270891, 8, 1440x900 
0x37CA2318, 38092267827591056, 226270952, 226270960, 8, 1440x900 
0x37CA2318, 38092267828264200, 226271017, 226271025, 8, 1440x900 
0x37CA2318, 38092267828928952, 226271083, 226271091, 8, 1440x900 
0x37CA2318, 38092267829392904, 226271127, 226271135, 8, 1440x900 
0x37CA2318, 38092267830052584, 226271193, 226271202, 9, 1440x900 
0x37CA2318, 38092267830721240, 226271262, 226271270, 8, 1440x900 
0x37CA2318, 38092267831577024, 226271347, 226271355, 8, 1440x900 
0x37CA2318, 38092267832235384, 226271412, 226271419, 7, 1440x900 
0x37CA2318, 38092267832897512, 226271477, 226271486, 9, 1440x900 
0x37CA2318, 38092267833558272, 226271543, 226271552, 9, 1440x900 
0x37CA2318, 38092267834209336, 226271608, 226271617, 9, 1440x900 
0x37CA2318, 38092267834689056, 226271658, 226271667, 9, 1440x900 
0x37CA2318, 38092267835356152, 226271722, 226271731, 9, 1440x900 
0x37CA2318, 38092267836019144, 226271788, 226271797, 9, 1440x900 
0x37CA2318, 38092267836865920, 226271878, 226271886, 8, 1440x900 
0x37CA2318, 38092267837520088, 226271938, 226271947, 9, 1440x900 
0x37CA2318, 38092267838187368, 226272007, 226272015, 8, 1440x900 
0x37CA2318, 38092267838842872, 226272073, 226272081, 8, 1440x900 
0x37CA2318, 38092267839490552, 226272137, 226272145, 8, 1440x900 
0x37CA2318, 38092267839979400, 226272189, 226272197, 8, 1440x900 
0x37CA2318, 38092267840641248, 226272252, 226272260, 8, 1440x900 
0x37CA2318, 38092267841299136, 226272317, 226272326, 9, 1440x900 
0x37CA2318, 38092267842166048, 226272405, 226272413, 8, 1440x900 
0x37CA2318, 38092267842818480, 226272473, 226272481, 8, 1440x900 
0x37CA2318, 38092267843477888, 226272533, 226272541, 8, 1440x900 
0x37CA2318, 38092267844141256, 226272603, 226272611, 8, 1440x900 
0x37CA2318, 38092267844665760, 226272657, 226272665, 8, 1440x900 
0x37CA2318, 38092267845271160, 226272718, 226272726, 8, 1440x900 
0x37CA2318, 38092267845931408, 226272782, 226272790, 8, 1440x900 
0x37CA2318, 38092267846602240, 226272848, 226272856, 8, 1440x900 
0x37CA2318, 38092267847447848, 226272937, 226272945, 8, 1440x900 
0x37CA2318, 38092267848111880, 226272998, 226273006, 8, 1440x900 
0x37CA2318, 38092267848770224, 226273067, 226273075, 8, 1440x900 
0x37CA2318, 38092267849424720, 226273134, 226273142, 8, 1440x900 
0x37CA2318, 38092267850002088, 226273188, 226273196, 8, 1440x900 
0x37CA2318, 38092267850567768, 226273248, 226273256, 8, 1440x900 
0x37CA2318, 38092267851229200, 226273313, 226273321, 8, 1440x900 
0x37CA2318, 38092267851886992, 226273378, 226273386, 8, 1440x900 
0x37CA2318, 38092267852742784, 226273462, 226273470, 8, 1440x900 
0x37CA2318, 38092267853404728, 226273528, 226273537, 9, 1440x900 
0x37CA2318, 38092267854064824, 226273597, 226273605, 8, 1440x900 
0x37CA2318, 38092267854726776, 226273662, 226273670, 8, 1440x900 
0x37CA2318, 38092267855198056, 226273713, 226273721, 8, 1440x900 
0x37CA2318, 38092267855858160, 226273777, 226273785, 8, 1440x900 
0x37CA2318, 38092267857180984, 226273907, 226273915, 8, 1440x900 
0x37CA2318, 38092267858021168, 226273988, 226273997, 9, 1440x900 
0x37CA2318, 38092267858691328, 226274057, 226274065, 8, 1440x900 
0x37CA2318, 38092267859344480, 226274123, 226274131, 8, 1440x900 
0x37CA2318, 38092267860012936, 226274192, 226274200, 8, 1440x900 
0x37CA2318, 38092267860519760, 226274243, 226274251, 8, 1440x900 
0x37CA2318, 38092267861142240, 226274303, 226274311, 8, 1440x900 
0x37CA2318, 38092267861802904, 226274368, 226274376, 8, 1440x900 
0x37CA2318, 38092267862461776, 226274433, 226274442, 9, 1440x900 
0x37CA2318, 38092267863325520, 226274523, 226274531, 8, 1440x900 
0x37CA2318, 38092267863995440, 226274592, 226274600, 8, 1440x900 
0x37CA2318, 38092267864646000, 226274652, 226274660, 8, 1440x900 
0x37CA2318, 38092267865309144, 226274718, 226274726, 8, 1440x900 
0x37CA2318, 38092267865777904, 226274768, 226274776, 8, 1440x900 
0x37CA2318, 38092267866438112, 226274835, 226274843, 8, 1440x900 
0x37CA2318, 38092267867098688, 226274898, 226274907, 9, 1440x900 
0x37CA2318, 38092267867758312, 226274963, 226274971, 8, 1440x900 
0x37CA2318, 38092267868611752, 226275048, 226275057, 9, 1440x900 
0x37CA2318, 38092267869263232, 226275113, 226275121, 8, 1440x900 
0x37CA2318, 38092267869926496, 226275182, 226275190, 8, 1440x900 
0x37CA2318, 38092267870588792, 226275247, 226275255, 8, 1440x900 
0x37CA2318, 38092267871059480, 226275293, 226275302, 9, 1440x900 
0x37CA2318, 38092267871718952, 226275363, 226275371, 8, 1440x900 
0x37CA2318, 38092267872380560, 226275432, 226275440, 8, 1440x900 
0x37CA2318, 38092267873231296, 226275508, 226275516, 8, 1440x900 
0x37CA2318, 38092267873892024, 226275573, 226275581, 8, 1440x900 
0x37CA2318, 38092267874543560, 226275643, 226275650, 7, 1440x900 
0x37CA2318, 38092267875214016, 226275707, 226275715, 8, 1440x900 
0x37CA2318, 38092267875878368, 226275772, 226275780, 8, 1440x900 
0x37CA2318, 38092267876339296, 226275817, 226275825, 8, 1440x900 
0x37CA2318, 38092267877004016, 226275887, 226275896, 9, 1440x900 
0x37CA2318, 38092267877665648, 226275958, 226275966, 8, 1440x900 
0x37CA2318, 38092267878333464, 226276023, 226276031, 8, 1440x900 
0x37CA2318, 38092267879180552, 226276108, 226276116, 8, 1440x900 
0x37CA2318, 38092267879843416, 226276173, 226276181, 8, 1440x900 
0x37CA2318, 38092267880512912, 226276238, 226276246, 8, 1440x900 
0x37CA2318, 38092267881171728, 226276308, 226276316, 8, 1440x900 
0x37CA2318, 38092267881636448, 226276353, 226276361, 8, 1440x900 
0x37CA2318, 38092267882298784, 226276418, 226276426, 8, 1440x900 
0x37CA2318, 38092267882956112, 226276483, 226276491, 8, 1440x900 
0x37CA2318, 38092267883812296, 226276567, 226276574, 7, 1440x900 
0x37CA2318, 38092267884472472, 226276634, 226276642, 8, 1440x900 
0x37CA2318, 38092267885134072, 226276702, 226276710, 8, 1440x900 
0x37CA2318, 38092267885796376, 226276773, 226276781, 8, 1440x900 
0x37CA2318, 38092267886455984, 226276832, 226276839, 7, 1440x900 
0x37CA2318, 38092267886927552, 226276883, 226276891, 8, 1440x900 
0x37CA2318, 38092267887587568, 226276948, 226276956, 8, 1440x900 
0x37CA2318, 38092267888247096, 226277017, 226277025, 8, 1440x900 
0x37CA2318, 38092267889100616, 226277102, 226277110, 8, 1440x900 
0x37CA2318, 38092267889758616, 226277167, 226277175, 8, 1440x900 
0x37CA2318, 38092267890417400, 226277228, 226277237, 9, 1440x900 
0x37CA2318, 38092267891078976, 226277298, 226277306, 8, 1440x900 
0x37CA2318, 38092267891733168, 226277362, 226277370, 8, 1440x900 
0x37CA2318, 38092267892214952, 226277407, 226277416, 9, 1440x900 
0x37CA2318, 38092267892881920, 226277477, 226277485, 8, 1440x900 
0x37CA2318, 38092267893534400, 226277542, 226277550, 8, 1440x900 
0x37CA2318, 38092267894395024, 226277628, 226277636, 8, 1440x900 
0x37CA2318, 38092267895046624, 226277693, 226277701, 8, 1440x900 
0x37CA2318, 38092267895716208, 226277762, 226277770, 8, 1440x900 
0x37CA2318, 38092267896377424, 226277823, 226277831, 8, 1440x900 
0x37CA2318, 38092267897037120, 226277891, 226277898, 7, 1440x900 
0x37CA2318, 38092267897503688, 226277937, 226277944, 7, 1440x900 
0x37CA2318, 38092267898170656, 226278008, 226278016, 8, 1440x900 
0x37CA2318, 38092267898830232, 226278073, 226278081, 8, 1440x900 
0x37CA2318, 38092267899681728, 226278157, 226278165, 8, 1440x900 
0x37CA2318, 38092267900338368, 226278222, 226278230, 8, 1440x900 
0x37CA2318, 38092267901007976, 226278293, 226278301, 8, 1440x900 
0x37CA2318, 38092267901677488, 226278357, 226278365, 8, 1440x900 
0x37CA2318, 38092267902337120, 226278423, 226278431, 8, 1440x900 
0x37CA2318, 38092267902801600, 226278472, 226278480, 8, 1440x900 
0x37CA2318, 38092267903462080, 226278532, 226278542, 10, 1440x900 
0x37CA2318, 38092267904119776, 226278597, 226278605, 8, 1440x900 
0x37CA2318, 38092267904778944, 226278663, 226278670, 7, 1440x900 
0x37CA2318, 38092267905627112, 226278749, 226278756, 7, 1440x900 
0x37CA2318, 38092267906296464, 226278817, 226278824, 7, 1440x900 
0x37CA2318, 38092267906955880, 226278882, 226278890, 8, 1440x900 
0x37CA2318, 38092267907608480, 226278947, 226278954, 7, 1440x900 
0x37CA2318, 38092267908272600, 226279017, 226279024, 7, 1440x900 
0x37CA2318, 38092267908932784, 226279083, 226279091, 8, 1440x900 
0x37CA2318, 38092267909592448, 226279148, 226279156, 8, 1440x900 
0x37CA2318, 38092267910253056, 226279212, 226279221, 9, 1440x900 
0x37CA2318, 38092267910922920, 226279282, 226279290, 8, 1440x900 
0x37CA2318, 38092267911576264, 226279348, 226279356, 8, 1440x900 
0x37CA2318, 38092267912245816, 226279412, 226279421, 9, 1440x900 
0x37CA2318, 38092267912895464, 226279479, 226279487, 8, 1440x900 
0x37CA2318, 38092267913556384, 226279547, 226279555, 8, 1440x900 
0x37CA2318, 38092267914216672, 226279608, 226279617, 9, 1440x900 
0x37CA2318, 38092267914871344, 226279677, 226279685, 8, 1440x900 
0x37CA2318, 38092267915547960, 226279742, 226279749, 7, 1440x900 
0x37CA2318, 38092267916200280, 226279807, 226279814, 7, 1440x900 
0x37CA2318, 38092267916868424, 226279872, 226279879, 7, 1440x900 
0x37CA2318, 38092267917518920, 226279938, 226279945, 7, 1440x900 
0x37CA2318, 38092267918179512, 226280003, 226280010, 7, 1440x900 
0x37CA2318, 38092267918830424, 226280068, 226280075, 7, 1440x900 
0x37CA2318, 38092267919500504, 226280136, 226280143, 7, 1440x900 
0x37CA2318, 38092267920161248, 226280202, 226280210, 8, 1440x900 
0x37CA2318, 38092267920819784, 226280268, 226280275, 7, 1440x900 
0x37CA2318, 38092267921488808, 226280337, 226280344, 7, 1440x900 
0x37CA2318, 38092267922148136, 226280402, 226280409, 7, 1440x900 
0x37CA2318, 38092267922807240, 226280468, 226280475, 7, 1440x900 
0x37CA2318, 38092267923462952, 226280533, 226280540, 7, 1440x900 
0x37CA2318, 38092267924141456, 226280602, 226280610, 8, 1440x900 
0x37CA2318, 38092267924803064, 226280667, 226280674, 7, 1440x900 
0x37CA2318, 38092267925466688, 226280736, 226280744, 8, 1440x900 
0x37CA2318, 38092267926118904, 226280798, 226280806, 8, 1440x900 
0x37CA2318, 38092267926788904, 226280863, 226280872, 9, 1440x900 
0x37CA2318, 38092267927449440, 226280932, 226280939, 7, 1440x900 
0x37CA2318, 38092267928109520, 226280998, 226281005, 7, 1440x900 
0x37CA2318, 38092267928771096, 226281063, 226281070, 7, 1440x900 
0x37CA2318, 38092267929439128, 226281133, 226281141, 8, 1440x900 
0x37CA2318, 38092267930090944, 226281198, 226281206, 8, 1440x900 
0x37CA2318, 38092267930754016, 226281262, 226281271, 9, 1440x900 
0x37CA2318, 38092267931421520, 226281334, 226281342, 8, 1440x900 
0x37CA2318, 38092267932089144, 226281396, 226281404, 8, 1440x900 
0x37CA2318, 38092267932740352, 226281462, 226281470, 8, 1440x900 
0x37CA2318, 38092267933398936, 226281527, 226281535, 8, 1440x900 
0x37CA2318, 38092267934069872, 226281593, 226281600, 7, 1440x900 
0x37CA2318, 38092267934723344, 226281658, 226281667, 9, 1440x900 
0x37CA2318, 38092267935402216, 226281729, 226281737, 8, 1440x900 
0x37CA2318, 38092267936051832, 226281792, 226281799, 7, 1440x900 
0x37CA2318, 38092267936716112, 226281858, 226281865, 7, 1440x900 
0x37CA2318, 38092267937376408, 226281927, 226281935, 8, 1440x900 
0x37CA2318, 38092267938036488, 226281992, 226282000, 8, 1440x900 
0x37CA2318, 38092267938697920, 226282058, 226282067, 9, 1440x900 
0x37CA2318, 38092267939366632, 226282122, 226282129, 7, 1440x900 
0x37CA2318, 38092267940678416, 226282258, 226282266, 8, 1440x900 
0x37CA2318, 38092267941336880, 226282323, 226282331, 8, 1440x900 
0x37CA2318, 38092267942005736, 226282393, 226282401, 8, 1440x900 
0x37CA2318, 38092267942665952, 226282458, 226282466, 8, 1440x900 
0x37CA2318, 38092267943327616, 226282523, 226282531, 8, 1440x900 
0x37CA2318, 38092267943987952, 226282588, 226282596, 8, 1440x900 
0x37CA2318, 38092267944638216, 226282653, 226282661, 8, 1440x900 
0x37CA2318, 38092267945299192, 226282717, 226282726, 9, 1440x900 
0x37CA2318, 38092267945959992, 226282783, 226282791, 8, 1440x900 
0x37CA2318, 38092267946619488, 226282853, 226282861, 8, 1440x900 
0x37CA2318, 38092267947280304, 226282918, 226282926, 8, 1440x900 
0x37CA2318, 38092267947941856, 226282983, 226282991, 8, 1440x900 
0x37CA2318, 38092267948599680, 226283052, 226283060, 8, 1440x900 
0x37CA2318, 38092267949261432, 226283113, 226283122, 9, 1440x900 
0x37CA2318, 38092267949920608, 226283183, 226283191, 8, 1440x900 
0x37CA2318, 38092267950590088, 226283247, 226283255, 8, 1440x900 
0x37CA2318, 38092267951241760, 226283313, 226283321, 8, 1440x900 
0x37CA2318, 38092267951903624, 226283378, 226283386, 8, 1440x900 
0x37CA2318, 38092267952573096, 226283447, 226283455, 8, 1440x900 
0x37CA2318, 38092267953224000, 226283514, 226283522, 8, 1440x900 
0x37CA2318, 38092267953875984, 226283578, 226283586, 8, 1440x900 
0x37CA2318, 38092267954546920, 226283643, 226283652, 9, 1440x900 
0x37CA2318, 38092267955200208, 226283707, 226283715, 8, 1440x900 
0x37CA2318, 38092267955868256, 226283777, 226283785, 8, 1440x900 
0x37CA2318, 38092267956528728, 226283843, 226283851, 8, 1440x900 
0x37CA2318, 38092267957198984, 226283907, 226283914, 7, 1440x900 
0x37CA2318, 38092267957852656, 226283973, 226283981, 8, 1440x900 
0x37CA2318, 38092267958507344, 226284037, 226284046, 9, 1440x900 
0x37CA2318, 38092267959174208, 226284108, 226284116, 8, 1440x900 
0x37CA2318, 38092267959836992, 226284173, 226284181, 8, 1440x900 
0x37CA2318, 38092267960497608, 226284236, 226284243, 7, 1440x900 
0x37CA2318, 38092267961149624, 226284302, 226284309, 7, 1440x900 
0x37CA2318, 38092267961818680, 226284371, 226284378, 7, 1440x900 
0x37CA2318, 38092267962477504, 226284437, 226284445, 8, 1440x900 
0x37CA2318, 38092267963136928, 226284502, 226284510, 8, 1440x900 
0x37CA2318, 38092267963806608, 226284568, 226284577, 9, 1440x900 
0x37CA2318, 38092267964467384, 226284633, 226284640, 7, 1440x900 
0x37CA2318, 38092267965122064, 226284703, 226284711, 8, 1440x900 
0x37CA2318, 38092267965791464, 226284772, 226284780, 8, 1440x900 
0x37CA2318, 38092267966443424, 226284832, 226284840, 8, 1440x900 
0x37CA2318, 38092267967106768, 226284903, 226284911, 8, 1440x900 
0x37CA2318, 38092267967768000, 226284967, 226284975, 8, 1440x900 
0x37CA2318, 38092267968437488, 226285033, 226285041, 8, 1440x900 
0x37CA2318, 38092267969096776, 226285098, 226285107, 9, 1440x900 
0x37CA2318, 38092267969747696, 226285162, 226285170, 8, 1440x900 
0x37CA2318, 38092267970410272, 226285228, 226285237, 9, 1440x900 
0x37CA2318, 38092267971069920, 226285293, 226285300, 7, 1440x900 
0x37CA2318, 38092267971733704, 226285357, 226285366, 9, 1440x900 
0x37CA2318, 38092267972401408, 226285428, 226285436, 8, 1440x900 
0x37CA2318, 38092267973052696, 226285492, 226285500, 8, 1440x900 
0x37CA2318, 38092267973720624, 226285563, 226285572, 9, 1440x900 
0x37CA2318, 38092267974388496, 226285627, 226285635, 8, 1440x900 
0x37CA2318, 38092267975047752, 226285692, 226285701, 9, 1440x900 
0x37CA2318, 38092267975709936, 226285763, 226285771, 8, 1440x900 
0x37CA2318, 38092267976370216, 226285823, 226285832, 9, 1440x900 
0x37CA2318, 38092267977040600, 226285893, 226285901, 8, 1440x900 
0x37CA2318, 38092267977689816, 226285958, 226285966, 8, 1440x900 
0x37CA2318, 38092267978360000, 226286024, 226286032, 8, 1440x900 
0x37CA2318, 38092267979011648, 226286088, 226286097, 9, 1440x900 
0x37CA2318, 38092267979679712, 226286157, 226286165, 8, 1440x900 
0x37CA2318, 38092267980340008, 226286223, 226286231, 8, 1440x900 
0x37CA2318, 38092267981003504, 226286287, 226286295, 8, 1440x900 
0x37CA2318, 38092267981664024, 226286352, 226286360, 8, 1440x900 
0x37CA2318, 38092267982333672, 226286423, 226286432, 9, 1440x900 
0x37CA2318, 38092267982984384, 226286489, 226286497, 8, 1440x900 
0x37CA2318, 38092267983642104, 226286553, 226286561, 8, 1440x900 
0x37CA2318, 38092267984311664, 226286623, 226286631, 8, 1440x900 
0x37CA2318, 38092267984972504, 226286683, 226286692, 9, 1440x900 
0x37CA2318, 38092267985624296, 226286748, 226286757, 9, 1440x900 
0x37CA2318, 38092267986283600, 226286819, 226286826, 7, 1440x900 
0x37CA2318, 38092267986954392, 226286882, 226286890, 8, 1440x900 
0x37CA2318, 38092267987605032, 226286948, 226286956, 8, 1440x900 
0x37CA2318, 38092267988269000, 226287018, 226287027, 9, 1440x900 
0x37CA2318, 38092267988927928, 226287083, 226287091, 8, 1440x900 
0x37CA2318, 38092267989597936, 226287152, 226287160, 8, 1440x900 
0x37CA2318, 38092267990256072, 226287217, 226287225, 8, 1440x900 
0x37CA2318, 38092267990917256, 226287282, 226287290, 8, 1440x900 
0x37CA2318, 38092267991583448, 226287348, 226287356, 8, 1440x900 
0x37CA2318, 38092267992234480, 226287409, 226287417, 8, 1440x900 
0x37CA2318, 38092267992914768, 226287483, 226287491, 8, 1440x900 
0x37CA2318, 38092267993573656, 226287548, 226287556, 8, 1440x900 
0x37CA2318, 38092267994226464, 226287612, 226287620, 8, 1440x900 
0x37CA2318, 38092267994887792, 226287677, 226287685, 8, 1440x900 
0x37CA2318, 38092267995555896, 226287744, 226287752, 8, 1440x900 
0x37CA2318, 38092267996217768, 226287808, 226287815, 7, 1440x900 
0x37CA2318, 38092267996884776, 226287879, 226287887, 8, 1440x900 
0x37CA2318, 38092267997545048, 226287943, 226287951, 8, 1440x900 
0x37CA2318, 38092267998216080, 226288008, 226288017, 9, 1440x900 
0x37CA2318, 38092267998867360, 226288078, 226288086, 8, 1440x900 
0x37CA2318, 38092267999527624, 226288143, 226288151, 8, 1440x900 
0x37CA2318, 38092268000189200, 226288207, 226288216, 9, 1440x900 
0x37CA2318, 38092268000850544, 226288278, 226288286, 8, 1440x900 
0x37CA2318, 38092268001512160, 226288342, 226288350, 8, 1440x900 
0x37CA2318, 38092268002173968, 226288407, 226288415, 8, 1440x900 
0x37CA2318, 38092268002826496, 226288468, 226288476, 8, 1440x900 
0x37CA2318, 38092268003489432, 226288533, 226288541, 8, 1440x900 
0x37CA2318, 38092268004160248, 226288603, 226288610, 7, 1440x900 
0x37CA2318, 38092268004819848, 226288668, 226288675, 7, 1440x900 
0x37CA2318, 38092268005480792, 226288737, 226288745, 8, 1440x900 
0x37CA2318, 38092268006150712, 226288802, 226288810, 8, 1440x900 
0x37CA2318, 38092268006798064, 226288872, 226288879, 7, 1440x900 
0x37CA2318, 38092268007458984, 226288933, 226288940, 7, 1440x900 
0x37CA2318, 38092268008127824, 226289002, 226289010, 8, 1440x900 
0x37CA2318, 38092268008786200, 226289067, 226289075, 8, 1440x900 
0x37CA2318, 38092268009446920, 226289131, 226289138, 7, 1440x900 
0x37CA2318, 38092268010107352, 226289198, 226289205, 7, 1440x900 
0x37CA2318, 38092268010772736, 226289264, 226289271, 7, 1440x900 
0x37CA2318, 38092268011441504, 226289332, 226289339, 7, 1440x900 
0x37CA2318, 38092268012099248, 226289397, 226289404, 7, 1440x900 
0x37CA2318, 38092268012753520, 226289463, 226289470, 7, 1440x900 
0x37CA2318, 38092268013406960, 226289527, 226289535, 8, 1440x900 
0x37CA2318, 38092268014077968, 226289597, 226289605, 8, 1440x900 
0x37CA2318, 38092268014732280, 226289663, 226289671, 8, 1440x900 
0x37CA2318, 38092268015394368, 226289727, 226289735, 8, 1440x900 
0x37CA2318, 38092268016055200, 226289792, 226289801, 9, 1440x900 
0x37CA2318, 38092268016725152, 226289864, 226289872, 8, 1440x900 
0x37CA2318, 38092268017377048, 226289927, 226289935, 8, 1440x900 
0x37CA2318, 38092268018040360, 226289993, 226290000, 7, 1440x900 
0x37CA2318, 38092268018706456, 226290062, 226290070, 8, 1440x900 
0x37CA2318, 38092268020024648, 226290193, 226290201, 8, 1440x900 
0x37CA2318, 38092268020685008, 226290262, 226290270, 8, 1440x900 
0x37CA2318, 38092268021340208, 226290322, 226290330, 8, 1440x900 
0x37CA2318, 38092268022003136, 226290388, 226290396, 8, 1440x900 
0x37CA2318, 38092268022671464, 226290458, 226290466, 8, 1440x900 
0x37CA2318, 38092268023330752, 226290522, 226290530, 8, 1440x900 
0x37CA2318, 38092268023989784, 226290583, 226290591, 8, 1440x900 
0x37CA2318, 38092268024653784, 226290652, 226290661, 9, 1440x900 
0x37CA2318, 38092268025307520, 226290719, 226290727, 8, 1440x900 
0x37CA2318, 38092268025966416, 226290788, 226290796, 8, 1440x900 
0x37CA2318, 38092268026618472, 226290852, 226290860, 8, 1440x900 
0x37CA2318, 38092268027282336, 226290918, 226290926, 8, 1440x900 
0x37CA2318, 38092268027953544, 226290983, 226290992, 9, 1440x900 
0x37CA2318, 38092268028614176, 226291048, 226291057, 9, 1440x900 
0x37CA2318, 38092268029265968, 226291113, 226291122, 9, 1440x900 
0x37CA2318, 38092268029927832, 226291183, 226291191, 8, 1440x900 
0x37CA2318, 38092268030580544, 226291248, 226291256, 8, 1440x900 
0x37CA2318, 38092268031247920, 226291313, 226291321, 8, 1440x900 
0x37CA2318, 38092268031907952, 226291383, 226291391, 8, 1440x900 
0x37CA2318, 38092268032569360, 226291447, 226291455, 8, 1440x900 
0x37CA2318, 38092268033227376, 226291513, 226291521, 8, 1440x900 
0x37CA2318, 38092268033889944, 226291578, 226291586, 8, 1440x900 
0x37CA2318, 38092268034541424, 226291643, 226291651, 8, 1440x900 
0x37CA2318, 38092268035213984, 226291708, 226291716, 8, 1440x900 
0x37CA2318, 38092268035869040, 226291774, 226291782, 8, 1440x900 
0x37CA2318, 38092268036538472, 226291843, 226291852, 9, 1440x900 
0x37CA2318, 38092268037190872, 226291907, 226291915, 8, 1440x900 
0x37CA2318, 38092268037855488, 226291977, 226291985, 8, 1440x900 
0x37CA2318, 38092268038521712, 226292042, 226292050, 8, 1440x900 
0x37CA2318, 38092268039180880, 226292107, 226292115, 8, 1440x900 
0x37CA2318, 38092268039830872, 226292173, 226292181, 8, 1440x900 
0x37CA2318, 38092268040503568, 226292237, 226292245, 8, 1440x900 
0x37CA2318, 38092268041154448, 226292303, 226292312, 9, 1440x900 
0x37CA2318, 38092268041809568, 226292368, 226292377, 9, 1440x900 
0x37CA2318, 38092268042480752, 226292437, 226292445, 8, 1440x900 
0x37CA2318, 38092268043137136, 226292503, 226292510, 7, 1440x900 
0x37CA2318, 38092268043800976, 226292572, 226292580, 8, 1440x900 
0x37CA2318, 38092268044468544, 226292637, 226292645, 8, 1440x900 
0x37CA2318, 38092268045118408, 226292703, 226292711, 8, 1440x900 
0x37CA2318, 38092268045779880, 226292768, 226292776, 8, 1440x900 
0x37CA2318, 38092268046435504, 226292834, 226292843, 9, 1440x900 
0x37CA2318, 38092268047113536, 226292898, 226292906, 8, 1440x900 
0x37CA2318, 38092268047569880, 226292944, 226292949, 5, 1440x900 
0x37CA2318, 38092268048432264, 226293028, 226293036, 8, 1440x900 
0x37CA2318, 38092268049093656, 226293097, 226293104, 7, 1440x900 
0x37CA2318, 38092268049750440, 226293162, 226293170, 8, 1440x900 
0x37CA2318, 38092268050415064, 226293233, 226293241, 8, 1440x900 
0x37CA2318, 38092268051073392, 226293298, 226293306, 8, 1440x900 
0x37CA2318, 38092268051733800, 226293362, 226293370, 8, 1440x900 
0x37CA2318, 38092268052393144, 226293427, 226293435, 8, 1440x900 
0x37CA2318, 38092268053052152, 226293493, 226293501, 8, 1440x900 
0x37CA2318, 38092268053723736, 226293558, 226293567, 9, 1440x900 
0x37CA2318, 38092268054376176, 226293623, 226293631, 8, 1440x900 
0x37CA2318, 38092268055044344, 226293695, 226293703, 8, 1440x900 
0x37CA2318, 38092268055511568, 226293738, 226293744, 6, 1440x900 
0x37CA2318, 38092268056366552, 226293823, 226293830, 7, 1440x900 
0x37CA2318, 38092268057019168, 226293892, 226293900, 8, 1440x900 
0x37CA2318, 38092268057690168, 226293957, 226293965, 8, 1440x900 
0x37CA2318, 38092268058358096, 226294023, 226294031, 8, 1440x900 
0x37CA2318, 38092268059012832, 226294088, 226294096, 8, 1440x900 
0x37CA2318, 38092268059666336, 226294154, 226294163, 9, 1440x900 
0x37CA2318, 38092268060329888, 226294223, 226294231, 8, 1440x900 
0x37CA2318, 38092268060999896, 226294293, 226294300, 7, 1440x900 
0x37CA2318, 38092268061672688, 226294358, 226294366, 8, 1440x900 
0x37CA2318, 38092268062314096, 226294418, 226294426, 8, 1440x900 
0x37CA2318, 38092268062992760, 226294488, 226294496, 8, 1440x900 
0x37CA2318, 38092268063647736, 226294553, 226294561, 8, 1440x900 
0x37CA2318, 38092268064317432, 226294624, 226294632, 8, 1440x900 
0x37CA2318, 38092268064976312, 226294683, 226294691, 8, 1440x900 
0x37CA2318, 38092268065628224, 226294752, 226294760, 8, 1440x900 
0x37CA2318, 38092268066297528, 226294822, 226294830, 8, 1440x900 
0x37CA2318, 38092268066956472, 226294882, 226294888, 6, 1440x900 
0x37CA2318, 38092268067617512, 226294948, 226294955, 7, 1440x900 
0x37CA2318, 38092268068282984, 226295017, 226295025, 8, 1440x900 
0x37CA2318, 38092268068941040, 226295083, 226295091, 8, 1440x900 
0x37CA2318, 38092268069606888, 226295153, 226295161, 8, 1440x900 
0x37CA2318, 38092268070267584, 226295213, 226295222, 9, 1440x900 
0x37CA2318, 38092268070917808, 226295279, 226295287, 8, 1440x900 
0x37CA2318, 38092268071578224, 226295348, 226295356, 8, 1440x900 
0x37CA2318, 38092268072239640, 226295413, 226295421, 8, 1440x900 
0x37CA2318, 38092268072901616, 226295478, 226295486, 8, 1440x900 
0x37CA2318, 38092268073571096, 226295543, 226295552, 9, 1440x900 
0x37CA2318, 38092268074223152, 226295608, 226295617, 9, 1440x900 
0x37CA2318, 38092268074892456, 226295677, 226295685, 8, 1440x900 
0x37CA2318, 38092268075536992, 226295742, 226295750, 8, 1440x900 
0x37CA2318, 38092268076208408, 226295812, 226295820, 8, 1440x900 
0x37CA2318, 38092268076877392, 226295878, 226295886, 8, 1440x900 
0x37CA2318, 38092268077526824, 226295938, 226295946, 8, 1440x900 
0x37CA2318, 38092268078198832, 226296007, 226296015, 8, 1440x900 
0x37CA2318, 38092268078859288, 226296077, 226296085, 8, 1440x900 
0x37CA2318, 38092268079519288, 226296143, 226296151, 8, 1440x900 
0x37CA2318, 38092268080178896, 226296207, 226296215, 8, 1440x900 
0x37CA2318, 38092268080830544, 226296273, 226296281, 8, 1440x900 
0x37CA2318, 38092268081493360, 226296338, 226296346, 8, 1440x900 
0x37CA2318, 38092268082153352, 226296404, 226296412, 8, 1440x900 
0x37CA2318, 38092268082808224, 226296472, 226296480, 8, 1440x900 
0x37CA2318, 38092268083478288, 226296538, 226296546, 8, 1440x900 
0x37CA2318, 38092268084147600, 226296602, 226296611, 9, 1440x900 
0x37CA2318, 38092268084798800, 226296672, 226296680, 8, 1440x900 
0x37CA2318, 38092268085469448, 226296733, 226296742, 9, 1440x900 
0x37CA2318, 38092268086120192, 226296802, 226296810, 8, 1440x900 
0x37CA2318, 38092268086771992, 226296863, 226296872, 9, 1440x900 
0x37CA2318, 38092268087450064, 226296934, 226296942, 8, 1440x900 
0x37CA2318, 38092268088110040, 226296997, 226297004, 7, 1440x900 
0x37CA2318, 38092268088780112, 226297063, 226297071, 8, 1440x900 
0x37CA2318, 38092268089431912, 226297132, 226297139, 7, 1440x900 
0x37CA2318, 38092268090097152, 226297197, 226297204, 7, 1440x900 
0x37CA2318, 38092268090767024, 226297263, 226297272, 9, 1440x900 
0x37CA2318, 38092268091417144, 226297333, 226297341, 8, 1440x900 
0x37CA2318, 38092268092079792, 226297397, 226297405, 8, 1440x900 
0x37CA2318, 38092268092740496, 226297463, 226297471, 8, 1440x900 
0x37CA2318, 38092268093401752, 226297528, 226297536, 8, 1440x900 
0x37CA2318, 38092268094073136, 226297598, 226297606, 8, 1440x900 
0x37CA2318, 38092268094739856, 226297662, 226297669, 7, 1440x900 
0x37CA2318, 38092268095400288, 226297728, 226297736, 8, 1440x900 
0x37CA2318, 38092268096072936, 226297793, 226297803, 10, 1440x900 
0x37CA2318, 38092268096714592, 226297864, 226297871, 7, 1440x900 
0x37CA2318, 38092268097385944, 226297928, 226297936, 8, 1440x900 
0x37CA2318, 38092268098045944, 226297992, 226297999, 7, 1440x900 
0x37CA2318, 38092268098707864, 226298057, 226298065, 8, 1440x900 
0x37CA2318, 38092268099362936, 226298123, 226298131, 8, 1440x900 
0x37CA2318, 38092268100028192, 226298193, 226298201, 8, 1440x900 
0x37CA2318, 38092268100698472, 226298258, 226298266, 8, 1440x900 
0x37CA2318, 38092268101359096, 226298323, 226298331, 8, 1440x900 
0x37CA2318, 38092268102670504, 226298453, 226298462, 9, 1440x900 
0x37CA2318, 38092268103333536, 226298523, 226298531, 8, 1440x900 
0x37CA2318, 38092268103994032, 226298587, 226298596, 9, 1440x900 
0x37CA2318, 38092268104653008, 226298652, 226298661, 9, 1440x900 
0x37CA2318, 38092268105315480, 226298718, 226298727, 9, 1440x900 
0x37CA2318, 38092268105970776, 226298784, 226298792, 8, 1440x900 
0x37CA2318, 38092268106633592, 226298852, 226298860, 8, 1440x900 
0x37CA2318, 38092268107302824, 226298917, 226298925, 8, 1440x900 
0x37CA2318, 38092268107954576, 226298986, 226298993, 7, 1440x900 
0x37CA2318, 38092268108613360, 226299047, 226299055, 8, 1440x900 
0x37CA2318, 38092268109286000, 226299117, 226299124, 7, 1440x900 
0x37CA2318, 38092268109948208, 226299182, 226299190, 8, 1440x900 
0x37CA2318, 38092268110604088, 226299249, 226299257, 8, 1440x900 
0x37CA2318, 38092268111273088, 226299317, 226299325, 8, 1440x900 
0x37CA2318, 38092268111932896, 226299383, 226299391, 8, 1440x900 
0x37CA2318, 38092268112593360, 226299448, 226299456, 8, 1440x900 
0x37CA2318, 38092268113263744, 226299517, 226299525, 8, 1440x900 
0x37CA2318, 38092268113921136, 226299583, 226299591, 8, 1440x900 
0x37CA2318, 38092268114574440, 226299648, 226299656, 8, 1440x900 
0x37CA2318, 38092268115234936, 226299714, 226299722, 8, 1440x900 
0x37CA2318, 38092268115895688, 226299782, 226299790, 8, 1440x900 
0x37CA2318, 38092268116552792, 226299847, 226299855, 8, 1440x900 
0x37CA2318, 38092268117219464, 226299913, 226299921, 8, 1440x900 
0x37CA2318, 38092268117874472, 226299975, 226299983, 8, 1440x900 
0x37CA2318, 38092268118535120, 226300038, 226300046, 8, 1440x900 
0x37CA2318, 38092268119202392, 226300113, 226300121, 8, 1440x900 
0x37CA2318, 38092268119853712, 226300172, 226300180, 8, 1440x900 
0x37CA2318, 38092268120523336, 226300238, 226300247, 9, 1440x900 
0x37CA2318, 38092268121175408, 226300308, 226300316, 8, 1440x900 
0x37CA2318, 38092268121837648, 226300372, 226300380, 8, 1440x900 
0x37CA2318, 38092268122500184, 226300442, 226300450, 8, 1440x900 
0x37CA2318, 38092268123152336, 226300502, 226300510, 8, 1440x900 
0x37CA2318, 38092268123831864, 226300573, 226300581, 8, 1440x900 
0x37CA2318, 38092268124491896, 226300637, 226300646, 9, 1440x900 
0x37CA2318, 38092268125140552, 226300703, 226300711, 8, 1440x900 
0x37CA2318, 38092268125807168, 226300768, 226300777, 9, 1440x900 
0x37CA2318, 38092268126463544, 226300837, 226300846, 9, 1440x900 
0x37CA2318, 38092268127132216, 226300903, 226300911, 8, 1440x900 
0x37CA2318, 38092268127783736, 226300967, 226300975, 8, 1440x900 
0x37CA2318, 38092268128454424, 226301038, 226301046, 8, 1440x900 
0x37CA2318, 38092268129106824, 226301098, 226301106, 8, 1440x900 
0x37CA2318, 38092268129757912, 226301167, 226301176, 9, 1440x900 
0x37CA2318, 38092268130426664, 226301233, 226301241, 8, 1440x900 
0x37CA2318, 38092268131089200, 226301298, 226301304, 6, 1440x900 
0x37CA2318, 38092268131749160, 226301363, 226301371, 8, 1440x900 
0x37CA2318, 38092268132410832, 226301428, 226301436, 8, 1440x900 
0x37CA2318, 38092268133073232, 226301497, 226301505, 8, 1440x900 
0x37CA2318, 38092268133733632, 226301563, 226301572, 9, 1440x900 
0x37CA2318, 38092268134395256, 226301628, 226301636, 8, 1440x900 
0x37CA2318, 38092268135068808, 226301697, 226301705, 8, 1440x900 
0x37CA2318, 38092268135728416, 226301762, 226301770, 8, 1440x900 
0x37CA2318, 38092268136390320, 226301828, 226301836, 8, 1440x900 
0x37CA2318, 38092268137050584, 226301892, 226301901, 9, 1440x900 
0x37CA2318, 38092268137720000, 226301958, 226301967, 9, 1440x900 
0x37CA2318, 38092268138363712, 226302030, 226302038, 8, 1440x900 
0x37CA2318, 38092268139027400, 226302088, 226302096, 8, 1440x900 
0x37CA2318, 38092268139700576, 226302156, 226302164, 8, 1440x900 
0x37CA2318, 38092268140356832, 226302223, 226302231, 8, 1440x900 
0x37CA2318, 38092268141016792, 226302292, 226302300, 8, 1440x900 
0x37CA2318, 38092268141669040, 226302354, 226302362, 8, 1440x900 
0x37CA2318, 38092268142330112, 226302423, 226302431, 8, 1440x900 
0x37CA2318, 38092268142991232, 226302487, 226302495, 8, 1440x900 
0x37CA2318, 38092268143663936, 226302557, 226302565, 8, 1440x900 
0x37CA2318, 38092268144317608, 226302619, 226302627, 8, 1440x900 
0x37CA2318, 38092268144985520, 226302688, 226302695, 7, 1440x900 
0x37CA2318, 38092268145646992, 226302753, 226302760, 7, 1440x900 
0x37CA2318, 38092268146308520, 226302817, 226302824, 7, 1440x900 
0x37CA2318, 38092268146971616, 226302882, 226302890, 8, 1440x900 
0x37CA2318, 38092268147632688, 226302948, 226302956, 8, 1440x900 
0x37CA2318, 38092268148293584, 226303017, 226303024, 7, 1440x900 
0x37CA2318, 38092268148953472, 226303081, 226303088, 7, 1440x900 
0x37CA2318, 38092268149623760, 226303153, 226303162, 9, 1440x900 
0x37CA2318, 38092268150275592, 226303218, 226303225, 7, 1440x900 
0x37CA2318, 38092268150943776, 226303282, 226303290, 8, 1440x900 
0x37CA2318, 38092268151595704, 226303347, 226303356, 9, 1440x900 
0x37CA2318, 38092268152264136, 226303418, 226303425, 7, 1440x900 
0x37CA2318, 38092268152925256, 226303484, 226303492, 8, 1440x900 
0x37CA2318, 38092268153585856, 226303547, 226303555, 8, 1440x900 
0x37CA2318, 38092268154243776, 226303613, 226303621, 8, 1440x900 
0x37CA2318, 38092268154894400, 226303679, 226303687, 8, 1440x900 
0x37CA2318, 38092268155554472, 226303744, 226303751, 7, 1440x900 
0x37CA2318, 38092268156216816, 226303808, 226303815, 7, 1440x900 
0x37CA2318, 38092268156885344, 226303878, 226303885, 7, 1440x900 
0x37CA2318, 38092268157535936, 226303941, 226303949, 8, 1440x900 
0x37CA2318, 38092268158198488, 226304006, 226304013, 7, 1440x900 
0x37CA2318, 38092268158867808, 226304074, 226304084, 10, 1440x900 
0x37CA2318, 38092268159517888, 226304138, 226304147, 9, 1440x900 
0x37CA2318, 38092268160186352, 226304203, 226304211, 8, 1440x900 
0x37CA2318, 38092268160847776, 226304273, 226304281, 8, 1440x900 
0x37CA2318, 38092268161507584, 226304342, 226304350, 8, 1440x900 
0x37CA2318, 38092268162158824, 226304403, 226304412, 9, 1440x900 
0x37CA2318, 38092268162818936, 226304468, 226304476, 8, 1440x900 
0x37CA2318, 38092268163480072, 226304533, 226304540, 7, 1440x900 
0x37CA2318, 38092268164133888, 226304603, 226304612, 9, 1440x900 
0x37CA2318, 38092268164795392, 226304666, 226304674, 8, 1440x900 
0x37CA2318, 38092268165461232, 226304737, 226304745, 8, 1440x900 
0x37CA2318, 38092268166114960, 226304802, 226304810, 8, 1440x900 
0x37CA2318, 38092268166785296, 226304868, 226304876, 8, 1440x900 
0x37CA2318, 38092268167446280, 226304932, 226304940, 8, 1440x900 
0x37CA2318, 38092268168105312, 226305002, 226305010, 8, 1440x900 
0x37CA2318, 38092268168773800, 226305065, 226305074, 9, 1440x900 
0x37CA2318, 38092268169435136, 226305133, 226305141, 8, 1440x900 
0x37CA2318, 38092268170095888, 226305197, 226305205, 8, 1440x900 
0x37CA2318, 38092268170767360, 226305267, 226305275, 8, 1440x900 
0x37CA2318, 38092268171438816, 226305332, 226305340, 8, 1440x900 
0x37CA2318, 38092268172097512, 226305398, 226305407, 9, 1440x900 
0x37CA2318, 38092268172749632, 226305463, 226305471, 8, 1440x900 
0x37CA2318, 38092268173412016, 226305528, 226305536, 8, 1440x900 
0x37CA2318, 38092268174073376, 226305598, 226305606, 8, 1440x900 
0x37CA2318, 38092268174723800, 226305658, 226305668, 10, 1440x900 
0x37CA2318, 38092268175393864, 226305728, 226305736, 8, 1440x900 
0x37CA2318, 38092268176045680, 226305792, 226305799, 7, 1440x900 
0x37CA2318, 38092268176715800, 226305858, 226305866, 8, 1440x900 
0x37CA2318, 38092268177375472, 226305923, 226305931, 8, 1440x900 
0x37CA2318, 38092268178030120, 226305988, 226305996, 8, 1440x900 
0x37CA2318, 38092268178701248, 226306057, 226306064, 7, 1440x900 
0x37CA2318, 38092268180029808, 226306193, 226306201, 8, 1440x900 
0x37CA2318, 38092268180681336, 226306257, 226306265, 8, 1440x900 
0x37CA2318, 38092268181341976, 226306323, 226306331, 8, 1440x900 
0x37CA2318, 38092268182001856, 226306388, 226306397, 9, 1440x900 
0x37CA2318, 38092268182664696, 226306458, 226306466, 8, 1440x900 
0x37CA2318, 38092268183324984, 226306521, 226306529, 8, 1440x900 
0x37CA2318, 38092268183987736, 226306586, 226306594, 8, 1440x900 
0x37CA2318, 38092268184652912, 226306653, 226306660, 7, 1440x900 
0x37CA2318, 38092268185304600, 226306724, 226306731, 7, 1440x900 
0x37CA2318, 38092268185966720, 226306787, 226306795, 8, 1440x900 
0x37CA2318, 38092268186620384, 226306852, 226306860, 8, 1440x900 
0x37CA2318, 38092268187284016, 226306918, 226306926, 8, 1440x900 
0x37CA2318, 38092268187953112, 226306987, 226306995, 8, 1440x900 
0x37CA2318, 38092268188611368, 226307052, 226307060, 8, 1440x900 
0x37CA2318, 38092268189268496, 226307118, 226307126, 8, 1440x900 
0x37CA2318, 38092268189928736, 226307183, 226307191, 8, 1440x900 
0x37CA2318, 38092268190588864, 226307248, 226307256, 8, 1440x900 
0x37CA2318, 38092268191249856, 226307317, 226307325, 8, 1440x900 
0x37CA2318, 38092268191920360, 226307383, 226307391, 8, 1440x900 
0x37CA2318, 38092268192581472, 226307448, 226307456, 8, 1440x900 
0x37CA2318, 38092268193245040, 226307514, 226307522, 8, 1440x900 
0x37CA2318, 38092268193895992, 226307578, 226307586, 8, 1440x900 
0x37CA2318, 38092268194567488, 226307648, 226307656, 8, 1440x900 
0x37CA2318, 38092268195227656, 226307713, 226307721, 8, 1440x900 
0x37CA2318, 38092268195889664, 226307778, 226307787, 9, 1440x900 
0x37CA2318, 38092268196549920, 226307848, 226307856, 8, 1440x900 
0x37CA2318, 38092268197210336, 226307907, 226307915, 8, 1440x900 
0x37CA2318, 38092268197880080, 226307978, 226307986, 8, 1440x900 
0x37CA2318, 38092268198530968, 226308042, 226308050, 8, 1440x900 
0x37CA2318, 38092268199191872, 226308108, 226308116, 8, 1440x900 
0x37CA2318, 38092268199853360, 226308178, 226308186, 8, 1440x900 
0x37CA2318, 38092268200516048, 226308243, 226308251, 8, 1440x900 
0x37CA2318, 38092268201169424, 226308307, 226308315, 8, 1440x900 
0x37CA2318, 38092268201831616, 226308373, 226308381, 8, 1440x900 
0x37CA2318, 38092268202501024, 226308438, 226308446, 8, 1440x900 
0x37CA2318, 38092268203152800, 226308507, 226308515, 8, 1440x900 
0x37CA2318, 38092268203804352, 226308567, 226308575, 8, 1440x900 
0x37CA2318, 38092268204473776, 226308633, 226308640, 7, 1440x900 
0x37CA2318, 38092268205133488, 226308698, 226308705, 7, 1440x900 
0x37CA2318, 38092268205794616, 226308767, 226308774, 7, 1440x900 
0x37CA2318, 38092268206460360, 226308833, 226308842, 9, 1440x900 
0x37CA2318, 38092268207127064, 226308898, 226308906, 8, 1440x900 
0x37CA2318, 38092268207785984, 226308963, 226308971, 8, 1440x900 
0x37CA2318, 38092268208439016, 226309028, 226309036, 8, 1440x900 
0x37CA2318, 38092268209099192, 226309097, 226309105, 8, 1440x900 
0x37CA2318, 38092268209751152, 226309162, 226309170, 8, 1440x900 
0x37CA2318, 38092268210413984, 226309228, 226309235, 7, 1440x900 
0x37CA2318, 38092268211082320, 226309298, 226309306, 8, 1440x900 
0x37CA2318, 38092268211740712, 226309363, 226309372, 9, 1440x900 
0x37CA2318, 38092268212410536, 226309432, 226309440, 8, 1440x900 
0x37CA2318, 38092268213072688, 226309498, 226309506, 8, 1440x900 
0x37CA2318, 38092268213722376, 226309563, 226309571, 8, 1440x900 
0x37CA2318, 38092268214382816, 226309628, 226309636, 8, 1440x900 
0x37CA2318, 38092268215044920, 226309693, 226309701, 8, 1440x900 
0x37CA2318, 38092268215706032, 226309763, 226309771, 8, 1440x900 
0x37CA2318, 38092268216357496, 226309827, 226309835, 8, 1440x900 
0x37CA2318, 38092268217028344, 226309892, 226309900, 8, 1440x900 
0x37CA2318, 38092268217688760, 226309957, 226309965, 8, 1440x900 
0x37CA2318, 38092268218358000, 226310022, 226310029, 7, 1440x900 
0x37CA2318, 38092268219011288, 226310087, 226310094, 7, 1440x900 
0x37CA2318, 38092268219679768, 226310158, 226310166, 8, 1440x900 
0x37CA2318, 38092268220331016, 226310223, 226310231, 8, 1440x900 
0x37CA2318, 38092268220996848, 226310288, 226310296, 8, 1440x900 
0x37CA2318, 38092268221657640, 226310352, 226310361, 9, 1440x900 
0x37CA2318, 38092268222317488, 226310418, 226310427, 9, 1440x900 
0x37CA2318, 38092268222978912, 226310487, 226310495, 8, 1440x900 
0x37CA2318, 38092268223640128, 226310553, 226310561, 8, 1440x900 
0x37CA2318, 38092268224299648, 226310622, 226310630, 8, 1440x900 
0x37CA2318, 38092268224960568, 226310683, 226310690, 7, 1440x900 
0x37CA2318, 38092268225640088, 226310752, 226310759, 7, 1440x900 
0x37CA2318, 38092268226278784, 226310813, 226310821, 8, 1440x900 
0x37CA2318, 38092268226950016, 226310883, 226310890, 7, 1440x900 
0x37CA2318, 38092268227609208, 226310947, 226310954, 7, 1440x900 
0x37CA2318, 38092268228272136, 226311013, 226311020, 7, 1440x900 
0x37CA2318, 38092268228929960, 226311078, 226311086, 8, 1440x900 
0x37CA2318, 38092268229593728, 226311146, 226311154, 8, 1440x900 
0x37CA2318, 38092268230256632, 226311217, 226311225, 8, 1440x900 
0x37CA2318, 38092268230926224, 226311282, 226311290, 8, 1440x900 
0x37CA2318, 38092268231580536, 226311348, 226311356, 8, 1440x900 
0x37CA2318, 38092268232240976, 226311412, 226311420, 8, 1440x900 
0x37CA2318, 38092268232893456, 226311478, 226311486, 8, 1440x900 
0x37CA2318, 38092268233565776, 226311547, 226311555, 8, 1440x900 
0x37CA2318, 38092268234235744, 226311613, 226311620, 7, 1440x900 
0x37CA2318, 38092268234891888, 226311677, 226311685, 8, 1440x900 
0x37CA2318, 38092268235551296, 226311747, 226311758, 11, 1440x900 
0x37CA2318, 38092268236202064, 226311807, 226311814, 7, 1440x900 
0x37CA2318, 38092268236867056, 226311877, 226311885, 8, 1440x900 
0x37CA2318, 38092268237528872, 226311943, 226311951, 8, 1440x900 
0x37CA2318, 38092268238198672, 226312008, 226312016, 8, 1440x900 
0x37CA2318, 38092268238848912, 226312073, 226312081, 8, 1440x900 
0x37CA2318, 38092268239518544, 226312139, 226312147, 8, 1440x900 
0x37CA2318, 38092268240170680, 226312204, 226312212, 8, 1440x900 
0x37CA2318, 38092268240829720, 226312271, 226312278, 7, 1440x900 
0x37CA2318, 38092268241492376, 226312338, 226312346, 8, 1440x900 
0x37CA2318, 38092268242143624, 226312398, 226312406, 8, 1440x900 
0x37CA2318, 38092268242805992, 226312473, 226312481, 8, 1440x900 
0x37CA2318, 38092268243484000, 226312537, 226312545, 8, 1440x900 
0x37CA2318, 38092268244137760, 226312603, 226312611, 8, 1440x900 
0x37CA2318, 38092268244788952, 226312668, 226312676, 8, 1440x900 
0x37CA2318, 38092268245452816, 226312737, 226312745, 8, 1440x900 
0x37CA2318, 38092268246124752, 226312799, 226312808, 9, 1440x900 
0x37CA2318, 38092268246774336, 226312863, 226312871, 8, 1440x900 
0x37CA2318, 38092268247437520, 226312932, 226312940, 8, 1440x900 
0x37CA2318, 38092268248098952, 226313002, 226313010, 8, 1440x900 
0x37CA2318, 38092268248761152, 226313063, 226313072, 9, 1440x900 
0x37CA2318, 38092268249420328, 226313128, 226313137, 9, 1440x900 
0x37CA2318, 38092268250074720, 226313197, 226313205, 8, 1440x900 
0x37CA2318, 38092268250750768, 226313262, 226313271, 9, 1440x900 
0x37CA2318, 38092268251401776, 226313327, 226313335, 8, 1440x900 
0x37CA2318, 38092268252063032, 226313393, 226313402, 9, 1440x900 
0x37CA2318, 38092268252725680, 226313463, 226313471, 8, 1440x900 
0x37CA2318, 38092268253383176, 226313528, 226313536, 8, 1440x900 
0x37CA2318, 38092268254042600, 226313592, 226313600, 8, 1440x900 
0x37CA2318, 38092268255366192, 226313727, 226313735, 8, 1440x900 
0x37CA2318, 38092268256026256, 226313792, 226313800, 8, 1440x900 
0x37CA2318, 38092268256686456, 226313858, 226313866, 8, 1440x900 
0x37CA2318, 38092268257347952, 226313927, 226313935, 8, 1440x900 
0x37CA2318, 38092268258017256, 226313988, 226313995, 7, 1440x900 
0x37CA2318, 38092268258676880, 226314053, 226314061, 8, 1440x900 
0x37CA2318, 38092268259328200, 226314119, 226314126, 7, 1440x900 
0x37CA2318, 38092268259989432, 226314186, 226314194, 8, 1440x900 
0x37CA2318, 38092268260645744, 226314252, 226314260, 8, 1440x900 
0x37CA2318, 38092268261310768, 226314322, 226314330, 8, 1440x900 
0x37CA2318, 38092268261971168, 226314388, 226314396, 8, 1440x900 
0x37CA2318, 38092268262633040, 226314452, 226314460, 8, 1440x900 
0x37CA2318, 38092268263292640, 226314518, 226314526, 8, 1440x900 
0x37CA2318, 38092268263948784, 226314583, 226314591, 8, 1440x900 
0x37CA2318, 38092268264620528, 226314652, 226314660, 8, 1440x900 
0x37CA2318, 38092268265275320, 226314718, 226314725, 7, 1440x900 
0x37CA2318, 38092268265947520, 226314783, 226314791, 8, 1440x900 
0x37CA2318, 38092268266601752, 226314847, 226314856, 9, 1440x900 
0x37CA2318, 38092268267254184, 226314913, 226314922, 9, 1440x900 
0x37CA2318, 38092268267917264, 226314982, 226314990, 8, 1440x900 
0x37CA2318, 38092268268595776, 226315047, 226315055, 8, 1440x900 
0x37CA2318, 38092268269246168, 226315111, 226315118, 7, 1440x900 
0x37CA2318, 38092268269904832, 226315178, 226315186, 8, 1440x900 
0x37CA2318, 38092268270571832, 226315247, 226315255, 8, 1440x900 
0x37CA2318, 38092268271224376, 226315313, 226315321, 8, 1440x900 
0x37CA2318, 38092268271893744, 226315373, 226315381, 8, 1440x900 
0x37CA2318, 38092268272555960, 226315444, 226315452, 8, 1440x900 
0x37CA2318, 38092268273207992, 226315512, 226315520, 8, 1440x900 
0x37CA2318, 38092268273870584, 226315578, 226315587, 9, 1440x900 
0x37CA2318, 38092268274532808, 226315643, 226315652, 9, 1440x900 
0x37CA2318, 38092268275201680, 226315708, 226315716, 8, 1440x900 
0x37CA2318, 38092268275873784, 226315778, 226315786, 8, 1440x900 
0x37CA2318, 38092268276524168, 226315843, 226315851, 8, 1440x900 
0x37CA2318, 38092268277191088, 226315907, 226315916, 9, 1440x900 
0x37CA2318, 38092268277851808, 226315972, 226315980, 8, 1440x900 
0x37CA2318, 38092268278512464, 226316043, 226316051, 8, 1440x900 
0x37CA2318, 38092268279170016, 226316103, 226316110, 7, 1440x900 
0x37CA2318, 38092268279832384, 226316172, 226316180, 8, 1440x900 
0x37CA2318, 38092268280483504, 226316238, 226316246, 8, 1440x900 
0x37CA2318, 38092268281154920, 226316302, 226316311, 9, 1440x900 
0x37CA2318, 38092268281816536, 226316372, 226316380, 8, 1440x900 
0x37CA2318, 38092268282477184, 226316437, 226316445, 8, 1440x900 
0x37CA2318, 38092268283138304, 226316503, 226316511, 8, 1440x900 
0x37CA2318, 38092268283790360, 226316568, 226316576, 8, 1440x900 
0x37CA2318, 38092268284459216, 226316637, 226316645, 8, 1440x900 
0x37CA2318, 38092268285128728, 226316701, 226316709, 8, 1440x900 
0x37CA2318, 38092268285783160, 226316767, 226316775, 8, 1440x900 
0x37CA2318, 38092268286450696, 226316833, 226316842, 9, 1440x900 
0x37CA2318, 38092268287117000, 226316903, 226316911, 8, 1440x900 
0x37CA2318, 38092268287768008, 226316968, 226316975, 7, 1440x900 
0x37CA2318, 38092268288426480, 226317032, 226317040, 8, 1440x900 
0x37CA2318, 38092268289098584, 226317098, 226317106, 8, 1440x900 
0x37CA2318, 38092268289758176, 226317168, 226317176, 8, 1440x900 
0x37CA2318, 38092268290418456, 226317232, 226317240, 8, 1440x900 
0x37CA2318, 38092268291088024, 226317298, 226317306, 8, 1440x900 
0x37CA2318, 38092268291745760, 226317363, 226317372, 9, 1440x900 
0x37CA2318, 38092268292405704, 226317432, 226317440, 8, 1440x900 
0x37CA2318, 38092268293068696, 226317498, 226317506, 8, 1440x900 
0x37CA2318, 38092268293728024, 226317563, 226317571, 8, 1440x900 
0x37CA2318, 38092268294379672, 226317627, 226317635, 8, 1440x900 
0x37CA2318, 38092268295040520, 226317692, 226317700, 8, 1440x900 
0x37CA2318, 38092268295701224, 226317758, 226317766, 8, 1440x900 
0x37CA2318, 38092268296362640, 226317823, 226317831, 8, 1440x900 
0x37CA2318, 38092268297014112, 226317888, 226317896, 8, 1440x900 
0x37CA2318, 38092268297686032, 226317957, 226317965, 8, 1440x900 
0x37CA2318, 38092268298338720, 226318023, 226318031, 8, 1440x900 
0x37CA2318, 38092268299016960, 226318093, 226318101, 8, 1440x900 
0x37CA2318, 38092268299677192, 226318157, 226318165, 8, 1440x900 
0x37CA2318, 38092268300336392, 226318221, 226318228, 7, 1440x900 
0x37CA2318, 38092268300997744, 226318287, 226318294, 7, 1440x900 
0x37CA2318, 38092268301658832, 226318353, 226318361, 8, 1440x900 
0x37CA2318, 38092268302325496, 226318418, 226318426, 8, 1440x900 
0x37CA2318, 38092268302979808, 226318487, 226318494, 7, 1440x900 
0x37CA2318, 38092268303644024, 226318552, 226318559, 7, 1440x900 
0x37CA2318, 38092268304304224, 226318617, 226318624, 7, 1440x900 
0x37CA2318, 38092268304965976, 226318683, 226318690, 7, 1440x900 
0x37CA2318, 38092268305626736, 226318748, 226318756, 8, 1440x900 
0x37CA2318, 38092268306289328, 226318818, 226318826, 8, 1440x900 
0x37CA2318, 38092268306951656, 226318883, 226318891, 8, 1440x900 
0x37CA2318, 38092268307617664, 226318953, 226318961, 8, 1440x900 
0x37CA2318, 38092268308270488, 226319017, 226319025, 8, 1440x900 
0x37CA2318, 38092268308936552, 226319082, 226319090, 8, 1440x900 
0x37CA2318, 38092268309589048, 226319147, 226319155, 8, 1440x900 
0x37CA2318, 38092268310249768, 226319213, 226319221, 8, 1440x900 
0x37CA2318, 38092268310909200, 226319278, 226319285, 7, 1440x900 
0x37CA2318, 38092268311572880, 226319348, 226319356, 8, 1440x900 
0x37CA2318, 38092268312241848, 226319413, 226319421, 8, 1440x900 
0x37CA2318, 38092268312892528, 226319478, 226319486, 8, 1440x900 
0x37CA2318, 38092268313554896, 226319544, 226319552, 8, 1440x900 
0x37CA2318, 38092268314216136, 226319612, 226319620, 8, 1440x900 
0x37CA2318, 38092268314870208, 226319677, 226319685, 8, 1440x900 
0x37CA2318, 38092268315549672, 226319743, 226319751, 8, 1440x900 
0x37CA2318, 38092268316202472, 226319808, 226319816, 8, 1440x900 
0x37CA2318, 38092268316853528, 226319873, 226319882, 9, 1440x900 
0x37CA2318, 38092268317524304, 226319943, 226319951, 8, 1440x900 
0x37CA2318, 38092268318184872, 226320009, 226320017, 8, 1440x900 
0x37CA2318, 38092268318845680, 226320072, 226320080, 8, 1440x900 
0x37CA2318, 38092268319508176, 226320138, 226320147, 9, 1440x900 
0x37CA2318, 38092268320166400, 226320204, 226320212, 8, 1440x900 
0x37CA2318, 38092268320828056, 226320272, 226320280, 8, 1440x900 
0x37CA2318, 38092268321479832, 226320337, 226320345, 8, 1440x900 
0x37CA2318, 38092268322142056, 226320402, 226320410, 8, 1440x900 
0x37CA2318, 38092268322803120, 226320472, 226320480, 8, 1440x900 
0x37CA2318, 38092268323472208, 226320537, 226320545, 8, 1440x900 
0x37CA2318, 38092268324133464, 226320603, 226320611, 8, 1440x900 
0x37CA2318, 38092268324794024, 226320667, 226320675, 8, 1440x900 
0x37CA2318, 38092268325455944, 226320737, 226320745, 8, 1440x900 
0x37CA2318, 38092268326116304, 226320798, 226320807, 9, 1440x900 
0x37CA2318, 38092268326786760, 226320873, 226320881, 8, 1440x900 
0x37CA2318, 38092268327446096, 226320932, 226320940, 8, 1440x900 
0x37CA2318, 38092268328749192, 226321062, 226321069, 7, 1440x900 
0x37CA2318, 38092268329418440, 226321127, 226321134, 7, 1440x900 
0x37CA2318, 38092268330083056, 226321193, 226321201, 8, 1440x900 
0x37CA2318, 38092268330741344, 226321263, 226321271, 8, 1440x900 
0x37CA2318, 38092268331401984, 226321329, 226321337, 8, 1440x900 
0x37CA2318, 38092268332063176, 226321393, 226321401, 8, 1440x900 
0x37CA2318, 38092268332723104, 226321463, 226321471, 8, 1440x900 
0x37CA2318, 38092268333394096, 226321528, 226321536, 8, 1440x900 
0x37CA2318, 38092268334038896, 226321593, 226321601, 8, 1440x900 
0x37CA2318, 38092268334705792, 226321662, 226321670, 8, 1440x900 
0x37CA2318, 38092268335423224, 226321727, 226321735, 8, 1440x900 
0x37CA2318, 38092268335861488, 226321771, 226321778, 7, 1440x900 
0x37CA2318, 38092268336701696, 226321857, 226321864, 7, 1440x900 
0x37CA2318, 38092268337360952, 226321922, 226321929, 7, 1440x900 
0x37CA2318, 38092268338021960, 226321987, 226321995, 8, 1440x900 
0x37CA2318, 38092268338673000, 226322052, 226322062, 10, 1440x900 
0x37CA2318, 38092268339340784, 226322122, 226322130, 8, 1440x900 
0x37CA2318, 38092268339992160, 226322187, 226322195, 8, 1440x900 
0x37CA2318, 38092268340662536, 226322253, 226322262, 9, 1440x900 
0x37CA2318, 38092268341314784, 226322323, 226322331, 8, 1440x900 
0x37CA2318, 38092268341985328, 226322387, 226322395, 8, 1440x900 
0x37CA2318, 38092268342446712, 226322432, 226322439, 7, 1440x900 
0x37CA2318, 38092268343298264, 226322517, 226322525, 8, 1440x900 
0x37CA2318, 38092268343950928, 226322583, 226322591, 8, 1440x900 
0x37CA2318, 38092268344617440, 226322652, 226322660, 8, 1440x900 
0x37CA2318, 38092268345280544, 226322718, 226322726, 8, 1440x900 
0x37CA2318, 38092268345946928, 226322782, 226322790, 8, 1440x900 
0x37CA2318, 38092268346608832, 226322847, 226322856, 9, 1440x900 
0x37CA2318, 38092268347258800, 226322913, 226322921, 8, 1440x900 
0x37CA2318, 38092268347925984, 226322983, 226322991, 8, 1440x900 
0x37CA2318, 38092268348589056, 226323047, 226323055, 8, 1440x900 
0x37CA2318, 38092268349239824, 226323113, 226323121, 8, 1440x900 
0x37CA2318, 38092268349901016, 226323177, 226323185, 8, 1440x900 
0x37CA2318, 38092268350571784, 226323247, 226323255, 8, 1440x900 
0x37CA2318, 38092268351222064, 226323309, 226323317, 8, 1440x900 
0x37CA2318, 38092268351881840, 226323378, 226323385, 7, 1440x900 
0x37CA2318, 38092268352533960, 226323443, 226323451, 8, 1440x900 
0x37CA2318, 38092268353203728, 226323508, 226323517, 9, 1440x900 
0x37CA2318, 38092268353855688, 226323578, 226323586, 8, 1440x900 
0x37CA2318, 38092268354519960, 226323638, 226323647, 9, 1440x900 
0x37CA2318, 38092268355207776, 226323708, 226323716, 8, 1440x900 
0x37CA2318, 38092268355649176, 226323752, 226323759, 7, 1440x900 
0x37CA2318, 38092268356503792, 226323838, 226323845, 7, 1440x900 
0x37CA2318, 38092268357173072, 226323903, 226323911, 8, 1440x900 
0x37CA2318, 38092268357823544, 226323968, 226323976, 8, 1440x900 
0x37CA2318, 38092268358491816, 226324037, 226324045, 8, 1440x900 
0x37CA2318, 38092268359140912, 226324103, 226324111, 8, 1440x900 
0x37CA2318, 38092268359807184, 226324168, 226324176, 8, 1440x900 
0x37CA2318, 38092268360459992, 226324233, 226324241, 8, 1440x900 
0x37CA2318, 38092268361130632, 226324302, 226324310, 8, 1440x900 
0x37CA2318, 38092268361782672, 226324368, 226324376, 8, 1440x900 
0x37CA2318, 38092268362445800, 226324432, 226324440, 8, 1440x900 
0x37CA2318, 38092268363101160, 226324498, 226324506, 8, 1440x900 
0x37CA2318, 38092268363765192, 226324562, 226324570, 8, 1440x900 
0x37CA2318, 38092268364427520, 226324628, 226324635, 7, 1440x900 
0x37CA2318, 38092268365089112, 226324697, 226324705, 8, 1440x900 
0x37CA2318, 38092268365751568, 226324762, 226324770, 8, 1440x900 
0x37CA2318, 38092268366409896, 226324828, 226324835, 7, 1440x900 
0x37CA2318, 38092268367069424, 226324898, 226324906, 8, 1440x900 
0x37CA2318, 38092268367738512, 226324962, 226324970, 8, 1440x900 
0x37CA2318, 38092268368398152, 226325027, 226325035, 8, 1440x900 
0x37CA2318, 38092268369067864, 226325092, 226325100, 8, 1440x900 
0x37CA2318, 38092268369718368, 226325157, 226325164, 7, 1440x900 
0x37CA2318, 38092268370381408, 226325226, 226325234, 8, 1440x900 
0x37CA2318, 38092268371044168, 226325291, 226325299, 8, 1440x900 
0x37CA2318, 38092268371703752, 226325357, 226325364, 7, 1440x900 
0x37CA2318, 38092268372363264, 226325422, 226325430, 8, 1440x900 
0x37CA2318, 38092268373024680, 226325488, 226325496, 8, 1440x900 
0x37CA2318, 38092268373681456, 226325553, 226325561, 8, 1440x900 
0x37CA2318, 38092268374351208, 226325622, 226325630, 8, 1440x900 
0x37CA2318, 38092268375014096, 226325687, 226325695, 8, 1440x900 
0x37CA2318, 38092268375665440, 226325753, 226325761, 8, 1440x900 
0x37CA2318, 38092268376318744, 226325823, 226325830, 7, 1440x900 
0x37CA2318, 38092268376991000, 226325886, 226325894, 8, 1440x900 
0x37CA2318, 38092268377651584, 226325951, 226325959, 8, 1440x900 
0x37CA2318, 38092268378303448, 226326017, 226326025, 8, 1440x900 
0x37CA2318, 38092268378983408, 226326083, 226326091, 8, 1440x900 
0x37CA2318, 38092268379641656, 226326151, 226326159, 8, 1440x900 
0x37CA2318, 38092268380296912, 226326217, 226326225, 8, 1440x900 
0x37CA2318, 38092268380959160, 226326282, 226326291, 9, 1440x900 
0x37CA2318, 38092268381621200, 226326352, 226326360, 8, 1440x900 
0x37CA2318, 38092268382289552, 226326418, 226326426, 8, 1440x900 
0x37CA2318, 38092268382934968, 226326482, 226326490, 8, 1440x900 
0x37CA2318, 38092268383596928, 226326548, 226326556, 8, 1440x900 
0x37CA2318, 38092268384265920, 226326613, 226326620, 7, 1440x900 
0x37CA2318, 38092268384926744, 226326683, 226326691, 8, 1440x900 
0x37CA2318, 38092268385596312, 226326748, 226326756, 8, 1440x900 
0x37CA2318, 38092268386255360, 226326812, 226326821, 9, 1440x900 
0x37CA2318, 38092268386916944, 226326878, 226326887, 9, 1440x900 
0x37CA2318, 38092268387570656, 226326948, 226326956, 8, 1440x900 
0x37CA2318, 38092268388235040, 226327008, 226327015, 7, 1440x900 
0x37CA2318, 38092268388896904, 226327078, 226327086, 8, 1440x900 
0x37CA2318, 38092268389549128, 226327143, 226327151, 8, 1440x900 
0x37CA2318, 38092268390210880, 226327212, 226327220, 8, 1440x900 
0x37CA2318, 38092268390873544, 226327277, 226327285, 8, 1440x900 
0x37CA2318, 38092268391534272, 226327343, 226327351, 8, 1440x900 
0x37CA2318, 38092268392203776, 226327408, 226327417, 9, 1440x900 
0x37CA2318, 38092268392855168, 226327473, 226327481, 8, 1440x900 
0x37CA2318, 38092268393517360, 226327542, 226327550, 8, 1440x900 
0x37CA2318, 38092268394169040, 226327606, 226327614, 8, 1440x900 
0x37CA2318, 38092268394832032, 226327673, 226327681, 8, 1440x900 
0x37CA2318, 38092268395500832, 226327737, 226327745, 8, 1440x900 
0x37CA2318, 38092268396161424, 226327802, 226327811, 9, 1440x900 
0x37CA2318, 38092268396816224, 226327868, 226327877, 9, 1440x900 
0x37CA2318, 38092268397478816, 226327937, 226327945, 8, 1440x900 
0x37CA2318, 38092268398149136, 226328008, 226328016, 8, 1440x900 
0x37CA2318, 38092268398819256, 226328068, 226328077, 9, 1440x900 
0x37CA2318, 38092268399469272, 226328137, 226328145, 8, 1440x900 
0x37CA2318, 38092268400131184, 226328202, 226328210, 8, 1440x900 
0x37CA2318, 38092268400801424, 226328268, 226328276, 8, 1440x900 
0x37CA2318, 38092268401453104, 226328332, 226328340, 8, 1440x900 
0x37CA2318, 38092268402114528, 226328398, 226328406, 8, 1440x900 
0x37CA2318, 38092268402768784, 226328468, 226328476, 8, 1440x900 
0x37CA2318, 38092268403433064, 226328532, 226328540, 8, 1440x900 
0x37CA2318, 38092268404756800, 226328667, 226328675, 8, 1440x900 
0x37CA2318, 38092268405409176, 226328732, 226328740, 8, 1440x900 
0x37CA2318, 38092268406089496, 226328798, 226328806, 8, 1440x900 
0x37CA2318, 38092268406748008, 226328862, 226328869, 7, 1440x900 
0x37CA2318, 38092268407410184, 226328932, 226328940, 8, 1440x900 
0x37CA2318, 38092268408070064, 226328993, 226329000, 7, 1440x900 
0x37CA2318, 38092268408732520, 226329063, 226329071, 8, 1440x900 
0x37CA2318, 38092268409390928, 226329127, 226329135, 8, 1440x900 
0x37CA2318, 38092268410053064, 226329192, 226329200, 8, 1440x900 
0x37CA2318, 38092268410707600, 226329262, 226329270, 8, 1440x900 
0x37CA2318, 38092268411373656, 226329327, 226329335, 8, 1440x900 
0x37CA2318, 38092268412035696, 226329392, 226329400, 8, 1440x900 
0x37CA2318, 38092268412692128, 226329458, 226329466, 8, 1440x900 
0x37CA2318, 38092268413362280, 226329528, 226329536, 8, 1440x900 
0x37CA2318, 38092268414013632, 226329593, 226329601, 8, 1440x900 
0x37CA2318, 38092268414673808, 226329653, 226329660, 7, 1440x900 
0x37CA2318, 38092268415344936, 226329723, 226329731, 8, 1440x900 
0x37CA2318, 38092268415995728, 226329792, 226329800, 8, 1440x900 
0x37CA2318, 38092268416653688, 226329853, 226329861, 8, 1440x900 
0x37CA2318, 38092268417313160, 226329917, 226329924, 7, 1440x900 
0x37CA2318, 38092268417977680, 226329988, 226329996, 8, 1440x900 
0x37CA2318, 38092268418638240, 226330052, 226330060, 8, 1440x900 
0x37CA2318, 38092268419297112, 226330117, 226330126, 9, 1440x900 
0x37CA2318, 38092268419958784, 226330183, 226330191, 8, 1440x900 
0x37CA2318, 38092268420610640, 226330247, 226330256, 9, 1440x900 
0x37CA2318, 38092268421282880, 226330317, 226330325, 8, 1440x900 
0x37CA2318, 38092268421935424, 226330383, 226330391, 8, 1440x900 
0x37CA2318, 38092268422596032, 226330447, 226330455, 8, 1440x900 
0x37CA2318, 38092268423268024, 226330518, 226330526, 8, 1440x900 
0x37CA2318, 38092268423926152, 226330583, 226330591, 8, 1440x900 
0x37CA2318, 38092268424596688, 226330653, 226330661, 8, 1440x900 
0x37CA2318, 38092268425248376, 226330713, 226330721, 8, 1440x900 
0x37CA2318, 38092268425900672, 226330782, 226330790, 8, 1440x900 
0x37CA2318, 38092268426572304, 226330847, 226330855, 8, 1440x900 
0x37CA2318, 38092268427232504, 226330913, 226330921, 8, 1440x900 
0x37CA2318, 38092268427893672, 226330978, 226330986, 8, 1440x900 
0x37CA2318, 38092268428561856, 226331042, 226331050, 8, 1440x900 
0x37CA2318, 38092268429216400, 226331112, 226331119, 7, 1440x900 
0x37CA2318, 38092268429882816, 226331177, 226331185, 8, 1440x900 
0x37CA2318, 38092268430544096, 226331243, 226331251, 8, 1440x900 
0x37CA2318, 38092268431205312, 226331312, 226331320, 8, 1440x900 
0x37CA2318, 38092268431866688, 226331378, 226331386, 8, 1440x900 
0x37CA2318, 38092268432528000, 226331442, 226331450, 8, 1440x900 
0x37CA2318, 38092268433191280, 226331507, 226331515, 8, 1440x900 
0x37CA2318, 38092268433852824, 226331572, 226331581, 9, 1440x900 
0x37CA2318, 38092268434518568, 226331638, 226331647, 9, 1440x900 
0x37CA2318, 38092268435179624, 226331708, 226331716, 8, 1440x900 
0x37CA2318, 38092268435848592, 226331773, 226331781, 8, 1440x900 
0x37CA2318, 38092268436508768, 226331839, 226331847, 8, 1440x900 
0x37CA2318, 38092268437169672, 226331904, 226331912, 8, 1440x900 
0x37CA2318, 38092268437829568, 226331972, 226331980, 8, 1440x900 
0x37CA2318, 38092268438481768, 226332037, 226332045, 8, 1440x900 
0x37CA2318, 38092268439141320, 226332102, 226332110, 8, 1440x900 
0x37CA2318, 38092268439801696, 226332168, 226332176, 8, 1440x900 
0x37CA2318, 38092268440464648, 226332238, 226332246, 8, 1440x900 
0x37CA2318, 38092268441123856, 226332303, 226332311, 8, 1440x900 
0x37CA2318, 38092268441790640, 226332367, 226332375, 8, 1440x900 
0x37CA2318, 38092268442453616, 226332432, 226332440, 8, 1440x900 
0x37CA2318, 38092268443108992, 226332498, 226332507, 9, 1440x900 
0x37CA2318, 38092268443778200, 226332567, 226332575, 8, 1440x900 
0x37CA2318, 38092268444439288, 226332632, 226332640, 8, 1440x900 
0x37CA2318, 38092268445096984, 226332698, 226332706, 8, 1440x900 
0x37CA2318, 38092268445750728, 226332763, 226332771, 8, 1440x900 
0x37CA2318, 38092268446417056, 226332829, 226332837, 8, 1440x900 
0x37CA2318, 38092268447081080, 226332897, 226332905, 8, 1440x900 
0x37CA2318, 38092268447734928, 226332963, 226332971, 8, 1440x900 
0x37CA2318, 38092268448408168, 226333032, 226333040, 8, 1440x900 
0x37CA2318, 38092268449067032, 226333098, 226333106, 8, 1440x900 
0x37CA2318, 38092268449713640, 226333157, 226333166, 9, 1440x900 
0x37CA2318, 38092268450384952, 226333229, 226333237, 8, 1440x900 
0x37CA2318, 38092268451044712, 226333294, 226333302, 8, 1440x900 
0x37CA2318, 38092268451698144, 226333357, 226333365, 8, 1440x900 
0x37CA2318, 38092268452360720, 226333422, 226333431, 9, 1440x900 
0x37CA2318, 38092268453030480, 226333492, 226333499, 7, 1440x900 
0x37CA2318, 38092268453681992, 226333558, 226333566, 8, 1440x900 
0x37CA2318, 38092268454345528, 226333627, 226333634, 7, 1440x900 
0x37CA2318, 38092268455015608, 226333688, 226333697, 9, 1440x900 
0x37CA2318, 38092268455676232, 226333758, 226333766, 8, 1440x900 
0x37CA2318, 38092268456336632, 226333822, 226333830, 8, 1440x900 
0x37CA2318, 38092268457006584, 226333887, 226333896, 9, 1440x900 
0x37CA2318, 38092268457658464, 226333954, 226333962, 8, 1440x900 
0x37CA2318, 38092268458313208, 226334022, 226334030, 8, 1440x900 
0x37CA2318, 38092268458989776, 226334087, 226334095, 8, 1440x900 
0x37CA2318, 38092268459641504, 226334153, 226334161, 8, 1440x900 
0x37CA2318, 38092268460303280, 226334217, 226334225, 8, 1440x900 
0x37CA2318, 38092268460957496, 226334287, 226334295, 8, 1440x900 
0x37CA2318, 38092268461633744, 226334353, 226334362, 9, 1440x900 
0x37CA2318, 38092268462304472, 226334417, 226334425, 8, 1440x900 
0x37CA2318, 38092268462961176, 226334487, 226334495, 8, 1440x900 
0x37CA2318, 38092268463628512, 226334552, 226334560, 8, 1440x900 
0x37CA2318, 38092268464298448, 226334617, 226334626, 9, 1440x900 
0x37CA2318, 38092268464955368, 226334683, 226334692, 9, 1440x900 
0x37CA2318, 38092268465618528, 226334753, 226334761, 8, 1440x900 
0x37CA2318, 38092268466272944, 226334813, 226334822, 9, 1440x900 
0x37CA2318, 38092268466927960, 226334882, 226334890, 8, 1440x900 
0x37CA2318, 38092268467607904, 226334948, 226334956, 8, 1440x900 
0x37CA2318, 38092268468260256, 226335017, 226335025, 8, 1440x900 
0x37CA2318, 38092268468923832, 226335078, 226335087, 9, 1440x900 
0x37CA2318, 38092268469584568, 226335149, 226335156, 7, 1440x900 
0x37CA2318, 38092268470244432, 226335214, 226335222, 8, 1440x900 
0x37CA2318, 38092268470905984, 226335277, 226335285, 8, 1440x900 
0x37CA2318, 38092268471567176, 226335348, 226335356, 8, 1440x900 
0x37CA2318, 38092268472235856, 226335412, 226335420, 8, 1440x900 
0x37CA2318, 38092268472889736, 226335478, 226335486, 8, 1440x900 
0x37CA2318, 38092268473547120, 226335545, 226335554, 9, 1440x900 
0x37CA2318, 38092268474216952, 226335608, 226335617, 9, 1440x900 
0x37CA2318, 38092268474872752, 226335677, 226335685, 8, 1440x900 
0x37CA2318, 38092268475528832, 226335743, 226335751, 8, 1440x900 
0x37CA2318, 38092268476191360, 226335807, 226335815, 8, 1440x900 
0x37CA2318, 38092268476851696, 226335873, 226335881, 8, 1440x900 
0x37CA2318, 38092268477513240, 226335938, 226335946, 8, 1440x900 
0x37CA2318, 38092268478176544, 226336008, 226336016, 8, 1440x900 
0x37CA2318, 38092268478837120, 226336073, 226336081, 8, 1440x900 
0x37CA2318, 38092268479504072, 226336138, 226336147, 9, 1440x900 
0x37CA2318, 38092268480165056, 226336208, 226336216, 8, 1440x900 
0x37CA2318, 38092268480822392, 226336272, 226336279, 7, 1440x900 
0x37CA2318, 38092268481485376, 226336337, 226336345, 8, 1440x900 
0x37CA2318, 38092268482154928, 226336403, 226336411, 8, 1440x900 
0x37CA2318, 38092268482815264, 226336473, 226336481, 8, 1440x900 
0x37CA2318, 38092268483465928, 226336537, 226336545, 8, 1440x900 
0x37CA2318, 38092268484127400, 226336603, 226336611, 8, 1440x900 
0x37CA2318, 38092268484797504, 226336667, 226336675, 8, 1440x900 
0x37CA2318, 38092268485447960, 226336732, 226336739, 7, 1440x900 
0x37CA2318, 38092268486112808, 226336798, 226336805, 7, 1440x900 
0x37CA2318, 38092268486771528, 226336863, 226336871, 8, 1440x900 
0x37CA2318, 38092268487441328, 226336932, 226336940, 8, 1440x900 
0x37CA2318, 38092268488092368, 226336997, 226337004, 7, 1440x900 
0x37CA2318, 38092268489407152, 226337132, 226337140, 8, 1440x900 
0x37CA2318, 38092268490070728, 226337194, 226337202, 8, 1440x900 
0x37CA2318, 38092268490741392, 226337263, 226337270, 7, 1440x900 
0x37CA2318, 38092268491400456, 226337333, 226337341, 8, 1440x900 
0x37CA2318, 38092268492060976, 226337394, 226337402, 8, 1440x900 
0x37CA2318, 38092268492720312, 226337458, 226337467, 9, 1440x900 
0x37CA2318, 38092268493392312, 226337528, 226337536, 8, 1440x900 
0x37CA2318, 38092268494041056, 226337592, 226337600, 8, 1440x900 
0x37CA2318, 38092268494696456, 226337657, 226337665, 8, 1440x900 
0x37CA2318, 38092268495368784, 226337727, 226337736, 9, 1440x900 
0x37CA2318, 38092268496028288, 226337793, 226337801, 8, 1440x900 
0x37CA2318, 38092268496679728, 226337858, 226337866, 8, 1440x900 
0x37CA2318, 38092268497349968, 226337923, 226337931, 8, 1440x900 
0x37CA2318, 38092268498019984, 226337993, 226338001, 8, 1440x900 
0x37CA2318, 38092268498681240, 226338058, 226338066, 8, 1440x900 
0x37CA2318, 38092268499335296, 226338124, 226338132, 8, 1440x900 
0x37CA2318, 38092268499997344, 226338187, 226338195, 8, 1440x900 
0x37CA2318, 38092268500663064, 226338257, 226338265, 8, 1440x900 
0x37CA2318, 38092268501318472, 226338322, 226338330, 8, 1440x900 
0x37CA2318, 38092268501984656, 226338389, 226338396, 7, 1440x900 
0x37CA2318, 38092268502647656, 226338453, 226338461, 8, 1440x900 
0x37CA2318, 38092268503306448, 226338518, 226338526, 8, 1440x900 
0x37CA2318, 38092268503962480, 226338583, 226338592, 9, 1440x900 
0x37CA2318, 38092268504628368, 226338652, 226338660, 8, 1440x900 
0x37CA2318, 38092268505285976, 226338718, 226338726, 8, 1440x900 
0x37CA2318, 38092268505956248, 226338783, 226338792, 9, 1440x900 
0x37CA2318, 38092268506606464, 226338852, 226338859, 7, 1440x900 
0x37CA2318, 38092268507266568, 226338919, 226338927, 8, 1440x900 
0x37CA2318, 38092268507927296, 226338983, 226338991, 8, 1440x900 
0x37CA2318, 38092268508593600, 226339047, 226339055, 8, 1440x900 
0x37CA2318, 38092268509246200, 226339113, 226339121, 8, 1440x900 
0x37CA2318, 38092268509909344, 226339182, 226339190, 8, 1440x900 
0x37CA2318, 38092268510562224, 226339247, 226339255, 8, 1440x900 
0x37CA2318, 38092268511233464, 226339312, 226339320, 8, 1440x900 
0x37CA2318, 38092268511892992, 226339378, 226339386, 8, 1440x900 
0x37CA2318, 38092268512545584, 226339442, 226339450, 8, 1440x900 
0x37CA2318, 38092268513212224, 226339508, 226339516, 8, 1440x900 
0x37CA2318, 38092268513874856, 226339573, 226339581, 8, 1440x900 
0x37CA2318, 38092268514535032, 226339642, 226339651, 9, 1440x900 
0x37CA2318, 38092268515199536, 226339708, 226339716, 8, 1440x900 
0x37CA2318, 38092268515859736, 226339777, 226339785, 8, 1440x900 
0x37CA2318, 38092268516520240, 226339842, 226339851, 9, 1440x900 
0x37CA2318, 38092268517178600, 226339903, 226339912, 9, 1440x900 
0x37CA2318, 38092268517841616, 226339972, 226339980, 8, 1440x900 
0x37CA2318, 38092268518491616, 226340038, 226340046, 8, 1440x900 
0x37CA2318, 38092268519153040, 226340102, 226340110, 8, 1440x900 
0x37CA2318, 38092268519817096, 226340173, 226340181, 8, 1440x900 
0x37CA2318, 38092268520471856, 226340238, 226340246, 8, 1440x900 
0x37CA2318, 38092268521139760, 226340303, 226340311, 8, 1440x900 
0x37CA2318, 38092268521800952, 226340368, 226340377, 9, 1440x900 
0x37CA2318, 38092268522460832, 226340433, 226340442, 9, 1440x900 
0x37CA2318, 38092268523126672, 226340503, 226340511, 8, 1440x900 
0x37CA2318, 38092268523786952, 226340567, 226340575, 8, 1440x900 
0x37CA2318, 38092268524448272, 226340632, 226340640, 8, 1440x900 
0x37CA2318, 38092268525100384, 226340697, 226340705, 8, 1440x900 
0x37CA2318, 38092268525780288, 226340767, 226340775, 8, 1440x900 
0x37CA2318, 38092268526432864, 226340833, 226340841, 8, 1440x900 
0x37CA2318, 38092268527092816, 226340898, 226340906, 8, 1440x900 
0x37CA2318, 38092268527756712, 226340963, 226340971, 8, 1440x900 
0x37CA2318, 38092268528420736, 226341028, 226341037, 9, 1440x900 
0x37CA2318, 38092268529075488, 226341098, 226341106, 8, 1440x900 
0x37CA2318, 38092268529741472, 226341162, 226341170, 8, 1440x900 
0x37CA2318, 38092268530401496, 226341232, 226341240, 8, 1440x900 
0x37CA2318, 38092268531062392, 226341292, 226341301, 9, 1440x900 
0x37CA2318, 38092268531732248, 226341363, 226341371, 8, 1440x900 
0x37CA2318, 38092268532384696, 226341429, 226341437, 8, 1440x900 
0x37CA2318, 38092268533054168, 226341492, 226341501, 9, 1440x900 
0x37CA2318, 38092268533714960, 226341558, 226341566, 8, 1440x900 
0x37CA2318, 38092268534366480, 226341628, 226341636, 8, 1440x900 
0x37CA2318, 38092268535019736, 226341693, 226341701, 8, 1440x900 
0x37CA2318, 38092268535699032, 226341758, 226341766, 8, 1440x900 
0x37CA2318, 38092268536351368, 226341822, 226341830, 8, 1440x900 
0x37CA2318, 38092268537011152, 226341888, 226341897, 9, 1440x900 
0x37CA2318, 38092268537680288, 226341958, 226341966, 8, 1440x900 
0x37CA2318, 38092268538341120, 226342022, 226342030, 8, 1440x900 
0x37CA2318, 38092268539002712, 226342088, 226342096, 8, 1440x900 
0x37CA2318, 38092268539672904, 226342153, 226342162, 9, 1440x900 
0x37CA2318, 38092268540322856, 226342223, 226342231, 8, 1440x900 
0x37CA2318, 38092268540993448, 226342288, 226342296, 8, 1440x900 
0x37CA2318, 38092268541642728, 226342353, 226342361, 8, 1440x900 
0x37CA2318, 38092268542310936, 226342422, 226342430, 8, 1440x900 
0x37CA2318, 38092268542962544, 226342483, 226342491, 8, 1440x900 
0x37CA2318, 38092268543632080, 226342553, 226342561, 8, 1440x900 
0x37CA2318, 38092268544292240, 226342616, 226342624, 8, 1440x900 
0x37CA2318, 38092268544954120, 226342682, 226342690, 8, 1440x900 
0x37CA2318, 38092268545615080, 226342748, 226342757, 9, 1440x900 
0x37CA2318, 38092268546284544, 226342817, 226342826, 9, 1440x900 
0x37CA2318, 38092268546946048, 226342884, 226342892, 8, 1440x900 
0x37CA2318, 38092268547614800, 226342947, 226342954, 7, 1440x900 
0x37CA2318, 38092268548275648, 226343013, 226343021, 8, 1440x900 
0x37CA2318, 38092268548926392, 226343081, 226343089, 8, 1440x900 
0x37CA2318, 38092268549584016, 226343147, 226343155, 8, 1440x900 
0x37CA2318, 38092268550258304, 226343212, 226343220, 8, 1440x900 
0x37CA2318, 38092268550927952, 226343281, 226343289, 8, 1440x900 
0x37CA2318, 38092268551581744, 226343343, 226343351, 8, 1440x900 
0x37CA2318, 38092268552242376, 226343412, 226343420, 8, 1440x900 
0x37CA2318, 38092268552899336, 226343477, 226343485, 8, 1440x900 
0x37CA2318, 38092268553555888, 226343548, 226343556, 8, 1440x900 
0x37CA2318, 38092268554221520, 226343613, 226343621, 8, 1440x900 
0x37CA2318, 38092268554885232, 226343677, 226343685, 8, 1440x900 
0x37CA2318, 38092268555552448, 226343742, 226343750, 8, 1440x900 
0x37CA2318, 38092268556205208, 226343812, 226343820, 8, 1440x900 
0x37CA2318, 38092268556865568, 226343873, 226343882, 9, 1440x900 
0x37CA2318, 38092268557534440, 226343944, 226343952, 8, 1440x900 
0x37CA2318, 38092268558184104, 226344004, 226344012, 8, 1440x900 
0x37CA2318, 38092268558845984, 226344072, 226344080, 8, 1440x900 
0x37CA2318, 38092268559510352, 226344137, 226344145, 8, 1440x900 
0x37CA2318, 38092268560171488, 226344204, 226344212, 8, 1440x900 
0x37CA2318, 38092268560835240, 226344274, 226344282, 8, 1440x900 
0x37CA2318, 38092268561493672, 226344338, 226344346, 8, 1440x900 
0x37CA2318, 38092268562158952, 226344408, 226344416, 8, 1440x900 
0x37CA2318, 38092268562821840, 226344468, 226344477, 9, 1440x900 
0x37CA2318, 38092268563471808, 226344533, 226344542, 9, 1440x900 
0x37CA2318, 38092268564133984, 226344602, 226344610, 8, 1440x900 
0x37CA2318, 38092268564795552, 226344668, 226344675, 7, 1440x900 
0x37CA2318, 38092268565456472, 226344738, 226344746, 8, 1440x900 
0x37CA2318, 38092268566124456, 226344803, 226344811, 8, 1440x900 
0x37CA2318, 38092268566775472, 226344868, 226344876, 8, 1440x900 
0x37CA2318, 38092268567447264, 226344933, 226344941, 8, 1440x900 
0x37CA2318, 38092268568099688, 226344997, 226345005, 8, 1440x900 
0x37CA2318, 38092268568759328, 226345063, 226345071, 8, 1440x900 
0x37CA2318, 38092268569430008, 226345134, 226345142, 8, 1440x900 
0x37CA2318, 38092268570733552, 226345263, 226345271, 8, 1440x900 
0x37CA2318, 38092268571404704, 226345328, 226345335, 7, 1440x900 
0x37CA2318, 38092268572068360, 226345397, 226345405, 8, 1440x900 
0x37CA2318, 38092268572720944, 226345463, 226345471, 8, 1440x900 
0x37CA2318, 38092268573383176, 226345527, 226345535, 8, 1440x900 
0x37CA2318, 38092268574053568, 226345597, 226345606, 9, 1440x900 
0x37CA2318, 38092268574716328, 226345663, 226345671, 8, 1440x900 
0x37CA2318, 38092268575385536, 226345728, 226345736, 8, 1440x900 
0x37CA2318, 38092268576036712, 226345792, 226345800, 8, 1440x900 
0x37CA2318, 38092268576702840, 226345857, 226345865, 8, 1440x900 
0x37CA2318, 38092268577353224, 226345922, 226345931, 9, 1440x900 
0x37CA2318, 38092268578023384, 226345993, 226346002, 9, 1440x900 
0x37CA2318, 38092268578690864, 226346058, 226346066, 8, 1440x900 
0x37CA2318, 38092268579343528, 226346123, 226346131, 8, 1440x900 
0x37CA2318, 38092268580006864, 226346188, 226346196, 8, 1440x900 
0x37CA2318, 38092268580656728, 226346253, 226346261, 8, 1440x900 
0x37CA2318, 38092268581326272, 226346322, 226346330, 8, 1440x900 
0x37CA2318, 38092268581988896, 226346388, 226346396, 8, 1440x900 
0x37CA2318, 38092268582641808, 226346453, 226346461, 8, 1440x900 
0x37CA2318, 38092268583320704, 226346522, 226346530, 8, 1440x900 
0x37CA2318, 38092268583979680, 226346582, 226346589, 7, 1440x900 
0x37CA2318, 38092268584640384, 226346653, 226346661, 8, 1440x900 
0x37CA2318, 38092268585303600, 226346718, 226346726, 8, 1440x900 
0x37CA2318, 38092268585962056, 226346787, 226346795, 8, 1440x900 
0x37CA2318, 38092268586619280, 226346851, 226346859, 8, 1440x900 
0x37CA2318, 38092268587288760, 226346913, 226346921, 8, 1440x900 
0x37CA2318, 38092268587942008, 226346982, 226346990, 8, 1440x900 
0x37CA2318, 38092268588601528, 226347047, 226347055, 8, 1440x900 
0x37CA2318, 38092268589263248, 226347113, 226347122, 9, 1440x900 
0x37CA2318, 38092268589932376, 226347182, 226347190, 8, 1440x900 
0x37CA2318, 38092268590584344, 226347248, 226347256, 8, 1440x900 
0x37CA2318, 38092268591253504, 226347312, 226347321, 9, 1440x900 
0x37CA2318, 38092268591907560, 226347383, 226347391, 8, 1440x900 
0x37CA2318, 38092268592574456, 226347448, 226347456, 8, 1440x900 
0x37CA2318, 38092268593234352, 226347514, 226347521, 7, 1440x900 
0x37CA2318, 38092268593888920, 226347577, 226347586, 9, 1440x900 
0x37CA2318, 38092268594540616, 226347642, 226347650, 8, 1440x900 
0x37CA2318, 38092268595205720, 226347712, 226347720, 8, 1440x900 
0x37CA2318, 38092268595868320, 226347773, 226347781, 8, 1440x900 
0x37CA2318, 38092268596531424, 226347842, 226347850, 8, 1440x900 
0x37CA2318, 38092268597192200, 226347907, 226347915, 8, 1440x900 
0x37CA2318, 38092268597855296, 226347974, 226347982, 8, 1440x900 
0x37CA2318, 38092268598514424, 226348039, 226348046, 7, 1440x900 
0x37CA2318, 38092268599166544, 226348103, 226348110, 7, 1440x900 
0x37CA2318, 38092268599837720, 226348172, 226348180, 8, 1440x900 
0x37CA2318, 38092268600497424, 226348238, 226348246, 8, 1440x900 
0x37CA2318, 38092268601154528, 226348303, 226348311, 8, 1440x900 
0x37CA2318, 38092268601808088, 226348368, 226348377, 9, 1440x900 
0x37CA2318, 38092268602470048, 226348437, 226348445, 8, 1440x900 
0x37CA2318, 38092268603140320, 226348502, 226348510, 8, 1440x900 
0x37CA2318, 38092268603799960, 226348567, 226348576, 9, 1440x900 
0x37CA2318, 38092268604469632, 226348638, 226348646, 8, 1440x900 
0x37CA2318, 38092268605121552, 226348702, 226348710, 8, 1440x900 
0x37CA2318, 38092268605783904, 226348768, 226348776, 8, 1440x900 
0x37CA2318, 38092268606452672, 226348832, 226348841, 9, 1440x900 
0x37CA2318, 38092268607122880, 226348903, 226348911, 8, 1440x900 
0x37CA2318, 38092268607782064, 226348963, 226348972, 9, 1440x900 
0x37CA2318, 38092268608445312, 226349033, 226349041, 8, 1440x900 
0x37CA2318, 38092268609104688, 226349098, 226349105, 7, 1440x900 
0x37CA2318, 38092268609765664, 226349168, 226349175, 7, 1440x900 
0x37CA2318, 38092268610427168, 226349233, 226349241, 8, 1440x900 
0x37CA2318, 38092268611085008, 226349298, 226349306, 8, 1440x900 
0x37CA2318, 38092268611744992, 226349364, 226349372, 8, 1440x900 
0x37CA2318, 38092268612405920, 226349432, 226349440, 8, 1440x900 
0x37CA2318, 38092268613066120, 226349498, 226349506, 8, 1440x900 
0x37CA2318, 38092268613726536, 226349562, 226349570, 8, 1440x900 
0x37CA2318, 38092268614387584, 226349628, 226349636, 8, 1440x900 
0x37CA2318, 38092268615040496, 226349692, 226349700, 8, 1440x900 
0x37CA2318, 38092268615711104, 226349762, 226349770, 8, 1440x900 
0x37CA2318, 38092268616365944, 226349828, 226349836, 8, 1440x900 
0x37CA2318, 38092268617027640, 226349893, 226349901, 8, 1440x900 
0x37CA2318, 38092268617688832, 226349958, 226349966, 8, 1440x900 
0x37CA2318, 38092268618349568, 226350022, 226350029, 7, 1440x900 
0x37CA2318, 38092268619002072, 226350093, 226350101, 8, 1440x900 
0x37CA2318, 38092268619666016, 226350153, 226350162, 9, 1440x900 
0x37CA2318, 38092268620328448, 226350222, 226350230, 8, 1440x900 
0x37CA2318, 38092268620993664, 226350287, 226350295, 8, 1440x900 
0x37CA2318, 38092268621643848, 226350352, 226350360, 8, 1440x900 
0x37CA2318, 38092268622306464, 226350422, 226350430, 8, 1440x900 
0x37CA2318, 38092268622976856, 226350488, 226350496, 8, 1440x900 
0x37CA2318, 38092268623629704, 226350553, 226350560, 7, 1440x900 
0x37CA2318, 38092268624291512, 226350617, 226350625, 8, 1440x900 
0x37CA2318, 38092268624952440, 226350683, 226350691, 8, 1440x900 
0x37CA2318, 38092268625616192, 226350752, 226350760, 8, 1440x900 
0x37CA2318, 38092268626285688, 226350819, 226350827, 8, 1440x900 
0x37CA2318, 38092268626947256, 226350883, 226350891, 8, 1440x900 
0x37CA2318, 38092268627597904, 226350947, 226350955, 8, 1440x900 
0x37CA2318, 38092268628258304, 226351017, 226351025, 8, 1440x900 
0x37CA2318, 38092268628920664, 226351083, 226351091, 8, 1440x900 
0x37CA2318, 38092268629587256, 226351148, 226351155, 7, 1440x900 
0x37CA2318, 38092268630242632, 226351214, 226351222, 8, 1440x900 
0x37CA2318, 38092268630906448, 226351282, 226351290, 8, 1440x900 
0x37CA2318, 38092268631565760, 226351343, 226351352, 9, 1440x900 
0x37CA2318, 38092268632224384, 226351413, 226351422, 9, 1440x900 
0x37CA2318, 38092268632877376, 226351478, 226351486, 8, 1440x900 
0x37CA2318, 38092268633546728, 226351547, 226351555, 8, 1440x900 
0x37CA2318, 38092268634208888, 226351607, 226351616, 9, 1440x900 
0x37CA2318, 38092268634867448, 226351673, 226351682, 9, 1440x900 
0x37CA2318, 38092268635523984, 226351742, 226351750, 8, 1440x900 
0x37CA2318, 38092268636191712, 226351807, 226351815, 8, 1440x900 
0x37CA2318, 38092268636860896, 226351873, 226351881, 8, 1440x900 
0x37CA2318, 38092268637513024, 226351942, 226351950, 8, 1440x900 
0x37CA2318, 38092268638181200, 226352008, 226352016, 8, 1440x900 
0x37CA2318, 38092268638833208, 226352072, 226352080, 8, 1440x900 
0x37CA2318, 38092268639492888, 226352138, 226352146, 8, 1440x900 
0x37CA2318, 38092268640163760, 226352202, 226352209, 7, 1440x900 
0x37CA2318, 38092268640823672, 226352272, 226352280, 8, 1440x900 
0x37CA2318, 38092268641475968, 226352338, 226352346, 8, 1440x900 
0x37CA2318, 38092268642136464, 226352403, 226352411, 8, 1440x900 
0x37CA2318, 38092268642796520, 226352468, 226352476, 8, 1440x900 
0x37CA2318, 38092268643466872, 226352533, 226352542, 9, 1440x900 
0x37CA2318, 38092268644117704, 226352602, 226352610, 8, 1440x900 
0x37CA2318, 38092268644779224, 226352668, 226352676, 8, 1440x900 
0x37CA2318, 38092268645440304, 226352733, 226352741, 8, 1440x900 
0x37CA2318, 38092268646101680, 226352798, 226352807, 9, 1440x900 
0x37CA2318, 38092268646763216, 226352862, 226352871, 9, 1440x900 
0x37CA2318, 38092268648085816, 226352997, 226353005, 8, 1440x900 
0x37CA2318, 38092268648751240, 226353063, 226353071, 8, 1440x900 
0x37CA2318, 38092268649402064, 226353132, 226353140, 8, 1440x900 
0x37CA2318, 38092268650071448, 226353193, 226353200, 7, 1440x900 
0x37CA2318, 38092268650722160, 226353258, 226353265, 7, 1440x900 
0x37CA2318, 38092268651382848, 226353323, 226353331, 8, 1440x900 
0x37CA2318, 38092268652044456, 226353393, 226353401, 8, 1440x900 
0x37CA2318, 38092268652704800, 226353458, 226353467, 9, 1440x900 
0x37CA2318, 38092268653360704, 226353524, 226353532, 8, 1440x900 
0x37CA2318, 38092268654039576, 226353592, 226353600, 8, 1440x900 
0x37CA2318, 38092268654692776, 226353657, 226353665, 8, 1440x900 
0x37CA2318, 38092268655259056, 226353713, 226353720, 7, 1440x900 
0x37CA2318, 38092268656011392, 226353788, 226353797, 9, 1440x900 
0x37CA2318, 38092268656626504, 226353852, 226353859, 7, 1440x900 
0x37CA2318, 38092268657335272, 226353922, 226353930, 8, 1440x900 
0x37CA2318, 38092268658004624, 226353987, 226353994, 7, 1440x900 
0x37CA2318, 38092268658655480, 226354052, 226354059, 7, 1440x900 
0x37CA2318, 38092268659325224, 226354118, 226354126, 8, 1440x900 
0x37CA2318, 38092268659987992, 226354187, 226354195, 8, 1440x900 
0x37CA2318, 38092268660639704, 226354253, 226354261, 8, 1440x900 
0x37CA2318, 38092268661300168, 226354318, 226354326, 8, 1440x900 
0x37CA2318, 38092268661956848, 226354382, 226354391, 9, 1440x900 
0x37CA2318, 38092268662627424, 226354453, 226354461, 8, 1440x900 
0x37CA2318, 38092268663279832, 226354517, 226354525, 8, 1440x900 
0x37CA2318, 38092268663941888, 226354582, 226354590, 8, 1440x900 
0x37CA2318, 38092268664602288, 226354647, 226354655, 8, 1440x900 
0x37CA2318, 38092268665263416, 226354713, 226354721, 8, 1440x900 
0x37CA2318, 38092268665925728, 226354783, 226354791, 8, 1440x900 
0x37CA2318, 38092268666586872, 226354848, 226354856, 8, 1440x900 
0x37CA2318, 38092268667247520, 226354913, 226354921, 8, 1440x900 
0x37CA2318, 38092268667907480, 226354978, 226354987, 9, 1440x900 
0x37CA2318, 38092268668561344, 226355043, 226355051, 8, 1440x900 
0x37CA2318, 38092268669237656, 226355113, 226355121, 8, 1440x900 
0x37CA2318, 38092268669897896, 226355178, 226355187, 9, 1440x900 
0x37CA2318, 38092268670550352, 226355242, 226355249, 7, 1440x900 
0x37CA2318, 38092268671204016, 226355308, 226355317, 9, 1440x900 
0x37CA2318, 38092268671874904, 226355378, 226355386, 8, 1440x900 
0x37CA2318, 38092268672534696, 226355442, 226355451, 9, 1440x900 
0x37CA2318, 38092268673195104, 226355507, 226355515, 8, 1440x900 
0x37CA2318, 38092268673856936, 226355573, 226355582, 9, 1440x900 
0x37CA2318, 38092268674525720, 226355643, 226355651, 8, 1440x900 
0x37CA2318, 38092268675195680, 226355712, 226355720, 8, 1440x900 
0x37CA2318, 38092268675843568, 226355772, 226355780, 8, 1440x900 
0x37CA2318, 38092268676522992, 226355842, 226355851, 9, 1440x900 
0x37CA2318, 38092268677174592, 226355908, 226355916, 8, 1440x900 
0x37CA2318, 38092268677827248, 226355973, 226355981, 8, 1440x900 
0x37CA2318, 38092268678504432, 226356039, 226356047, 8, 1440x900 
0x37CA2318, 38092268679166304, 226356108, 226356116, 8, 1440x900 
0x37CA2318, 38092268679822512, 226356168, 226356177, 9, 1440x900 
0x37CA2318, 38092268680474672, 226356233, 226356241, 8, 1440x900 
0x37CA2318, 38092268681144872, 226356303, 226356312, 9, 1440x900 
0x37CA2318, 38092268681807336, 226356372, 226356380, 8, 1440x900 
0x37CA2318, 38092268682467944, 226356437, 226356445, 8, 1440x900 
0x37CA2318, 38092268683125264, 226356504, 226356512, 8, 1440x900 
0x37CA2318, 38092268683786512, 226356567, 226356575, 8, 1440x900 
0x37CA2318, 38092268684448760, 226356631, 226356639, 8, 1440x900 
0x37CA2318, 38092268685099904, 226356697, 226356705, 8, 1440x900 
0x37CA2318, 38092268685773032, 226356763, 226356771, 8, 1440x900 
0x37CA2318, 38092268686442160, 226356831, 226356839, 8, 1440x900 
0x37CA2318, 38092268687103824, 226356902, 226356910, 8, 1440x900 
0x37CA2318, 38092268687758536, 226356963, 226356972, 9, 1440x900 
0x37CA2318, 38092268688417752, 226357032, 226357040, 8, 1440x900 
0x37CA2318, 38092268689083832, 226357098, 226357106, 8, 1440x900 
0x37CA2318, 38092268689739432, 226357163, 226357171, 8, 1440x900 
0x37CA2318, 38092268690405024, 226357228, 226357236, 8, 1440x900 
0x37CA2318, 38092268691066336, 226357297, 226357305, 8, 1440x900 
0x37CA2318, 38092268691735456, 226357362, 226357370, 8, 1440x900 
0x37CA2318, 38092268692383240, 226357427, 226357434, 7, 1440x900 
0x37CA2318, 38092268693054296, 226357493, 226357505, 12, 1440x900 
0x37CA2318, 38092268693717168, 226357559, 226357567, 8, 1440x900 
0x37CA2318, 38092268694378824, 226357628, 226357636, 8, 1440x900 
0x37CA2318, 38092268695048368, 226357693, 226357701, 8, 1440x900 
0x37CA2318, 38092268695702576, 226357757, 226357765, 8, 1440x900 
0x37CA2318, 38092268696354752, 226357824, 226357832, 8, 1440x900 
0x37CA2318, 38092268697024968, 226357893, 226357901, 8, 1440x900 
0x37CA2318, 38092268697686304, 226357957, 226357965, 8, 1440x900 
0x37CA2318, 38092268698356760, 226358027, 226358035, 8, 1440x900 
0x37CA2318, 38092268699007608, 226358089, 226358097, 8, 1440x900 
0x37CA2318, 38092268699667568, 226358153, 226358162, 9, 1440x900 
0x37CA2318, 38092268700335576, 226358222, 226358230, 8, 1440x900 
0x37CA2318, 38092268700995760, 226358288, 226358296, 8, 1440x900 
0x37CA2318, 38092268701658752, 226358358, 226358366, 8, 1440x900 
0x37CA2318, 38092268702310528, 226358417, 226358425, 8, 1440x900 
0x37CA2318, 38092268702978656, 226358486, 226358494, 8, 1440x900 
0x37CA2318, 38092268703638888, 226358552, 226358560, 8, 1440x900 
0x37CA2318, 38092268704290816, 226358618, 226358626, 8, 1440x900 
0x37CA2318, 38092268704961368, 226358683, 226358691, 8, 1440x900 
0x37CA2318, 38092268705625616, 226358753, 226358761, 8, 1440x900 
0x37CA2318, 38092268706287408, 226358817, 226358825, 8, 1440x900 
0x37CA2318, 38092268706947408, 226358883, 226358891, 8, 1440x900 
0x37CA2318, 38092268707609936, 226358948, 226358956, 8, 1440x900 
0x37CA2318, 38092268708261504, 226359013, 226359021, 8, 1440x900 
0x37CA2318, 38092268708933944, 226359083, 226359090, 7, 1440x900 
0x37CA2318, 38092268709592416, 226359147, 226359155, 8, 1440x900 
0x37CA2318, 38092268710253768, 226359217, 226359225, 8, 1440x900 
0x37CA2318, 38092268710914456, 226359283, 226359291, 8, 1440x900 
0x37CA2318, 38092268711584480, 226359348, 226359356, 8, 1440x900 
0x37CA2318, 38092268712232656, 226359412, 226359420, 8, 1440x900 
0x37CA2318, 38092268712910144, 226359478, 226359487, 9, 1440x900 
0x37CA2318, 38092268713572920, 226359547, 226359555, 8, 1440x900 
0x37CA2318, 38092268714232312, 226359613, 226359621, 8, 1440x900 
0x37CA2318, 38092268714884544, 226359677, 226359685, 8, 1440x900 
0x37CA2318, 38092268715540456, 226359743, 226359751, 8, 1440x900 
0x37CA2318, 38092268716213296, 226359812, 226359820, 8, 1440x900 
0x37CA2318, 38092268716873032, 226359877, 226359885, 8, 1440x900 
0x37CA2318, 38092268717533896, 226359942, 226359951, 9, 1440x900 
0x37CA2318, 38092268718195744, 226360008, 226360016, 8, 1440x900 
0x37CA2318, 38092268718854528, 226360073, 226360082, 9, 1440x900 
0x37CA2318, 38092268719509272, 226360138, 226360146, 8, 1440x900 
0x37CA2318, 38092268720178192, 226360208, 226360216, 8, 1440x900 
0x37CA2318, 38092268720847792, 226360273, 226360281, 8, 1440x900 
0x37CA2318, 38092268721502080, 226360337, 226360345, 8, 1440x900 
0x37CA2318, 38092268722168648, 226360403, 226360410, 7, 1440x900 
0x37CA2318, 38092268722814008, 226360467, 226360475, 8, 1440x900 
0x37CA2318, 38092268723478992, 226360533, 226360541, 8, 1440x900 
0x37CA2318, 38092268724140048, 226360601, 226360608, 7, 1440x900 
0x37CA2318, 38092268724809640, 226360672, 226360680, 8, 1440x900 
0x37CA2318, 38092268725463472, 226360733, 226360741, 8, 1440x900 
0x37CA2318, 38092268726123576, 226360798, 226360807, 9, 1440x900 
0x37CA2318, 38092268726774808, 226360868, 226360876, 8, 1440x900 
0x37CA2318, 38092268727435592, 226360932, 226360940, 8, 1440x900 
0x37CA2318, 38092268728104032, 226360997, 226361007, 10, 1440x900 
0x37CA2318, 38092268728759016, 226361067, 226361075, 8, 1440x900 
0x37CA2318, 38092268729426840, 226361132, 226361140, 8, 1440x900 
0x37CA2318, 38092268730747992, 226361262, 226361270, 8, 1440x900 
0x37CA2318, 38092268731409536, 226361328, 226361337, 9, 1440x900 
0x37CA2318, 38092268732069592, 226361393, 226361400, 7, 1440x900 
0x37CA2318, 38092268732730720, 226361463, 226361471, 8, 1440x900 
0x37CA2318, 38092268733391872, 226361527, 226361535, 8, 1440x900 
0x37CA2318, 38092268734053544, 226361589, 226361598, 9, 1440x900 
0x37CA2318, 38092268734706672, 226361657, 226361664, 7, 1440x900 
0x37CA2318, 38092268735383760, 226361723, 226361731, 8, 1440x900 
0x37CA2318, 38092268736041416, 226361792, 226361800, 8, 1440x900 
0x37CA2318, 38092268736692856, 226361857, 226361865, 8, 1440x900 
0x37CA2318, 38092268737363696, 226361928, 226361936, 8, 1440x900 
0x37CA2318, 38092268738015280, 226361993, 226362001, 8, 1440x900 
0x37CA2318, 38092268738668296, 226362054, 226362062, 8, 1440x900 
0x37CA2318, 38092268739330256, 226362123, 226362131, 8, 1440x900 
0x37CA2318, 38092268740000952, 226362188, 226362196, 8, 1440x900 
0x37CA2318, 38092268740655920, 226362253, 226362261, 8, 1440x900 
0x37CA2318, 38092268741327968, 226362322, 226362330, 8, 1440x900 
0x37CA2318, 38092268741985752, 226362389, 226362397, 8, 1440x900 
0x37CA2318, 38092268742637880, 226362452, 226362460, 8, 1440x900 
0x37CA2318, 38092268743309088, 226362518, 226362526, 8, 1440x900 
0x37CA2318, 38092268743968400, 226362588, 226362596, 8, 1440x900 
0x37CA2318, 38092268744637560, 226362657, 226362665, 8, 1440x900 
0x37CA2318, 38092268745297568, 226362722, 226362730, 8, 1440x900 
0x37CA2318, 38092268745957952, 226362787, 226362795, 8, 1440x900 
0x37CA2318, 38092268746608912, 226362848, 226362857, 9, 1440x900 
0x37CA2318, 38092268747278464, 226362917, 226362925, 8, 1440x900 
0x37CA2318, 38092268747929352, 226362983, 226362991, 8, 1440x900 
0x37CA2318, 38092268748591080, 226363047, 226363055, 8, 1440x900 
0x37CA2318, 38092268749253488, 226363113, 226363121, 8, 1440x900 
0x37CA2318, 38092268749913472, 226363183, 226363191, 8, 1440x900 
0x37CA2318, 38092268750575192, 226363248, 226363256, 8, 1440x900 
0x37CA2318, 38092268751235224, 226363313, 226363321, 8, 1440x900 
0x37CA2318, 38092268751896088, 226363376, 226363384, 8, 1440x900 
0x37CA2318, 38092268752557032, 226363448, 226363456, 8, 1440x900 
0x37CA2318, 38092268753218832, 226363512, 226363520, 8, 1440x900 
0x37CA2318, 38092268753879552, 226363578, 226363586, 8, 1440x900 
0x37CA2318, 38092268754531688, 226363642, 226363650, 8, 1440x900 
0x37CA2318, 38092268755195104, 226363708, 226363716, 8, 1440x900 
0x37CA2318, 38092268755858400, 226363773, 226363780, 7, 1440x900 
0x37CA2318, 38092268756519552, 226363838, 226363846, 8, 1440x900 
0x37CA2318, 38092268757182424, 226363903, 226363912, 9, 1440x900 
0x37CA2318, 38092268757849792, 226363973, 226363981, 8, 1440x900 
0x37CA2318, 38092268758509456, 226364037, 226364046, 9, 1440x900 
0x37CA2318, 38092268759172368, 226364107, 226364115, 8, 1440x900 
0x37CA2318, 38092268759823384, 226364168, 226364177, 9, 1440x900 
0x37CA2318, 38092268760494120, 226364238, 226364246, 8, 1440x900 
0x37CA2318, 38092268761159072, 226364308, 226364316, 8, 1440x900 
0x37CA2318, 38092268761820224, 226364373, 226364381, 8, 1440x900 
0x37CA2318, 38092268762479824, 226364438, 226364446, 8, 1440x900 
0x37CA2318, 38092268763148320, 226364503, 226364511, 8, 1440x900 
0x37CA2318, 38092268763803152, 226364572, 226364580, 8, 1440x900 
0x37CA2318, 38092268764468416, 226364638, 226364646, 8, 1440x900 
0x37CA2318, 38092268765127536, 226364703, 226364710, 7, 1440x900 
0x37CA2318, 38092268765789272, 226364767, 226364775, 8, 1440x900 
0x37CA2318, 38092268766451368, 226364832, 226364839, 7, 1440x900 
0x37CA2318, 38092268767112448, 226364897, 226364904, 7, 1440x900 
0x37CA2318, 38092268767779872, 226364967, 226364975, 8, 1440x900 
0x37CA2318, 38092268768440856, 226365032, 226365040, 8, 1440x900 
0x37CA2318, 38092268769110736, 226365102, 226365110, 8, 1440x900 
0x37CA2318, 38092268769761456, 226365163, 226365170, 7, 1440x900 
0x37CA2318, 38092268770423320, 226365228, 226365237, 9, 1440x900 
0x37CA2318, 38092268771080616, 226365298, 226365306, 8, 1440x900 
0x37CA2318, 38092268771745536, 226365363, 226365370, 7, 1440x900 
0x37CA2318, 38092268772405192, 226365432, 226365439, 7, 1440x900 
0x37CA2318, 38092268773060152, 226365493, 226365501, 8, 1440x900 
0x37CA2318, 38092268773724328, 226365562, 226365570, 8, 1440x900 
0x37CA2318, 38092268774376008, 226365628, 226365636, 8, 1440x900 
0x37CA2318, 38092268775037128, 226365693, 226365701, 8, 1440x900 
0x37CA2318, 38092268775698056, 226365758, 226365766, 8, 1440x900 
0x37CA2318, 38092268776358768, 226365823, 226365831, 8, 1440x900 
0x37CA2318, 38092268777019560, 226365888, 226365897, 9, 1440x900 
0x37CA2318, 38092268777689832, 226365958, 226365966, 8, 1440x900 
0x37CA2318, 38092268778357936, 226366023, 226366032, 9, 1440x900 
0x37CA2318, 38092268779021176, 226366092, 226366100, 8, 1440x900 
0x37CA2318, 38092268779672816, 226366157, 226366165, 8, 1440x900 
0x37CA2318, 38092268780333328, 226366222, 226366230, 8, 1440x900 
0x37CA2318, 38092268781004944, 226366292, 226366300, 8, 1440x900 
0x37CA2318, 38092268781663464, 226366357, 226366365, 8, 1440x900 
0x37CA2318, 38092268782321416, 226366422, 226366430, 8, 1440x900 
0x37CA2318, 38092268782986200, 226366487, 226366495, 8, 1440x900 
0x37CA2318, 38092268783644776, 226366553, 226366560, 7, 1440x900 
0x37CA2318, 38092268784296368, 226366618, 226366626, 8, 1440x900 
0x37CA2318, 38092268784957680, 226366688, 226366696, 8, 1440x900 
0x37CA2318, 38092268785618584, 226366749, 226366757, 8, 1440x900 
0x37CA2318, 38092268786287272, 226366818, 226366826, 8, 1440x900 
0x37CA2318, 38092268786937696, 226366881, 226366889, 8, 1440x900 
0x37CA2318, 38092268787599992, 226366952, 226366960, 8, 1440x900 
0x37CA2318, 38092268788261168, 226367013, 226367022, 9, 1440x900 
0x37CA2318, 38092268788917408, 226367078, 226367087, 9, 1440x900 
0x37CA2318, 38092268789580552, 226367148, 226367156, 8, 1440x900 
0x37CA2318, 38092268790245808, 226367214, 226367224, 10, 1440x900 
0x37CA2318, 38092268790897480, 226367282, 226367290, 8, 1440x900 
0x37CA2318, 38092268791562632, 226367348, 226367356, 8, 1440x900 
0x37CA2318, 38092268792226464, 226367412, 226367420, 8, 1440x900 
0x37CA2318, 38092268792895216, 226367482, 226367490, 8, 1440x900 
0x37CA2318, 38092268793547704, 226367548, 226367556, 8, 1440x900 
0x37CA2318, 38092268794208128, 226367608, 226367616, 8, 1440x900 
0x37CA2318, 38092268794867288, 226367677, 226367685, 8, 1440x900 
0x37CA2318, 38092268795529584, 226367742, 226367750, 8, 1440x900 
0x37CA2318, 38092268796189512, 226367808, 226367816, 8, 1440x900 
0x37CA2318, 38092268796851960, 226367872, 226367881, 9, 1440x900 
0x37CA2318, 38092268797520424, 226367943, 226367951, 8, 1440x900 
0x37CA2318, 38092268798173104, 226368007, 226368015, 8, 1440x900 
0x37CA2318, 38092268798830160, 226368072, 226368080, 8, 1440x900 
0x37CA2318, 38092268799510232, 226368142, 226368150, 8, 1440x900 
0x37CA2318, 38092268800161136, 226368203, 226368211, 8, 1440x900 
0x37CA2318, 38092268800830600, 226368272, 226368280, 8, 1440x900 
0x37CA2318, 38092268801483480, 226368337, 226368345, 8, 1440x900 
0x37CA2318, 38092268802143480, 226368403, 226368411, 8, 1440x900 
0x37CA2318, 38092268802804496, 226368468, 226368476, 8, 1440x900 
0x37CA2318, 38092268803465000, 226368532, 226368540, 8, 1440x900 
0x37CA2318, 38092268804134504, 226368598, 226368607, 9, 1440x900 
0x37CA2318, 38092268804785816, 226368663, 226368671, 8, 1440x900 
0x37CA2318, 38092268805449568, 226368731, 226368739, 8, 1440x900 
0x37CA2318, 38092268806110216, 226368803, 226368811, 8, 1440x900 
0x37CA2318, 38092268806769200, 226368868, 226368876, 8, 1440x900 
0x37CA2318, 38092268807430216, 226368933, 226368941, 8, 1440x900 
0x37CA2318, 38092268808751968, 226369067, 226369074, 7, 1440x900 
0x37CA2318, 38092268809414032, 226369128, 226369135, 7, 1440x900 
0x37CA2318, 38092268810074816, 226369197, 226369205, 8, 1440x900 
0x37CA2318, 38092268810734440, 226369258, 226369266, 8, 1440x900 
0x37CA2318, 38092268811394416, 226369327, 226369335, 8, 1440x900 
0x37CA2318, 38092268812057536, 226369397, 226369405, 8, 1440x900 
0x37CA2318, 38092268812717064, 226369458, 226369467, 9, 1440x900 
0x37CA2318, 38092268813389016, 226369527, 226369535, 8, 1440x900 
0x37CA2318, 38092268814032856, 226369592, 226369600, 8, 1440x900 
0x37CA2318, 38092268814703776, 226369657, 226369666, 9, 1440x900 
0x37CA2318, 38092268815364160, 226369727, 226369735, 8, 1440x900 
0x37CA2318, 38092268816025920, 226369793, 226369801, 8, 1440x900 
0x37CA2318, 38092268816686040, 226369857, 226369865, 8, 1440x900 
0x37CA2318, 38092268817337472, 226369923, 226369930, 7, 1440x900 
0x37CA2318, 38092268818004080, 226369988, 226369996, 8, 1440x900 
0x37CA2318, 38092268818667976, 226370054, 226370063, 9, 1440x900 
0x37CA2318, 38092268819336392, 226370123, 226370131, 8, 1440x900 
0x37CA2318, 38092268819987440, 226370188, 226370196, 8, 1440x900 
0x37CA2318, 38092268820649744, 226370257, 226370265, 8, 1440x900 
0x37CA2318, 38092268821310856, 226370318, 226370326, 8, 1440x900 
0x37CA2318, 38092268821980800, 226370388, 226370396, 8, 1440x900 
0x37CA2318, 38092268822637632, 226370452, 226370460, 8, 1440x900 
0x37CA2318, 38092268823292056, 226370518, 226370526, 8, 1440x900 
0x37CA2318, 38092268823953456, 226370588, 226370596, 8, 1440x900 
0x37CA2318, 38092268824622344, 226370652, 226370660, 8, 1440x900 
0x37CA2318, 38092268825276480, 226370718, 226370726, 8, 1440x900 
0x37CA2318, 38092268825931040, 226370783, 226370791, 8, 1440x900 
0x37CA2318, 38092268826599088, 226370847, 226370855, 8, 1440x900 
0x37CA2318, 38092268827260248, 226370917, 226370925, 8, 1440x900 
0x37CA2318, 38092268827911560, 226370982, 226370990, 8, 1440x900 
0x37CA2318, 38092268828573368, 226371043, 226371052, 9, 1440x900 
0x37CA2318, 38092268829242848, 226371111, 226371119, 8, 1440x900 
0x37CA2318, 38092268829906064, 226371178, 226371185, 7, 1440x900 
0x37CA2318, 38092268830566560, 226371243, 226371250, 7, 1440x900 
0x37CA2318, 38092268831220872, 226371308, 226371315, 7, 1440x900 
0x37CA2318, 38092268831892272, 226371377, 226371385, 8, 1440x900 
0x37CA2318, 38092268832543064, 226371443, 226371451, 8, 1440x900 
0x37CA2318, 38092268833203480, 226371513, 226371520, 7, 1440x900 
0x37CA2318, 38092268833865216, 226371573, 226371581, 8, 1440x900 
0x37CA2318, 38092268834526320, 226371638, 226371646, 8, 1440x900 
0x37CA2318, 38092268835190352, 226371708, 226371716, 8, 1440x900 
0x37CA2318, 38092268835850448, 226371773, 226371781, 8, 1440x900 
0x37CA2318, 38092268836512632, 226371839, 226371848, 9, 1440x900 
0x37CA2318, 38092268837173984, 226371908, 226371916, 8, 1440x900 
0x37CA2318, 38092268837844072, 226371973, 226371981, 8, 1440x900 
0x37CA2318, 38092268838502120, 226372037, 226372046, 9, 1440x900 
0x37CA2318, 38092268839164912, 226372108, 226372116, 8, 1440x900 
0x37CA2318, 38092268839824992, 226372174, 226372182, 8, 1440x900 
0x37CA2318, 38092268840478672, 226372238, 226372246, 8, 1440x900 
0x37CA2318, 38092268841140704, 226372302, 226372310, 8, 1440x900 
0x37CA2318, 38092268841791696, 226372367, 226372375, 8, 1440x900 
0x37CA2318, 38092268842452728, 226372437, 226372445, 8, 1440x900 
0x37CA2318, 38092268843122664, 226372503, 226372511, 8, 1440x900 
0x37CA2318, 38092268843782616, 226372569, 226372577, 8, 1440x900 
0x37CA2318, 38092268844443816, 226372632, 226372640, 8, 1440x900 
0x37CA2318, 38092268845105648, 226372698, 226372707, 9, 1440x900 
0x37CA2318, 38092268845765784, 226372767, 226372775, 8, 1440x900 
0x37CA2318, 38092268846427816, 226372833, 226372841, 8, 1440x900 
0x37CA2318, 38092268847082896, 226372898, 226372906, 8, 1440x900 
0x37CA2318, 38092268847752816, 226372962, 226372970, 8, 1440x900 
0x37CA2318, 38092268848414992, 226373029, 226373037, 8, 1440x900 
0x37CA2318, 38092268849076712, 226373098, 226373106, 8, 1440x900 
0x37CA2318, 38092268849742112, 226373162, 226373170, 8, 1440x900 
0x37CA2318, 38092268850392800, 226373223, 226373231, 8, 1440x900 
0x37CA2318, 38092268851053488, 226373293, 226373302, 9, 1440x900 
0x37CA2318, 38092268851716352, 226373363, 226373371, 8, 1440x900 
0x37CA2318, 38092268852378680, 226373428, 226373436, 8, 1440x900 
0x37CA2318, 38092268853043440, 226373493, 226373501, 8, 1440x900 
0x37CA2318, 38092268853697528, 226373558, 226373566, 8, 1440x900 
0x37CA2318, 38092268854354888, 226373623, 226373630, 7, 1440x900 
0x37CA2318, 38092268855016800, 226373688, 226373697, 9, 1440x900 
0x37CA2318, 38092268855678568, 226373758, 226373766, 8, 1440x900 
0x37CA2318, 38092268856339584, 226373823, 226373831, 8, 1440x900 
0x37CA2318, 38092268857001616, 226373887, 226373895, 8, 1440x900 
0x37CA2318, 38092268857663832, 226373953, 226373961, 8, 1440x900 
0x37CA2318, 38092268858315552, 226374018, 226374027, 9, 1440x900 
0x37CA2318, 38092268858986656, 226374087, 226374096, 9, 1440x900 
0x37CA2318, 38092268859647704, 226374157, 226374165, 8, 1440x900 
0x37CA2318, 38092268860307584, 226374222, 226374230, 8, 1440x900 
0x37CA2318, 38092268860967680, 226374283, 226374292, 9, 1440x900 
0x37CA2318, 38092268861639440, 226374352, 226374360, 8, 1440x900 
0x37CA2318, 38092268862298944, 226374422, 226374430, 8, 1440x900 
0x37CA2318, 38092268862958912, 226374487, 226374495, 8, 1440x900 
0x37CA2318, 38092268863618544, 226374552, 226374560, 8, 1440x900 
0x37CA2318, 38092268864277808, 226374618, 226374626, 8, 1440x900 
0x37CA2318, 38092268864931272, 226374683, 226374691, 8, 1440x900 
0x37CA2318, 38092268865592288, 226374748, 226374756, 8, 1440x900 
0x37CA2318, 38092268866253184, 226374817, 226374825, 8, 1440x900 
0x37CA2318, 38092268866914448, 226374883, 226374891, 8, 1440x900 
0x37CA2318, 38092268867574600, 226374948, 226374956, 8, 1440x900 
0x37CA2318, 38092268868235456, 226375013, 226375021, 8, 1440x900 
0x37CA2318, 38092268868896136, 226375077, 226375085, 8, 1440x900 
0x37CA2318, 38092268869565640, 226375148, 226375156, 8, 1440x900 
0x37CA2318, 38092268870217968, 226375212, 226375220, 8, 1440x900 
0x37CA2318, 38092268870885472, 226375278, 226375287, 9, 1440x900 
0x37CA2318, 38092268871536704, 226375342, 226375349, 7, 1440x900 
0x37CA2318, 38092268872187776, 226375406, 226375414, 8, 1440x900 
0x37CA2318, 38092268872858688, 226375472, 226375480, 8, 1440x900 
0x37CA2318, 38092268873522696, 226375542, 226375550, 8, 1440x900 
0x37CA2318, 38092268874189888, 226375607, 226375615, 8, 1440x900 
0x37CA2318, 38092268874841648, 226375668, 226375677, 9, 1440x900 
0x37CA2318, 38092268875504656, 226375743, 226375751, 8, 1440x900 
0x37CA2318, 38092268876158592, 226375803, 226375811, 8, 1440x900 
0x37CA2318, 38092268876822216, 226375869, 226375877, 8, 1440x900 
0x37CA2318, 38092268877487640, 226375938, 226375946, 8, 1440x900 
0x37CA2318, 38092268878138752, 226376003, 226376011, 8, 1440x900 
0x37CA2318, 38092268878810632, 226376068, 226376076, 8, 1440x900 
0x37CA2318, 38092268879479952, 226376138, 226376146, 8, 1440x900 
0x37CA2318, 38092268880131696, 226376203, 226376211, 8, 1440x900 
0x37CA2318, 38092268880792144, 226376268, 226376276, 8, 1440x900 
0x37CA2318, 38092268881455576, 226376333, 226376342, 9, 1440x900 
0x37CA2318, 38092268882113808, 226376397, 226376404, 7, 1440x900 
0x37CA2318, 38092268882775288, 226376468, 226376476, 8, 1440x900 
0x37CA2318, 38092268883441040, 226376532, 226376540, 8, 1440x900 
0x37CA2318, 38092268884090800, 226376598, 226376606, 8, 1440x900 
0x37CA2318, 38092268884771904, 226376667, 226376675, 8, 1440x900 
0x37CA2318, 38092268885440072, 226376731, 226376739, 8, 1440x900 
0x37CA2318, 38092268886093600, 226376797, 226376805, 8, 1440x900 
0x37CA2318, 38092268886756520, 226376863, 226376872, 9, 1440x900 
0x37CA2318, 38092268887423080, 226376932, 226376940, 8, 1440x900 
0x37CA2318, 38092268888093072, 226376997, 226377006, 9, 1440x900 
0x37CA2318, 38092268889405328, 226377132, 226377141, 9, 1440x900 
0x37CA2318, 38092268890066440, 226377197, 226377205, 8, 1440x900 
0x37CA2318, 38092268890722352, 226377259, 226377268, 9, 1440x900 
0x37CA2318, 38092268891392088, 226377332, 226377340, 8, 1440x900 
0x37CA2318, 38092268892052600, 226377393, 226377402, 9, 1440x900 
0x37CA2318, 38092268892721800, 226377462, 226377470, 8, 1440x900 
0x37CA2318, 38092268893381728, 226377528, 226377536, 8, 1440x900 
0x37CA2318, 38092268894035560, 226377593, 226377600, 7, 1440x900 
0x37CA2318, 38092268894695320, 226377658, 226377666, 8, 1440x900 
0x37CA2318, 38092268895365264, 226377725, 226377733, 8, 1440x900 
0x37CA2318, 38092268896007008, 226377788, 226377796, 8, 1440x900 
0x37CA2318, 38092268896677728, 226377857, 226377865, 8, 1440x900 
0x37CA2318, 38092268897338016, 226377923, 226377931, 8, 1440x900 
0x37CA2318, 38092268898000040, 226377988, 226377996, 8, 1440x900 
0x37CA2318, 38092268898660240, 226378053, 226378061, 8, 1440x900 
0x37CA2318, 38092268899321416, 226378119, 226378128, 9, 1440x900 
0x37CA2318, 38092268899984776, 226378187, 226378195, 8, 1440x900 
0x37CA2318, 38092268900636224, 226378253, 226378261, 8, 1440x900 
0x37CA2318, 38092268901298320, 226378318, 226378326, 8, 1440x900 
0x37CA2318, 38092268901968888, 226378388, 226378396, 8, 1440x900 
0x37CA2318, 38092268902629600, 226378453, 226378462, 9, 1440x900 
0x37CA2318, 38092268903293248, 226378518, 226378525, 7, 1440x900 
0x37CA2318, 38092268903951008, 226378582, 226378590, 8, 1440x900 
0x37CA2318, 38092268904612880, 226378652, 226378660, 8, 1440x900 
0x37CA2318, 38092268905271760, 226378717, 226378725, 8, 1440x900 
0x37CA2318, 38092268905932384, 226378782, 226378791, 9, 1440x900 
0x37CA2318, 38092268906591568, 226378848, 226378856, 8, 1440x900 
0x37CA2318, 38092268907261024, 226378914, 226378921, 7, 1440x900 
0x37CA2318, 38092268907914176, 226378979, 226378987, 8, 1440x900 
0x37CA2318, 38092268908575584, 226379048, 226379055, 7, 1440x900 
0x37CA2318, 38092268909237272, 226379113, 226379121, 8, 1440x900 
0x37CA2318, 38092268909888400, 226379177, 226379185, 8, 1440x900 
0x37CA2318, 38092268910558840, 226379243, 226379251, 8, 1440x900 
0x37CA2318, 38092268911211408, 226379307, 226379316, 9, 1440x900 
0x37CA2318, 38092268911881800, 226379378, 226379386, 8, 1440x900 
0x37CA2318, 38092268912539280, 226379443, 226379450, 7, 1440x900 
0x37CA2318, 38092268913197824, 226379512, 226379520, 8, 1440x900 
0x37CA2318, 38092268913857200, 226379572, 226379579, 7, 1440x900 
0x37CA2318, 38092268914527744, 226379643, 226379651, 8, 1440x900 
0x37CA2318, 38092268915184504, 226379707, 226379716, 9, 1440x900 
0x37CA2318, 38092268915835568, 226379772, 226379780, 8, 1440x900 
0x37CA2318, 38092268916497656, 226379838, 226379847, 9, 1440x900 
0x37CA2318, 38092268917177056, 226379908, 226379916, 8, 1440x900 
0x37CA2318, 38092268917829368, 226379973, 226379981, 8, 1440x900 
0x37CA2318, 38092268918489928, 226380038, 226380046, 8, 1440x900 
0x37CA2318, 38092268919151648, 226380102, 226380111, 9, 1440x900 
0x37CA2318, 38092268919820896, 226380172, 226380180, 8, 1440x900 
0x37CA2318, 38092268920479440, 226380237, 226380245, 8, 1440x900 
0x37CA2318, 38092268921137560, 226380304, 226380312, 8, 1440x900 
0x37CA2318, 38092268921797432, 226380368, 226380376, 8, 1440x900 
0x37CA2318, 38092268922456624, 226380433, 226380441, 8, 1440x900 
0x37CA2318, 38092268923114624, 226380503, 226380511, 8, 1440x900 
0x37CA2318, 38092268923779864, 226380568, 226380576, 8, 1440x900 
0x37CA2318, 38092268924439816, 226380631, 226380638, 7, 1440x900 
0x37CA2318, 38092268925102504, 226380697, 226380706, 9, 1440x900 
0x37CA2318, 38092268925769344, 226380767, 226380775, 8, 1440x900 
0x37CA2318, 38092268926427664, 226380833, 226380841, 8, 1440x900 
0x37CA2318, 38092268927097352, 226380902, 226380910, 8, 1440x900 
0x37CA2318, 38092268927755224, 226380963, 226380971, 8, 1440x900 
0x37CA2318, 38092268928407528, 226381032, 226381040, 8, 1440x900 
0x37CA2318, 38092268929079048, 226381097, 226381105, 8, 1440x900 
0x37CA2318, 38092268929737920, 226381161, 226381169, 8, 1440x900 
0x37CA2318, 38092268930374240, 226381222, 226381230, 8, 1440x900 
0x37CA2318, 38092268931066624, 226381292, 226381300, 8, 1440x900 
0x37CA2318, 38092268931726016, 226381358, 226381366, 8, 1440x900 
0x37CA2318, 38092268932387032, 226381423, 226381431, 8, 1440x900 
0x37CA2318, 38092268933040576, 226381491, 226381498, 7, 1440x900 
0x37CA2318, 38092268933708376, 226381558, 226381566, 8, 1440x900 
0x37CA2318, 38092268934371544, 226381628, 226381636, 8, 1440x900 
0x37CA2318, 38092268935025768, 226381688, 226381696, 8, 1440x900 
0x37CA2318, 38092268935703952, 226381758, 226381765, 7, 1440x900 
0x37CA2318, 38092268936365088, 226381828, 226381836, 8, 1440x900 
0x37CA2318, 38092268937027000, 226381893, 226381901, 8, 1440x900 
0x37CA2318, 38092268937686368, 226381958, 226381967, 9, 1440x900 
0x37CA2318, 38092268938355448, 226382023, 226382029, 6, 1440x900 
0x37CA2318, 38092268938813528, 226382068, 226382075, 7, 1440x900 
0x37CA2318, 38092268939679088, 226382153, 226382161, 8, 1440x900 
0x37CA2318, 38092268940328544, 226382218, 226382226, 8, 1440x900 
0x37CA2318, 38092268941008504, 226382287, 226382294, 7, 1440x900 
0x37CA2318, 38092268941659024, 226382353, 226382361, 8, 1440x900 
0x37CA2318, 38092268942319928, 226382422, 226382429, 7, 1440x900 
0x37CA2318, 38092268942791016, 226382468, 226382475, 7, 1440x900 
0x37CA2318, 38092268943631848, 226382552, 226382560, 8, 1440x900 
0x37CA2318, 38092268944296088, 226382618, 226382625, 7, 1440x900 
0x37CA2318, 38092268944965312, 226382686, 226382693, 7, 1440x900 
0x37CA2318, 38092268945629224, 226382748, 226382756, 8, 1440x900 
0x37CA2318, 38092268946298856, 226382817, 226382826, 9, 1440x900 
0x37CA2318, 38092268946969144, 226382884, 226382892, 8, 1440x900 
0x37CA2318, 38092268947628704, 226382953, 226382961, 8, 1440x900 
0x37CA2318, 38092268948282232, 226383018, 226383026, 8, 1440x900 
0x37CA2318, 38092268948949048, 226383083, 226383091, 8, 1440x900 
0x37CA2318, 38092268949600784, 226383148, 226383156, 8, 1440x900 
0x37CA2318, 38092268950258016, 226383218, 226383226, 8, 1440x900 
0x37CA2318, 38092268950919584, 226383282, 226383290, 8, 1440x900 
0x37CA2318, 38092268951586848, 226383348, 226383356, 8, 1440x900 
0x37CA2318, 38092268952239152, 226383412, 226383420, 8, 1440x900 
0x37CA2318, 38092268952905072, 226383478, 226383486, 8, 1440x900 
0x37CA2318, 38092268953560872, 226383542, 226383551, 9, 1440x900 
0x37CA2318, 38092268954231384, 226383613, 226383621, 8, 1440x900 
0x37CA2318, 38092268954888808, 226383690, 226383700, 10, 1440x900 
0x37CA2318, 38092268956015168, 226383787, 226383794, 7, 1440x900 
0x37CA2318, 38092268956869712, 226383877, 226383885, 8, 1440x900 
0x37CA2318, 38092268957540392, 226383943, 226383951, 8, 1440x900 
0x37CA2318, 38092268958199392, 226384007, 226384016, 9, 1440x900 
0x37CA2318, 38092268958851416, 226384073, 226384081, 8, 1440x900 
0x37CA2318, 38092268959502816, 226384137, 226384144, 7, 1440x900 
0x37CA2318, 38092268960165632, 226384203, 226384211, 8, 1440x900 
0x37CA2318, 38092268960835896, 226384272, 226384280, 8, 1440x900 
0x37CA2318, 38092268961496528, 226384337, 226384346, 9, 1440x900 
0x37CA2318, 38092268962157824, 226384402, 226384410, 8, 1440x900 
0x37CA2318, 38092268962818304, 226384468, 226384475, 7, 1440x900 
0x37CA2318, 38092268963479328, 226384537, 226384545, 8, 1440x900 
0x37CA2318, 38092268964140752, 226384603, 226384611, 8, 1440x900 
0x37CA2318, 38092268964802480, 226384668, 226384676, 8, 1440x900 
0x37CA2318, 38092268965461392, 226384733, 226384742, 9, 1440x900 
0x37CA2318, 38092268966119152, 226384798, 226384805, 7, 1440x900 
0x37CA2318, 38092268966780288, 226384866, 226384873, 7, 1440x900 
0x37CA2318, 38092268967442968, 226384933, 226384941, 8, 1440x900 
0x37CA2318, 38092268968099248, 226384997, 226385005, 8, 1440x900 
0x37CA2318, 38092268968761392, 226385063, 226385072, 9, 1440x900 
0x37CA2318, 38092268969434320, 226385132, 226385140, 8, 1440x900 
0x37CA2318, 38092268970095456, 226385198, 226385206, 8, 1440x900 
0x37CA2318, 38092268970757736, 226385263, 226385271, 8, 1440x900 
0x37CA2318, 38092268971408864, 226385328, 226385337, 9, 1440x900 
0x37CA2318, 38092268972069472, 226385398, 226385406, 8, 1440x900 
0x37CA2318, 38092268972731912, 226385463, 226385471, 8, 1440x900 
0x37CA2318, 38092268973393088, 226385528, 226385536, 8, 1440x900 
0x37CA2318, 38092268974058840, 226385598, 226385606, 8, 1440x900 
0x37CA2318, 38092268974719376, 226385663, 226385671, 8, 1440x900 
0x37CA2318, 38092268975389984, 226385728, 226385736, 8, 1440x900 
0x37CA2318, 38092268976045096, 226385794, 226385802, 8, 1440x900 
0x37CA2318, 38092268976695632, 226385858, 226385867, 9, 1440x900 
0x37CA2318, 38092268977367984, 226385923, 226385932, 9, 1440x900 
0x37CA2318, 38092268978022800, 226385992, 226386000, 8, 1440x900 
0x37CA2318, 38092268978681184, 226386057, 226386065, 8, 1440x900 
0x37CA2318, 38092268979335944, 226386123, 226386131, 8, 1440x900 
0x37CA2318, 38092268980007896, 226386188, 226386196, 8, 1440x900 
0x37CA2318, 38092268980669240, 226386258, 226386266, 8, 1440x900 
0x37CA2318, 38092268981324496, 226386323, 226386331, 8, 1440x900 
0x37CA2318, 38092268982002712, 226386389, 226386397, 8, 1440x900 
0x37CA2318, 38092268982673360, 226386453, 226386462, 9, 1440x900 
0x37CA2318, 38092268983328656, 226386523, 226386531, 8, 1440x900 
0x37CA2318, 38092268983993656, 226386588, 226386596, 8, 1440x900 
0x37CA2318, 38092268984659104, 226386653, 226386661, 8, 1440x900 
0x37CA2318, 38092268985319856, 226386722, 226386730, 8, 1440x900 
0x37CA2318, 38092268985972520, 226386787, 226386795, 8, 1440x900 
0x37CA2318, 38092268986633016, 226386853, 226386861, 8, 1440x900 
0x37CA2318, 38092268987301576, 226386917, 226386925, 8, 1440x900 
0x37CA2318, 38092268987954208, 226386983, 226386991, 8, 1440x900 
0x37CA2318, 38092268988614568, 226387049, 226387058, 9, 1440x900 
0x37CA2318, 38092268989275448, 226387118, 226387126, 8, 1440x900 
0x37CA2318, 38092268989939680, 226387182, 226387190, 8, 1440x900 
0x37CA2318, 38092268990608712, 226387248, 226387256, 8, 1440x900 
0x37CA2318, 38092268991262296, 226387317, 226387325, 8, 1440x900 
0x37CA2318, 38092268991931216, 226387378, 226387386, 8, 1440x900 
0x37CA2318, 38092268992582152, 226387448, 226387456, 8, 1440x900 
0x37CA2318, 38092268993252544, 226387513, 226387521, 8, 1440x900 
0x37CA2318, 38092268993905168, 226387582, 226387590, 8, 1440x900 
0x37CA2318, 38092268994566240, 226387643, 226387652, 9, 1440x900 
0x37CA2318, 38092268995227264, 226387713, 226387721, 8, 1440x900 
0x37CA2318, 38092268995888616, 226387777, 226387785, 8, 1440x900 
0x37CA2318, 38092268996549896, 226387847, 226387855, 8, 1440x900 
0x37CA2318, 38092268997218464, 226387911, 226387919, 8, 1440x900 
0x37CA2318, 38092268997868192, 226387978, 226387985, 7, 1440x900 
0x37CA2318, 38092268998540216, 226388042, 226388050, 8, 1440x900 
0x37CA2318, 38092268999199600, 226388108, 226388116, 8, 1440x900 
0x37CA2318, 38092268999851808, 226388173, 226388181, 8, 1440x900 
0x37CA2318, 38092269000521352, 226388243, 226388251, 8, 1440x900 
0x37CA2318, 38092269001182352, 226388308, 226388316, 8, 1440x900 
0x37CA2318, 38092269001836176, 226388373, 226388381, 8, 1440x900 
0x37CA2318, 38092269002499224, 226388438, 226388446, 8, 1440x900 
0x37CA2318, 38092269003152080, 226388503, 226388511, 8, 1440x900 
0x37CA2318, 38092269003814520, 226388568, 226388576, 8, 1440x900 
0x37CA2318, 38092269004473544, 226388637, 226388645, 8, 1440x900 
0x37CA2318, 38092269005135840, 226388702, 226388710, 8, 1440x900 
0x37CA2318, 38092269005795512, 226388768, 226388776, 8, 1440x900 
0x37CA2318, 38092269006465160, 226388839, 226388847, 8, 1440x900 
0x37CA2318, 38092269007124696, 226388903, 226388911, 8, 1440x900 
0x37CA2318, 38092269007783528, 226388967, 226388974, 7, 1440x900 
0x37CA2318, 38092269008445776, 226389033, 226389041, 8, 1440x900 
0x37CA2318, 38092269009100528, 226389098, 226389106, 8, 1440x900 
0x37CA2318, 38092269009775808, 226389168, 226389176, 8, 1440x900 
0x37CA2318, 38092269010421240, 226389233, 226389241, 8, 1440x900 
0x37CA2318, 38092269011091216, 226389298, 226389306, 8, 1440x900 
0x37CA2318, 38092269011752056, 226389362, 226389371, 9, 1440x900 
0x37CA2318, 38092269012412008, 226389428, 226389437, 9, 1440x900 
0x37CA2318, 38092269013076208, 226389497, 226389505, 8, 1440x900 
0x37CA2318, 38092269013745880, 226389563, 226389571, 8, 1440x900 
0x37CA2318, 38092269014402216, 226389628, 226389636, 8, 1440x900 
0x37CA2318, 38092269015057032, 226389693, 226389702, 9, 1440x900 
0x37CA2318, 38092269015720992, 226389763, 226389771, 8, 1440x900 
0x37CA2318, 38092269016387968, 226389827, 226389835, 8, 1440x900 
0x37CA2318, 38092269017042936, 226389892, 226389900, 8, 1440x900 
0x37CA2318, 38092269017710848, 226389959, 226389967, 8, 1440x900 
0x37CA2318, 38092269018358704, 226390023, 226390031, 8, 1440x900 
0x37CA2318, 38092269019025664, 226390093, 226390101, 8, 1440x900 
0x37CA2318, 38092269019676472, 226390158, 226390165, 7, 1440x900 
0x37CA2318, 38092269020342112, 226390222, 226390230, 8, 1440x900 
0x37CA2318, 38092269021009232, 226390288, 226390296, 8, 1440x900 
0x37CA2318, 38092269021666672, 226390354, 226390362, 8, 1440x900 
0x37CA2318, 38092269022337488, 226390423, 226390431, 8, 1440x900 
0x37CA2318, 38092269022994128, 226390487, 226390495, 8, 1440x900 
0x37CA2318, 38092269023659264, 226390553, 226390561, 8, 1440x900 
0x37CA2318, 38092269024311472, 226390623, 226390631, 8, 1440x900 
0x37CA2318, 38092269024972816, 226390683, 226390692, 9, 1440x900 
0x37CA2318, 38092269025633936, 226390752, 226390760, 8, 1440x900 
0x37CA2318, 38092269026285168, 226390818, 226390826, 8, 1440x900 
0x37CA2318, 38092269026955120, 226390887, 226390895, 8, 1440x900 
0x37CA2318, 38092269027616792, 226390952, 226390960, 8, 1440x900 
0x37CA2318, 38092269028286160, 226391017, 226391025, 8, 1440x900 
0x37CA2318, 38092269028936912, 226391082, 226391090, 8, 1440x900 
0x37CA2318, 38092269029597488, 226391152, 226391160, 8, 1440x900 
0x37CA2318, 38092269030262704, 226391212, 226391219, 7, 1440x900 
0x37CA2318, 38092269030915952, 226391278, 226391285, 7, 1440x900 
0x37CA2318, 38092269031576792, 226391348, 226391356, 8, 1440x900 
0x37CA2318, 38092269032238768, 226391413, 226391421, 8, 1440x900 
0x37CA2318, 38092269032908472, 226391482, 226391490, 8, 1440x900 
0x37CA2318, 38092269033569368, 226391547, 226391555, 8, 1440x900 
0x37CA2318, 38092269034228888, 226391613, 226391621, 8, 1440x900 
0x37CA2318, 38092269034879808, 226391677, 226391685, 8, 1440x900 
0x37CA2318, 38092269035541208, 226391742, 226391750, 8, 1440x900 
0x37CA2318, 38092269036868624, 226391873, 226391882, 9, 1440x900 
0x37CA2318, 38092269037522656, 226391942, 226391950, 8, 1440x900 
0x37CA2318, 38092269038181928, 226392007, 226392015, 8, 1440x900 
0x37CA2318, 38092269038843520, 226392068, 226392076, 8, 1440x900 
0x37CA2318, 38092269039507592, 226392138, 226392146, 8, 1440x900 
0x37CA2318, 38092269040167408, 226392208, 226392216, 8, 1440x900 
0x37CA2318, 38092269040837160, 226392271, 226392279, 8, 1440x900 
0x37CA2318, 38092269041488880, 226392336, 226392343, 7, 1440x900 
0x37CA2318, 38092269042158576, 226392402, 226392410, 8, 1440x900 
0x37CA2318, 38092269042818816, 226392472, 226392480, 8, 1440x900 
0x37CA2318, 38092269043472928, 226392537, 226392545, 8, 1440x900 
0x37CA2318, 38092269044122504, 226392603, 226392611, 8, 1440x900 
0x37CA2318, 38092269044793752, 226392667, 226392675, 8, 1440x900 
0x37CA2318, 38092269045454568, 226392734, 226392742, 8, 1440x900 
0x37CA2318, 38092269046115528, 226392803, 226392811, 8, 1440x900 
0x37CA2318, 38092269046774528, 226392863, 226392870, 7, 1440x900 
0x37CA2318, 38092269047438848, 226392932, 226392940, 8, 1440x900 
0x37CA2318, 38092269048097912, 226392998, 226393006, 8, 1440x900 
0x37CA2318, 38092269048757712, 226393062, 226393069, 7, 1440x900 
0x37CA2318, 38092269049417328, 226393128, 226393137, 9, 1440x900 
0x37CA2318, 38092269050075808, 226393198, 226393206, 8, 1440x900 
0x37CA2318, 38092269050738224, 226393263, 226393271, 8, 1440x900 
0x37CA2318, 38092269051395216, 226393327, 226393334, 7, 1440x900 
0x37CA2318, 38092269052059648, 226393393, 226393401, 8, 1440x900 
0x37CA2318, 38092269052727488, 226393463, 226393471, 8, 1440x900 
0x37CA2318, 38092269053384192, 226393528, 226393536, 8, 1440x900 
0x37CA2318, 38092269054042672, 226393593, 226393602, 9, 1440x900 
0x37CA2318, 38092269054698512, 226393658, 226393666, 8, 1440x900 
0x37CA2318, 38092269055363568, 226393727, 226393735, 8, 1440x900 
0x37CA2318, 38092269056020824, 226393793, 226393801, 8, 1440x900 
0x37CA2318, 38092269056687816, 226393858, 226393866, 8, 1440x900 
0x37CA2318, 38092269057339976, 226393922, 226393930, 8, 1440x900 
0x37CA2318, 38092269058010664, 226393989, 226393997, 8, 1440x900 
0x37CA2318, 38092269058663376, 226394052, 226394060, 8, 1440x900 
0x37CA2318, 38092269059321336, 226394117, 226394125, 8, 1440x900 
0x37CA2318, 38092269059984648, 226394187, 226394195, 8, 1440x900 
0x37CA2318, 38092269060643416, 226394252, 226394260, 8, 1440x900 
0x37CA2318, 38092269061310456, 226394318, 226394326, 8, 1440x900 
0x37CA2318, 38092269061968000, 226394387, 226394395, 8, 1440x900 
0x37CA2318, 38092269062620080, 226394448, 226394455, 7, 1440x900 
0x37CA2318, 38092269063291192, 226394513, 226394521, 8, 1440x900 
0x37CA2318, 38092269063944456, 226394583, 226394591, 8, 1440x900 
0x37CA2318, 38092269064604360, 226394649, 226394656, 7, 1440x900 
0x37CA2318, 38092269065265952, 226394718, 226394725, 7, 1440x900 
0x37CA2318, 38092269065936200, 226394783, 226394791, 8, 1440x900 
0x37CA2318, 38092269066586928, 226394848, 226394856, 8, 1440x900 
0x37CA2318, 38092269067248272, 226394913, 226394921, 8, 1440x900 
0x37CA2318, 38092269067911744, 226394982, 226394990, 8, 1440x900 
0x37CA2318, 38092269068565032, 226395043, 226395052, 9, 1440x900 
0x37CA2318, 38092269069225616, 226395113, 226395121, 8, 1440x900 
0x37CA2318, 38092269069887264, 226395177, 226395185, 8, 1440x900 
0x37CA2318, 38092269070547464, 226395243, 226395251, 8, 1440x900 
0x37CA2318, 38092269071216360, 226395309, 226395318, 9, 1440x900 
0x37CA2318, 38092269071865064, 226395372, 226395379, 7, 1440x900 
0x37CA2318, 38092269072527856, 226395443, 226395451, 8, 1440x900 
0x37CA2318, 38092269073187888, 226395507, 226395515, 8, 1440x900 
0x37CA2318, 38092269073848656, 226395572, 226395580, 8, 1440x900 
0x37CA2318, 38092269074517768, 226395638, 226395645, 7, 1440x900 
0x37CA2318, 38092269075168912, 226395703, 226395710, 7, 1440x900 
0x37CA2318, 38092269075829328, 226395771, 226395779, 8, 1440x900 
0x37CA2318, 38092269076489600, 226395838, 226395845, 7, 1440x900 
0x37CA2318, 38092269077152232, 226395901, 226395909, 8, 1440x900 
0x37CA2318, 38092269077821168, 226395968, 226395975, 7, 1440x900 
0x37CA2318, 38092269078473232, 226396033, 226396040, 7, 1440x900 
0x37CA2318, 38092269079124720, 226396102, 226396109, 7, 1440x900 
0x37CA2318, 38092269079790768, 226396168, 226396176, 8, 1440x900 
0x37CA2318, 38092269080459808, 226396233, 226396241, 8, 1440x900 
0x37CA2318, 38092269081122744, 226396302, 226396310, 8, 1440x900 
0x37CA2318, 38092269081782840, 226396368, 226396376, 8, 1440x900 
0x37CA2318, 38092269082443248, 226396432, 226396440, 8, 1440x900 
0x37CA2318, 38092269083094800, 226396497, 226396504, 7, 1440x900 
0x37CA2318, 38092269083765096, 226396563, 226396570, 7, 1440x900 
0x37CA2318, 38092269084426264, 226396632, 226396640, 8, 1440x900 
0x37CA2318, 38092269085093360, 226396698, 226396706, 8, 1440x900 
0x37CA2318, 38092269085753424, 226396763, 226396772, 9, 1440x900 
0x37CA2318, 38092269086416456, 226396832, 226396840, 8, 1440x900 
0x37CA2318, 38092269087067184, 226396897, 226396905, 8, 1440x900 
0x37CA2318, 38092269087727608, 226396963, 226396971, 8, 1440x900 
0x37CA2318, 38092269088390136, 226397028, 226397036, 8, 1440x900 
0x37CA2318, 38092269089049880, 226397092, 226397101, 9, 1440x900 
0x37CA2318, 38092269089700344, 226397156, 226397164, 8, 1440x900 
0x37CA2318, 38092269090364544, 226397224, 226397233, 9, 1440x900 
0x37CA2318, 38092269091031560, 226397293, 226397301, 8, 1440x900 
0x37CA2318, 38092269091695864, 226397362, 226397370, 8, 1440x900 
0x37CA2318, 38092269092363936, 226397424, 226397432, 8, 1440x900 
0x37CA2318, 38092269093018616, 226397493, 226397501, 8, 1440x900 
0x37CA2318, 38092269093676000, 226397553, 226397561, 8, 1440x900 
0x37CA2318, 38092269094331768, 226397622, 226397630, 8, 1440x900 
0x37CA2318, 38092269095010928, 226397688, 226397695, 7, 1440x900 
0x37CA2318, 38092269095665984, 226397758, 226397765, 7, 1440x900 
0x37CA2318, 38092269096322472, 226397823, 226397831, 8, 1440x900 
0x37CA2318, 38092269096985368, 226397888, 226397895, 7, 1440x900 
0x37CA2318, 38092269097649248, 226397953, 226397961, 8, 1440x900 
0x37CA2318, 38092269098306208, 226398022, 226398030, 8, 1440x900 
0x37CA2318, 38092269098958360, 226398083, 226398092, 9, 1440x900 
0x37CA2318, 38092269099620112, 226398148, 226398157, 9, 1440x900 
0x37CA2318, 38092269100289648, 226398218, 226398226, 8, 1440x900 
0x37CA2318, 38092269100959664, 226398287, 226398295, 8, 1440x900 
0x37CA2318, 38092269101621512, 226398349, 226398358, 9, 1440x900 
0x37CA2318, 38092269102276504, 226398417, 226398425, 8, 1440x900 
0x37CA2318, 38092269102927488, 226398482, 226398490, 8, 1440x900 
0x37CA2318, 38092269103590408, 226398548, 226398556, 8, 1440x900 
0x37CA2318, 38092269104249184, 226398612, 226398619, 7, 1440x900 
0x37CA2318, 38092269104915496, 226398683, 226398691, 8, 1440x900 
0x37CA2318, 38092269105576016, 226398748, 226398756, 8, 1440x900 
0x37CA2318, 38092269106235728, 226398813, 226398820, 7, 1440x900 
0x37CA2318, 38092269106906800, 226398878, 226398886, 8, 1440x900 
0x37CA2318, 38092269107557496, 226398947, 226398955, 8, 1440x900 
0x37CA2318, 38092269108219504, 226399008, 226399017, 9, 1440x900 
0x37CA2318, 38092269108875072, 226399079, 226399087, 8, 1440x900 
0x37CA2318, 38092269109540488, 226399142, 226399151, 9, 1440x900 
0x37CA2318, 38092269110866208, 226399278, 226399286, 8, 1440x900 
0x37CA2318, 38092269111527000, 226399343, 226399351, 8, 1440x900 
0x37CA2318, 38092269112187168, 226399408, 226399416, 8, 1440x900 
0x37CA2318, 38092269112841176, 226399473, 226399481, 8, 1440x900 
0x37CA2318, 38092269113501488, 226399538, 226399546, 8, 1440x900 
0x37CA2318, 38092269114167736, 226399604, 226399612, 8, 1440x900 
0x37CA2318, 38092269114821472, 226399668, 226399677, 9, 1440x900 
0x37CA2318, 38092269115492936, 226399738, 226399746, 8, 1440x900 
0x37CA2318, 38092269116152624, 226399802, 226399810, 8, 1440x900 
0x37CA2318, 38092269116814024, 226399868, 226399877, 9, 1440x900 
0x37CA2318, 38092269117483784, 226399939, 226399947, 8, 1440x900 
0x37CA2318, 38092269118135440, 226400003, 226400011, 8, 1440x900 
0x37CA2318, 38092269118791160, 226400067, 226400075, 8, 1440x900 
0x37CA2318, 38092269119456416, 226400133, 226400142, 9, 1440x900 
0x37CA2318, 38092269120106792, 226400198, 226400205, 7, 1440x900 
0x37CA2318, 38092269120769584, 226400263, 226400271, 8, 1440x900 
0x37CA2318, 38092269121438656, 226400332, 226400340, 8, 1440x900 
0x37CA2318, 38092269122100264, 226400398, 226400406, 8, 1440x900 
0x37CA2318, 38092269122752240, 226400463, 226400471, 8, 1440x900 
0x37CA2318, 38092269123415024, 226400529, 226400536, 7, 1440x900 
0x37CA2318, 38092269124088800, 226400597, 226400605, 8, 1440x900 
0x37CA2318, 38092269124756560, 226400662, 226400669, 7, 1440x900 
0x37CA2318, 38092269125416064, 226400727, 226400734, 7, 1440x900 
0x37CA2318, 38092269126075872, 226400797, 226400804, 7, 1440x900 
0x37CA2318, 38092269126747192, 226400862, 226400870, 8, 1440x900 
0x37CA2318, 38092269127397504, 226400927, 226400935, 8, 1440x900 
0x37CA2318, 38092269128057000, 226400993, 226401001, 8, 1440x900 
0x37CA2318, 38092269128726312, 226401062, 226401071, 9, 1440x900 
0x37CA2318, 38092269129376848, 226401128, 226401136, 8, 1440x900 
0x37CA2318, 38092269130045656, 226401193, 226401202, 9, 1440x900 
0x37CA2318, 38092269130698912, 226401258, 226401266, 8, 1440x900 
0x37CA2318, 38092269131359472, 226401327, 226401335, 8, 1440x900 
0x37CA2318, 38092269132020256, 226401392, 226401400, 8, 1440x900 
0x37CA2318, 38092269132674272, 226401454, 226401463, 9, 1440x900 
0x37CA2318, 38092269133343672, 226401523, 226401531, 8, 1440x900 
0x37CA2318, 38092269134005168, 226401588, 226401597, 9, 1440x900 
0x37CA2318, 38092269134667720, 226401657, 226401665, 8, 1440x900 
0x37CA2318, 38092269135321136, 226401718, 226401727, 9, 1440x900 
0x37CA2318, 38092269135998864, 226401788, 226401796, 8, 1440x900 
0x37CA2318, 38092269136655232, 226401853, 226401861, 8, 1440x900 
0x37CA2318, 38092269137316272, 226401918, 226401927, 9, 1440x900 
0x37CA2318, 38092269137967728, 226401983, 226401990, 7, 1440x900 
0x37CA2318, 38092269138637680, 226402051, 226402059, 8, 1440x900 
0x37CA2318, 38092269139296720, 226402118, 226402126, 8, 1440x900 
0x37CA2318, 38092269139960264, 226402183, 226402191, 8, 1440x900 
0x37CA2318, 38092269140621128, 226402252, 226402260, 8, 1440x900 
0x37CA2318, 38092269141281864, 226402318, 226402326, 8, 1440x900 
0x37CA2318, 38092269141937816, 226402382, 226402390, 8, 1440x900 
0x37CA2318, 38092269142598632, 226402447, 226402455, 8, 1440x900 
0x37CA2318, 38092269143260928, 226402517, 226402525, 8, 1440x900 
0x37CA2318, 38092269143914240, 226402582, 226402590, 8, 1440x900 
0x37CA2318, 38092269144585728, 226402648, 226402656, 8, 1440x900 
0x37CA2318, 38092269145254024, 226402717, 226402725, 8, 1440x900 
0x37CA2318, 38092269145912880, 226402777, 226402786, 9, 1440x900 
0x37CA2318, 38092269146564928, 226402847, 226402855, 8, 1440x900 
0x37CA2318, 38092269147235360, 226402912, 226402920, 8, 1440x900 
0x37CA2318, 38092269147890192, 226402978, 226402986, 8, 1440x900 
0x37CA2318, 38092269148555096, 226403044, 226403052, 8, 1440x900 
0x37CA2318, 38092269149215016, 226403111, 226403118, 7, 1440x900 
0x37CA2318, 38092269149875608, 226403178, 226403186, 8, 1440x900 
0x37CA2318, 38092269150536552, 226403243, 226403251, 8, 1440x900 
0x37CA2318, 38092269151197424, 226403308, 226403316, 8, 1440x900 
0x37CA2318, 38092269151858768, 226403373, 226403381, 8, 1440x900 
0x37CA2318, 38092269152519344, 226403442, 226403450, 8, 1440x900 
0x37CA2318, 38092269153171600, 226403503, 226403512, 9, 1440x900 
0x37CA2318, 38092269153848720, 226403572, 226403580, 8, 1440x900 
0x37CA2318, 38092269154499872, 226403642, 226403650, 8, 1440x900 
0x37CA2318, 38092269155168160, 226403708, 226403716, 8, 1440x900 
0x37CA2318, 38092269155820040, 226403768, 226403777, 9, 1440x900 
0x37CA2318, 38092269156479328, 226403838, 226403847, 9, 1440x900 
0x37CA2318, 38092269157140520, 226403903, 226403911, 8, 1440x900 
0x37CA2318, 38092269157809888, 226403972, 226403980, 8, 1440x900 
0x37CA2318, 38092269158471408, 226404033, 226404042, 9, 1440x900 
0x37CA2318, 38092269159122496, 226404102, 226404110, 8, 1440x900 
0x37CA2318, 38092269159784888, 226404168, 226404176, 8, 1440x900 
0x37CA2318, 38092269160447344, 226404232, 226404240, 8, 1440x900 
0x37CA2318, 38092269161116128, 226404303, 226404311, 8, 1440x900 
0x37CA2318, 38092269161767528, 226404363, 226404370, 7, 1440x900 
0x37CA2318, 38092269162429680, 226404432, 226404440, 8, 1440x900 
0x37CA2318, 38092269163097696, 226404498, 226404506, 8, 1440x900 
0x37CA2318, 38092269163751744, 226404562, 226404570, 8, 1440x900 
0x37CA2318, 38092269164420832, 226404633, 226404641, 8, 1440x900 
0x37CA2318, 38092269165073104, 226404697, 226404705, 8, 1440x900 
0x37CA2318, 38092269165733224, 226404763, 226404771, 8, 1440x900 
0x37CA2318, 38092269166399184, 226404827, 226404835, 8, 1440x900 
0x37CA2318, 38092269167061016, 226404897, 226404905, 8, 1440x900 
0x37CA2318, 38092269167712800, 226404957, 226404966, 9, 1440x900 
0x37CA2318, 38092269168392304, 226405028, 226405036, 8, 1440x900 
0x37CA2318, 38092269169052112, 226405093, 226405101, 8, 1440x900 
0x37CA2318, 38092269169719576, 226405162, 226405170, 8, 1440x900 
0x37CA2318, 38092269170374344, 226405228, 226405236, 8, 1440x900 
0x37CA2318, 38092269171027400, 226405288, 226405296, 8, 1440x900 
0x37CA2318, 38092269171700512, 226405357, 226405364, 7, 1440x900 
0x37CA2318, 38092269172365136, 226405424, 226405431, 7, 1440x900 
0x37CA2318, 38092269173015552, 226405488, 226405497, 9, 1440x900 
0x37CA2318, 38092269173677352, 226405558, 226405566, 8, 1440x900 
0x37CA2318, 38092269174331128, 226405623, 226405631, 8, 1440x900 
0x37CA2318, 38092269175001392, 226405692, 226405700, 8, 1440x900 
0x37CA2318, 38092269175662584, 226405753, 226405761, 8, 1440x900 
0x37CA2318, 38092269176319752, 226405818, 226405827, 9, 1440x900 
0x37CA2318, 38092269176988960, 226405888, 226405896, 8, 1440x900 
0x37CA2318, 38092269177658504, 226405952, 226405961, 9, 1440x900 
0x37CA2318, 38092269178311864, 226406017, 226406026, 9, 1440x900 
0x37CA2318, 38092269178964208, 226406085, 226406093, 8, 1440x900 
0x37CA2318, 38092269179635008, 226406153, 226406161, 8, 1440x900 
0x37CA2318, 38092269180286808, 226406217, 226406226, 9, 1440x900 
0x37CA2318, 38092269180947696, 226406287, 226406294, 7, 1440x900 
0x37CA2318, 38092269181621168, 226406348, 226406355, 7, 1440x900 
0x37CA2318, 38092269182272600, 226406413, 226406420, 7, 1440x900 
0x37CA2318, 38092269182951440, 226406482, 226406491, 9, 1440x900 
0x37CA2318, 38092269183602632, 226406547, 226406556, 9, 1440x900 
0x37CA2318, 38092269184263552, 226406613, 226406622, 9, 1440x900 
0x37CA2318, 38092269184924376, 226406683, 226406691, 8, 1440x900 
0x37CA2318, 38092269185586376, 226406747, 226406755, 8, 1440x900 
0x37CA2318, 38092269186245736, 226406813, 226406821, 8, 1440x900 
0x37CA2318, 38092269186909272, 226406879, 226406887, 8, 1440x900 
0x37CA2318, 38092269187579472, 226406948, 226406955, 7, 1440x900 
0x37CA2318, 38092269188230720, 226407013, 226407021, 8, 1440x900 
0x37CA2318, 38092269188891000, 226407078, 226407086, 8, 1440x900 
0x37CA2318, 38092269189552616, 226407142, 226407151, 9, 1440x900 
0x37CA2318, 38092269190212992, 226407208, 226407217, 9, 1440x900 
0x37CA2318, 38092269190875000, 226407278, 226407286, 8, 1440x900 
0x37CA2318, 38092269192187120, 226407406, 226407413, 7, 1440x900 
0x37CA2318, 38092269192849472, 226407473, 226407481, 8, 1440x900 
0x37CA2318, 38092269193511296, 226407542, 226407550, 8, 1440x900 
0x37CA2318, 38092269194172848, 226407603, 226407612, 9, 1440x900 
0x37CA2318, 38092269194832736, 226407672, 226407680, 8, 1440x900 
0x37CA2318, 38092269195492784, 226407737, 226407745, 8, 1440x900 
0x37CA2318, 38092269196153616, 226407807, 226407815, 8, 1440x900 
0x37CA2318, 38092269196819520, 226407872, 226407880, 8, 1440x900 
0x37CA2318, 38092269197471184, 226407937, 226407945, 8, 1440x900 
0x37CA2318, 38092269198143584, 226408003, 226408011, 8, 1440x900 
0x37CA2318, 38092269198813024, 226408068, 226408076, 8, 1440x900 
0x37CA2318, 38092269199462672, 226408133, 226408142, 9, 1440x900 
0x37CA2318, 38092269200122488, 226408202, 226408210, 8, 1440x900 
0x37CA2318, 38092269200793712, 226408267, 226408275, 8, 1440x900 
0x37CA2318, 38092269201456696, 226408338, 226408346, 8, 1440x900 
0x37CA2318, 38092269202119088, 226408398, 226408407, 9, 1440x900 
0x37CA2318, 38092269202778256, 226408463, 226408471, 8, 1440x900 
0x37CA2318, 38092269203431440, 226408532, 226408540, 8, 1440x900 
0x37CA2318, 38092269204108232, 226408602, 226408609, 7, 1440x900 
0x37CA2318, 38092269204771384, 226408668, 226408676, 8, 1440x900 
0x37CA2318, 38092269205431776, 226408733, 226408741, 8, 1440x900 
0x37CA2318, 38092269206083664, 226408797, 226408805, 8, 1440x900 
0x37CA2318, 38092269206744736, 226408864, 226408872, 8, 1440x900 
0x37CA2318, 38092269207408408, 226408928, 226408936, 8, 1440x900 
0x37CA2318, 38092269208072800, 226408993, 226409002, 9, 1440x900 
0x37CA2318, 38092269208739344, 226409062, 226409070, 8, 1440x900 
0x37CA2318, 38092269209403304, 226409132, 226409140, 8, 1440x900 
0x37CA2318, 38092269210061152, 226409197, 226409205, 8, 1440x900 
0x37CA2318, 38092269210726016, 226409263, 226409271, 8, 1440x900 
0x37CA2318, 38092269211388408, 226409327, 226409335, 8, 1440x900 
0x37CA2318, 38092269212048304, 226409392, 226409399, 7, 1440x900 
0x37CA2318, 38092269212702312, 226409457, 226409465, 8, 1440x900 
0x37CA2318, 38092269213371384, 226409523, 226409532, 9, 1440x900 
0x37CA2318, 38092269214031872, 226409593, 226409601, 8, 1440x900 
0x37CA2318, 38092269214693504, 226409662, 226409670, 8, 1440x900 
0x37CA2318, 38092269215352928, 226409721, 226409729, 8, 1440x900 
0x37CA2318, 38092269216016416, 226409792, 226409800, 8, 1440x900 
0x37CA2318, 38092269216683928, 226409857, 226409865, 8, 1440x900 
0x37CA2318, 38092269217353168, 226409922, 226409931, 9, 1440x900 
0x37CA2318, 38092269218005056, 226409993, 226410001, 8, 1440x900 
0x37CA2318, 38092269218665016, 226410058, 226410066, 8, 1440x900 
0x37CA2318, 38092269219327760, 226410123, 226410131, 8, 1440x900 
0x37CA2318, 38092269219980256, 226410188, 226410196, 8, 1440x900 
0x37CA2318, 38092269220649640, 226410253, 226410261, 8, 1440x900 
0x37CA2318, 38092269221299608, 226410318, 226410326, 8, 1440x900 
0x37CA2318, 38092269221962832, 226410388, 226410396, 8, 1440x900 
0x37CA2318, 38092269222641496, 226410451, 226410458, 7, 1440x900 
0x37CA2318, 38092269223292512, 226410517, 226410525, 8, 1440x900 
0x37CA2318, 38092269223952544, 226410583, 226410590, 7, 1440x900 
0x37CA2318, 38092269224614936, 226410648, 226410656, 8, 1440x900 
0x37CA2318, 38092269225267272, 226410713, 226410720, 7, 1440x900 
0x37CA2318, 38092269225928192, 226410778, 226410786, 8, 1440x900 
0x37CA2318, 38092269226589512, 226410847, 226410855, 8, 1440x900 
0x37CA2318, 38092269227260392, 226410912, 226410921, 9, 1440x900 
0x37CA2318, 38092269227930080, 226410983, 226410991, 8, 1440x900 
0x37CA2318, 38092269228588832, 226411047, 226411055, 8, 1440x900 
0x37CA2318, 38092269229241504, 226411113, 226411121, 8, 1440x900 
0x37CA2318, 38092269229903952, 226411177, 226411186, 9, 1440x900 
0x37CA2318, 38092269230555536, 226411243, 226411251, 8, 1440x900 
0x37CA2318, 38092269231227480, 226411312, 226411320, 8, 1440x900 
0x37CA2318, 38092269231882552, 226411377, 226411385, 8, 1440x900 
0x37CA2318, 38092269232551944, 226411444, 226411452, 8, 1440x900 
0x37CA2318, 38092269233213960, 226411508, 226411517, 9, 1440x900 
0x37CA2318, 38092269233871224, 226411577, 226411585, 8, 1440x900 
0x37CA2318, 38092269234533872, 226411643, 226411651, 8, 1440x900 
0x37CA2318, 38092269235202936, 226411708, 226411715, 7, 1440x900 
0x37CA2318, 38092269235856256, 226411777, 226411785, 8, 1440x900 
0x37CA2318, 38092269236507040, 226411838, 226411847, 9, 1440x900 
0x37CA2318, 38092269237168640, 226411904, 226411912, 8, 1440x900 
0x37CA2318, 38092269237843200, 226411973, 226411981, 8, 1440x900 
0x37CA2318, 38092269238503752, 226412038, 226412046, 8, 1440x900 
0x37CA2318, 38092269239162096, 226412107, 226412115, 8, 1440x900 
0x37CA2318, 38092269239830096, 226412172, 226412180, 8, 1440x900 
0x37CA2318, 38092269240481056, 226412237, 226412245, 8, 1440x900 
0x37CA2318, 38092269241143768, 226412303, 226412311, 8, 1440x900 
0x37CA2318, 38092269241806760, 226412372, 226412380, 8, 1440x900 
0x37CA2318, 38092269242476528, 226412437, 226412445, 8, 1440x900 
0x37CA2318, 38092269243127152, 226412503, 226412511, 8, 1440x900 
0x37CA2318, 38092269243789584, 226412568, 226412576, 8, 1440x900 
0x37CA2318, 38092269244458552, 226412637, 226412645, 8, 1440x900 
0x37CA2318, 38092269245120976, 226412703, 226412711, 8, 1440x900 
0x37CA2318, 38092269245780024, 226412763, 226412771, 8, 1440x900 
0x37CA2318, 38092269246440936, 226412832, 226412840, 8, 1440x900 
0x37CA2318, 38092269247102016, 226412898, 226412906, 8, 1440x900 
0x37CA2318, 38092269247767408, 226412968, 226412976, 8, 1440x900 
0x37CA2318, 38092269248426344, 226413033, 226413041, 8, 1440x900 
0x37CA2318, 38092269249077392, 226413098, 226413106, 8, 1440x900 
0x37CA2318, 38092269249748768, 226413167, 226413175, 8, 1440x900 
0x37CA2318, 38092269250400880, 226413229, 226413237, 8, 1440x900 
0x37CA2318, 38092269251070496, 226413294, 226413302, 8, 1440x900 
0x37CA2318, 38092269251726216, 226413362, 226413370, 8, 1440x900 
0x37CA2318, 38092269252383392, 226413427, 226413436, 9, 1440x900 
0x37CA2318, 38092269253044864, 226413493, 226413500, 7, 1440x900 
0x37CA2318, 38092269253698352, 226413562, 226413570, 8, 1440x900 
0x37CA2318, 38092269254368264, 226413627, 226413635, 8, 1440x900 
0x37CA2318, 38092269255028160, 226413693, 226413703, 10, 1440x900 
0x37CA2318, 38092269256166024, 226413808, 226413816, 8, 1440x900 
0x37CA2318, 38092269257019808, 226413893, 226413901, 8, 1440x900 
0x37CA2318, 38092269257679392, 226413957, 226413965, 8, 1440x900 
0x37CA2318, 38092269258332048, 226414023, 226414031, 8, 1440x900 
0x37CA2318, 38092269258990072, 226414087, 226414095, 8, 1440x900 
0x37CA2318, 38092269259654040, 226414153, 226414161, 8, 1440x900 
0x37CA2318, 38092269260305712, 226414217, 226414226, 9, 1440x900 
0x37CA2318, 38092269260969680, 226414288, 226414296, 8, 1440x900 
0x37CA2318, 38092269261630584, 226414353, 226414361, 8, 1440x900 
0x37CA2318, 38092269262294392, 226414419, 226414426, 7, 1440x900 
0x37CA2318, 38092269262960736, 226414488, 226414496, 8, 1440x900 
0x37CA2318, 38092269263622624, 226414553, 226414561, 8, 1440x900 
0x37CA2318, 38092269264266304, 226414613, 226414622, 9, 1440x900 
0x37CA2318, 38092269264944240, 226414688, 226414696, 8, 1440x900 
0x37CA2318, 38092269265604784, 226414749, 226414757, 8, 1440x900 
0x37CA2318, 38092269266266952, 226414813, 226414822, 9, 1440x900 
0x37CA2318, 38092269266926600, 226414878, 226414886, 8, 1440x900 
0x37CA2318, 38092269267583280, 226414943, 226414950, 7, 1440x900 
0x37CA2318, 38092269268248392, 226415012, 226415020, 8, 1440x900 
0x37CA2318, 38092269268909912, 226415078, 226415086, 8, 1440x900 
0x37CA2318, 38092269269572584, 226415143, 226415152, 9, 1440x900 
0x37CA2318, 38092269270222824, 226415213, 226415221, 8, 1440x900 
0x37CA2318, 38092269270882880, 226415277, 226415285, 8, 1440x900 
0x37CA2318, 38092269271544528, 226415342, 226415350, 8, 1440x900 
0x37CA2318, 38092269272220512, 226415413, 226415421, 8, 1440x900 
0x37CA2318, 38092269272874192, 226415478, 226415486, 8, 1440x900 
0x37CA2318, 38092269273531104, 226415538, 226415547, 9, 1440x900 
0x37CA2318, 38092269274195096, 226415607, 226415615, 8, 1440x900 
0x37CA2318, 38092269274848184, 226415673, 226415681, 8, 1440x900 
0x37CA2318, 38092269275521936, 226415738, 226415748, 10, 1440x900 
0x37CA2318, 38092269276174408, 226415808, 226415815, 7, 1440x900 
0x37CA2318, 38092269276837664, 226415873, 226415881, 8, 1440x900 
0x37CA2318, 38092269277498776, 226415937, 226415946, 9, 1440x900 
0x37CA2318, 38092269278150424, 226416002, 226416009, 7, 1440x900 
0x37CA2318, 38092269278819856, 226416068, 226416077, 9, 1440x900 
0x37CA2318, 38092269279483224, 226416138, 226416146, 8, 1440x900 
0x37CA2318, 38092269280133984, 226416203, 226416212, 9, 1440x900 
0x37CA2318, 38092269280797224, 226416268, 226416277, 9, 1440x900 
0x37CA2318, 38092269281467168, 226416333, 226416342, 9, 1440x900 
0x37CA2318, 38092269282136888, 226416403, 226416411, 8, 1440x900 
0x37CA2318, 38092269282788336, 226416468, 226416476, 8, 1440x900 
0x37CA2318, 38092269283449440, 226416538, 226416546, 8, 1440x900 
0x37CA2318, 38092269284111072, 226416598, 226416605, 7, 1440x900 
0x37CA2318, 38092269284774960, 226416664, 226416671, 7, 1440x900 
0x37CA2318, 38092269285433952, 226416729, 226416737, 8, 1440x900 
0x37CA2318, 38092269286089760, 226416797, 226416805, 8, 1440x900 
0x37CA2318, 38092269286763072, 226416863, 226416870, 7, 1440x900 
0x37CA2318, 38092269287414648, 226416929, 226416937, 8, 1440x900 
0x37CA2318, 38092269288076552, 226416997, 226417005, 8, 1440x900 
0x37CA2318, 38092269288737144, 226417062, 226417069, 7, 1440x900 
0x37CA2318, 38092269289401008, 226417127, 226417135, 8, 1440x900 
0x37CA2318, 38092269290067352, 226417197, 226417205, 8, 1440x900 
0x37CA2318, 38092269290710376, 226417262, 226417270, 8, 1440x900 
0x37CA2318, 38092269291377344, 226417328, 226417336, 8, 1440x900 
0x37CA2318, 38092269292038368, 226417392, 226417400, 8, 1440x900 
0x37CA2318, 38092269292700608, 226417462, 226417470, 8, 1440x900 
0x37CA2318, 38092269293360576, 226417522, 226417531, 9, 1440x900 
0x37CA2318, 38092269294021040, 226417588, 226417597, 9, 1440x900 
0x37CA2318, 38092269294680984, 226417658, 226417665, 7, 1440x900 
0x37CA2318, 38092269295348392, 226417722, 226417730, 8, 1440x900 
0x37CA2318, 38092269296009096, 226417793, 226417801, 8, 1440x900 
0x37CA2318, 38092269296671800, 226417857, 226417865, 8, 1440x900 
0x37CA2318, 38092269297331688, 226417923, 226417931, 8, 1440x900 
0x37CA2318, 38092269297986184, 226417987, 226417995, 8, 1440x900 
0x37CA2318, 38092269298657776, 226418053, 226418060, 7, 1440x900 
0x37CA2318, 38092269299319352, 226418119, 226418127, 8, 1440x900 
0x37CA2318, 38092269299988912, 226418187, 226418195, 8, 1440x900 
0x37CA2318, 38092269300641024, 226418252, 226418260, 8, 1440x900 
0x37CA2318, 38092269301293768, 226418317, 226418325, 8, 1440x900 
0x37CA2318, 38092269301972032, 226418383, 226418392, 9, 1440x900 
0x37CA2318, 38092269302617376, 226418452, 226418460, 8, 1440x900 
0x37CA2318, 38092269303288296, 226418518, 226418525, 7, 1440x900 
0x37CA2318, 38092269303956944, 226418588, 226418595, 7, 1440x900 
0x37CA2318, 38092269304617240, 226418648, 226418655, 7, 1440x900 
0x37CA2318, 38092269305276104, 226418713, 226418722, 9, 1440x900 
0x37CA2318, 38092269305936800, 226418782, 226418790, 8, 1440x900 
0x37CA2318, 38092269306597816, 226418852, 226418860, 8, 1440x900 
0x37CA2318, 38092269307259920, 226418917, 226418925, 8, 1440x900 
0x37CA2318, 38092269307920048, 226418982, 226418990, 8, 1440x900 
0x37CA2318, 38092269308580880, 226419047, 226419055, 8, 1440x900 
0x37CA2318, 38092269309250824, 226419112, 226419120, 8, 1440x900 
0x37CA2318, 38092269309903176, 226419177, 226419185, 8, 1440x900 
0x37CA2318, 38092269310560840, 226419242, 226419250, 8, 1440x900 
0x37CA2318, 38092269311215104, 226419314, 226419321, 7, 1440x900 
0x37CA2318, 38092269311882840, 226419378, 226419386, 8, 1440x900 
0x37CA2318, 38092269312544152, 226419443, 226419452, 9, 1440x900 
0x37CA2318, 38092269313198160, 226419508, 226419516, 8, 1440x900 
0x37CA2318, 38092269313862568, 226419578, 226419586, 8, 1440x900 
0x37CA2318, 38092269314525352, 226419638, 226419645, 7, 1440x900 
0x37CA2318, 38092269315188776, 226419707, 226419716, 9, 1440x900 
0x37CA2318, 38092269315852096, 226419773, 226419781, 8, 1440x900 
0x37CA2318, 38092269316512560, 226419839, 226419847, 8, 1440x900 
0x37CA2318, 38092269317174440, 226419903, 226419912, 9, 1440x900 
0x37CA2318, 38092269317844672, 226419974, 226419982, 8, 1440x900 
0x37CA2318, 38092269318496864, 226420038, 226420046, 8, 1440x900 
0x37CA2318, 38092269319158816, 226420107, 226420115, 8, 1440x900 
0x37CA2318, 38092269319818120, 226420168, 226420177, 9, 1440x900 
0x37CA2318, 38092269320487352, 226420237, 226420245, 8, 1440x900 
0x37CA2318, 38092269321148320, 226420302, 226420310, 8, 1440x900 
0x37CA2318, 38092269321818936, 226420373, 226420381, 8, 1440x900 
0x37CA2318, 38092269322470928, 226420438, 226420446, 8, 1440x900 
0x37CA2318, 38092269323130816, 226420502, 226420510, 8, 1440x900 
0x37CA2318, 38092269323799104, 226420568, 226420576, 8, 1440x900 
0x37CA2318, 38092269324451408, 226420633, 226420642, 9, 1440x900 
0x37CA2318, 38092269325110704, 226420702, 226420710, 8, 1440x900 
0x37CA2318, 38092269325773024, 226420767, 226420775, 8, 1440x900 
0x37CA2318, 38092269326432416, 226420832, 226420841, 9, 1440x900 
0x37CA2318, 38092269327101984, 226420898, 226420906, 8, 1440x900 
0x37CA2318, 38092269327753496, 226420967, 226420975, 8, 1440x900 
0x37CA2318, 38092269328423176, 226421032, 226421040, 8, 1440x900 
0x37CA2318, 38092269329082736, 226421098, 226421106, 8, 1440x900 
0x37CA2318, 38092269329745232, 226421163, 226421171, 8, 1440x900 
0x37CA2318, 38092269330391256, 226421227, 226421236, 9, 1440x900 
0x37CA2318, 38092269331069240, 226421294, 226421302, 8, 1440x900 
0x37CA2318, 38092269331718544, 226421358, 226421365, 7, 1440x900 
0x37CA2318, 38092269332379896, 226421423, 226421431, 8, 1440x900 
0x37CA2318, 38092269333040328, 226421488, 226421496, 8, 1440x900 
0x37CA2318, 38092269333697520, 226421556, 226421564, 8, 1440x900 
0x37CA2318, 38092269334376832, 226421622, 226421630, 8, 1440x900 
0x37CA2318, 38092269335037104, 226421692, 226421699, 7, 1440x900 
0x37CA2318, 38092269335689800, 226421757, 226421765, 8, 1440x900 
0x37CA2318, 38092269337012328, 226421892, 226421900, 8, 1440x900 
0x37CA2318, 38092269337671520, 226421958, 226421966, 8, 1440x900 
0x37CA2318, 38092269338334624, 226422023, 226422030, 7, 1440x900 
0x37CA2318, 38092269338993560, 226422088, 226422096, 8, 1440x900 
0x37CA2318, 38092269339659920, 226422158, 226422166, 8, 1440x900 
0x37CA2318, 38092269340320632, 226422223, 226422231, 8, 1440x900 
0x37CA2318, 38092269340981408, 226422288, 226422296, 8, 1440x900 
0x37CA2318, 38092269341642272, 226422352, 226422361, 9, 1440x900 
0x37CA2318, 38092269342300976, 226422416, 226422424, 8, 1440x900 
0x37CA2318, 38092269342965008, 226422488, 226422495, 7, 1440x900 
0x37CA2318, 38092269343633656, 226422552, 226422560, 8, 1440x900 
0x37CA2318, 38092269344285824, 226422618, 226422625, 7, 1440x900 
0x37CA2318, 38092269344946640, 226422682, 226422690, 8, 1440x900 
0x37CA2318, 38092269345601376, 226422749, 226422756, 7, 1440x900 
0x37CA2318, 38092269346267968, 226422817, 226422825, 8, 1440x900 
0x37CA2318, 38092269346928208, 226422883, 226422891, 8, 1440x900 
0x37CA2318, 38092269347587840, 226422947, 226422955, 8, 1440x900 
0x37CA2318, 38092269348248944, 226423017, 226423024, 7, 1440x900 
0x37CA2318, 38092269348918768, 226423083, 226423091, 8, 1440x900 
0x37CA2318, 38092269349577672, 226423148, 226423156, 8, 1440x900 
0x37CA2318, 38092269350229144, 226423212, 226423220, 8, 1440x900 
0x37CA2318, 38092269350888488, 226423277, 226423285, 8, 1440x900 
0x37CA2318, 38092269351550824, 226423342, 226423350, 8, 1440x900 
0x37CA2318, 38092269352207752, 226423408, 226423416, 8, 1440x900 
0x37CA2318, 38092269352878672, 226423477, 226423485, 8, 1440x900 
0x37CA2318, 38092269353532304, 226423543, 226423551, 8, 1440x900 
0x37CA2318, 38092269354189144, 226423607, 226423615, 8, 1440x900 
0x37CA2318, 38092269354853720, 226423673, 226423682, 9, 1440x900 
0x37CA2318, 38092269355519208, 226423737, 226423745, 8, 1440x900 
0x37CA2318, 38092269356172200, 226423804, 226423812, 8, 1440x900 
0x37CA2318, 38092269356834272, 226423873, 226423881, 8, 1440x900 
0x37CA2318, 38092269357494272, 226423938, 226423945, 7, 1440x900 
0x37CA2318, 38092269358149576, 226424003, 226424011, 8, 1440x900 
0x37CA2318, 38092269358818744, 226424073, 226424081, 8, 1440x900 
0x37CA2318, 38092269359486504, 226424137, 226424145, 8, 1440x900 
0x37CA2318, 38092269360148840, 226424203, 226424211, 8, 1440x900 
0x37CA2318, 38092269360799992, 226424268, 226424276, 8, 1440x900 
0x37CA2318, 38092269361461632, 226424337, 226424345, 8, 1440x900 
0x37CA2318, 38092269362118864, 226424402, 226424410, 8, 1440x900 
0x37CA2318, 38092269362779536, 226424467, 226424475, 8, 1440x900 
0x37CA2318, 38092269363442648, 226424533, 226424541, 8, 1440x900 
0x37CA2318, 38092269364094128, 226424598, 226424606, 8, 1440x900 
0x37CA2318, 38092269364763448, 226424663, 226424672, 9, 1440x900 
0x37CA2318, 38092269365420208, 226424728, 226424737, 9, 1440x900 
0x37CA2318, 38092269366095456, 226424802, 226424810, 8, 1440x900 
0x37CA2318, 38092269366758056, 226424868, 226424876, 8, 1440x900 
0x37CA2318, 38092269367409504, 226424928, 226424936, 8, 1440x900 
0x37CA2318, 38092269368070976, 226424998, 226425006, 8, 1440x900 
0x37CA2318, 38092269368725752, 226425063, 226425071, 8, 1440x900 
0x37CA2318, 38092269369396352, 226425132, 226425140, 8, 1440x900 
0x37CA2318, 38092269370047208, 226425192, 226425200, 8, 1440x900 
0x37CA2318, 38092269370708608, 226425262, 226425270, 8, 1440x900 
0x37CA2318, 38092269371378512, 226425327, 226425335, 8, 1440x900 
0x37CA2318, 38092269372047352, 226425392, 226425399, 7, 1440x900 
0x37CA2318, 38092269372701184, 226425457, 226425464, 7, 1440x900 
0x37CA2318, 38092269373365160, 226425528, 226425536, 8, 1440x900 
0x37CA2318, 38092269374034432, 226425594, 226425602, 8, 1440x900 
0x37CA2318, 38092269374695496, 226425656, 226425663, 7, 1440x900 
0x37CA2318, 38092269375347216, 226425723, 226425730, 7, 1440x900 
0x37CA2318, 38092269376008160, 226425788, 226425796, 8, 1440x900 
0x37CA2318, 38092269376668672, 226425857, 226425865, 8, 1440x900 
0x37CA2318, 38092269377338032, 226425923, 226425931, 8, 1440x900 
0x37CA2318, 38092269377987640, 226425987, 226425995, 8, 1440x900 
0x37CA2318, 38092269378649072, 226426057, 226426065, 8, 1440x900 
0x37CA2318, 38092269379319056, 226426123, 226426131, 8, 1440x900 
0x37CA2318, 38092269379971680, 226426184, 226426192, 8, 1440x900 
0x37CA2318, 38092269380634448, 226426253, 226426261, 8, 1440x900 
0x37CA2318, 38092269381285392, 226426318, 226426326, 8, 1440x900 
0x37CA2318, 38092269381955808, 226426387, 226426395, 8, 1440x900 
0x37CA2318, 38092269382608568, 226426448, 226426456, 8, 1440x900 
0x37CA2318, 38092269383286328, 226426518, 226426525, 7, 1440x900 
0x37CA2318, 38092269383940480, 226426587, 226426595, 8, 1440x900 
0x37CA2318, 38092269384599744, 226426647, 226426655, 8, 1440x900 
0x37CA2318, 38092269385265304, 226426715, 226426724, 9, 1440x900 
0x37CA2318, 38092269385915488, 226426777, 226426784, 7, 1440x900 
0x37CA2318, 38092269386585072, 226426847, 226426855, 8, 1440x900 
0x37CA2318, 38092269387247448, 226426917, 226426925, 8, 1440x900 
0x37CA2318, 38092269387903104, 226426978, 226426986, 8, 1440x900 
0x37CA2318, 38092269388567208, 226427048, 226427056, 8, 1440x900 
0x37CA2318, 38092269389228816, 226427113, 226427121, 8, 1440x900 
0x37CA2318, 38092269389890944, 226427177, 226427185, 8, 1440x900 
0x37CA2318, 38092269390546904, 226427242, 226427250, 8, 1440x900 
0x37CA2318, 38092269391219192, 226427312, 226427320, 8, 1440x900 
0x37CA2318, 38092269391879560, 226427378, 226427386, 8, 1440x900 
0x37CA2318, 38092269392549760, 226427443, 226427451, 8, 1440x900 
0x37CA2318, 38092269393208792, 226427508, 226427516, 8, 1440x900 
0x37CA2318, 38092269393860016, 226427573, 226427581, 8, 1440x900 
0x37CA2318, 38092269394522768, 226427643, 226427651, 8, 1440x900 
0x37CA2318, 38092269395176016, 226427707, 226427715, 8, 1440x900 
0x37CA2318, 38092269395836968, 226427776, 226427783, 7, 1440x900 
0x37CA2318, 38092269396510536, 226427838, 226427847, 9, 1440x900 
0x37CA2318, 38092269397171240, 226427908, 226427916, 8, 1440x900 
0x37CA2318, 38092269397823104, 226427972, 226427980, 8, 1440x900 
0x37CA2318, 38092269398486112, 226428037, 226428045, 8, 1440x900 
0x37CA2318, 38092269399145224, 226428103, 226428111, 8, 1440x900 
0x37CA2318, 38092269399807168, 226428167, 226428176, 9, 1440x900 
0x37CA2318, 38092269400469968, 226428238, 226428246, 8, 1440x900 
0x37CA2318, 38092269401121632, 226428302, 226428310, 8, 1440x900 
0x37CA2318, 38092269401785184, 226428368, 226428376, 8, 1440x900 
0x37CA2318, 38092269402439064, 226428432, 226428440, 8, 1440x900 
0x37CA2318, 38092269403110928, 226428497, 226428504, 7, 1440x900 
0x37CA2318, 38092269403763920, 226428562, 226428570, 8, 1440x900 
0x37CA2318, 38092269404433824, 226428628, 226428637, 9, 1440x900 
0x37CA2318, 38092269405094424, 226428697, 226428704, 7, 1440x900 
0x37CA2318, 38092269405756152, 226428763, 226428770, 7, 1440x900 
0x37CA2318, 38092269406409688, 226428827, 226428835, 8, 1440x900 
0x37CA2318, 38092269407088392, 226428899, 226428908, 9, 1440x900 
0x37CA2318, 38092269407758088, 226428962, 226428968, 6, 1440x900 
0x37CA2318, 38092269408408232, 226429032, 226429040, 8, 1440x900 
0x37CA2318, 38092269409080536, 226429098, 226429106, 8, 1440x900 
0x37CA2318, 38092269409731064, 226429163, 226429171, 8, 1440x900 
0x37CA2318, 38092269410393592, 226429228, 226429236, 8, 1440x900 
0x37CA2318, 38092269411046424, 226429297, 226429304, 7, 1440x900 
0x37CA2318, 38092269411724000, 226429358, 226429367, 9, 1440x900 
0x37CA2318, 38092269412384024, 226429429, 226429437, 8, 1440x900 
0x37CA2318, 38092269413036648, 226429492, 226429500, 8, 1440x900 
0x37CA2318, 38092269413699312, 226429557, 226429566, 9, 1440x900 
0x37CA2318, 38092269415021808, 226429692, 226429700, 8, 1440x900 
0x37CA2318, 38092269415674856, 226429757, 226429766, 9, 1440x900 
0x37CA2318, 38092269416345328, 226429821, 226429828, 7, 1440x900 
0x37CA2318, 38092269417000768, 226429887, 226429896, 9, 1440x900 
0x37CA2318, 38092269417662304, 226429958, 226429966, 8, 1440x900 
0x37CA2318, 38092269418333128, 226430023, 226430031, 8, 1440x900 
0x37CA2318, 38092269418984104, 226430089, 226430097, 8, 1440x900 
0x37CA2318, 38092269419646208, 226430153, 226430161, 8, 1440x900 
0x37CA2318, 38092269420302664, 226430218, 226430227, 9, 1440x900 
0x37CA2318, 38092269420973128, 226430287, 226430295, 8, 1440x900 
0x37CA2318, 38092269421628096, 226430353, 226430361, 8, 1440x900 
0x37CA2318, 38092269422289392, 226430418, 226430426, 8, 1440x900 
0x37CA2318, 38092269422949088, 226430482, 226430490, 8, 1440x900 
0x37CA2318, 38092269423611424, 226430548, 226430557, 9, 1440x900 
0x37CA2318, 38092269424278080, 226430617, 226430627, 10, 1440x900 
0x37CA2318, 38092269424947224, 226430682, 226430690, 8, 1440x900 
0x37CA2318, 38092269425602304, 226430748, 226430756, 8, 1440x900 
0x37CA2318, 38092269426269856, 226430818, 226430826, 8, 1440x900 
0x37CA2318, 38092269426938376, 226430881, 226430888, 7, 1440x900 
0x37CA2318, 38092269427590192, 226430948, 226430956, 8, 1440x900 
0x37CA2318, 38092269428250320, 226431013, 226431021, 8, 1440x900 
0x37CA2318, 38092269428913408, 226431083, 226431091, 8, 1440x900 
0x37CA2318, 38092269429575040, 226431143, 226431152, 9, 1440x900 
0x37CA2318, 38092269430242728, 226431213, 226431221, 8, 1440x900 
0x37CA2318, 38092269430893176, 226431278, 226431286, 8, 1440x900 
0x37CA2318, 38092269431554784, 226431343, 226431351, 8, 1440x900 
0x37CA2318, 38092269432216824, 226431412, 226431420, 8, 1440x900 
0x37CA2318, 38092269432885096, 226431477, 226431485, 8, 1440x900 
0x37CA2318, 38092269433545144, 226431543, 226431551, 8, 1440x900 
0x37CA2318, 38092269434206128, 226431608, 226431617, 9, 1440x900 
0x37CA2318, 38092269434857104, 226431672, 226431681, 9, 1440x900 
0x37CA2318, 38092269435517072, 226431743, 226431751, 8, 1440x900 
0x37CA2318, 38092269436180232, 226431808, 226431820, 12, 1440x900 
0x37CA2318, 38092269436840416, 226431872, 226431880, 8, 1440x900 
0x37CA2318, 38092269437499928, 226431942, 226431950, 8, 1440x900 
0x37CA2318, 38092269438163072, 226432003, 226432011, 8, 1440x900 
0x37CA2318, 38092269438817160, 226432072, 226432080, 8, 1440x900 
0x37CA2318, 38092269439494320, 226432138, 226432147, 9, 1440x900 
0x37CA2318, 38092269440155616, 226432202, 226432209, 7, 1440x900 
0x37CA2318, 38092269440816624, 226432267, 226432275, 8, 1440x900 
0x37CA2318, 38092269441471440, 226432332, 226432340, 8, 1440x900 
0x37CA2318, 38092269442151984, 226432407, 226432415, 8, 1440x900 
0x37CA2318, 38092269442806016, 226432472, 226432480, 8, 1440x900 
0x37CA2318, 38092269443463392, 226432537, 226432545, 8, 1440x900 
0x37CA2318, 38092269444124296, 226432603, 226432611, 8, 1440x900 
0x37CA2318, 38092269444784000, 226432669, 226432677, 8, 1440x900 
0x37CA2318, 38092269445445272, 226432733, 226432741, 8, 1440x900 
0x37CA2318, 38092269446103768, 226432797, 226432806, 9, 1440x900 
0x37CA2318, 38092269446759136, 226432868, 226432876, 8, 1440x900 
0x37CA2318, 38092269447430216, 226432932, 226432940, 8, 1440x900 
0x37CA2318, 38092269448082776, 226432997, 226433005, 8, 1440x900 
0x37CA2318, 38092269448751688, 226433061, 226433068, 7, 1440x900 
0x37CA2318, 38092269449415448, 226433128, 226433135, 7, 1440x900 
0x37CA2318, 38092269450084048, 226433197, 226433204, 7, 1440x900 
0x37CA2318, 38092269450737536, 226433262, 226433269, 7, 1440x900 
0x37CA2318, 38092269451391584, 226433328, 226433335, 7, 1440x900 
0x37CA2318, 38092269452071888, 226433398, 226433406, 8, 1440x900 
0x37CA2318, 38092269452732520, 226433462, 226433470, 8, 1440x900 
0x37CA2318, 38092269453383968, 226433527, 226433535, 8, 1440x900 
0x37CA2318, 38092269454054552, 226433592, 226433601, 9, 1440x900 
0x37CA2318, 38092269454713624, 226433658, 226433667, 9, 1440x900 
0x37CA2318, 38092269455366168, 226433728, 226433736, 8, 1440x900 
0x37CA2318, 38092269456026568, 226433793, 226433801, 8, 1440x900 
0x37CA2318, 38092269456678968, 226433853, 226433861, 8, 1440x900 
0x37CA2318, 38092269457349256, 226433921, 226433929, 8, 1440x900 
0x37CA2318, 38092269458017568, 226433988, 226433995, 7, 1440x900 
0x37CA2318, 38092269458674200, 226434054, 226434061, 7, 1440x900 
0x37CA2318, 38092269459337216, 226434123, 226434131, 8, 1440x900 
0x37CA2318, 38092269459999240, 226434187, 226434195, 8, 1440x900 
0x37CA2318, 38092269460651472, 226434253, 226434261, 8, 1440x900 
0x37CA2318, 38092269461310072, 226434317, 226434324, 7, 1440x900 
0x37CA2318, 38092269461979288, 226434383, 226434390, 7, 1440x900 
0x37CA2318, 38092269462634088, 226434448, 226434456, 8, 1440x900 
0x37CA2318, 38092269463294992, 226434518, 226434526, 8, 1440x900 
0x37CA2318, 38092269463955992, 226434587, 226434595, 8, 1440x900 
0x37CA2318, 38092269464607776, 226434648, 226434657, 9, 1440x900 
0x37CA2318, 38092269465270880, 226434717, 226434725, 8, 1440x900 
0x37CA2318, 38092269465942544, 226434782, 226434791, 9, 1440x900 
0x37CA2318, 38092269466603632, 226434848, 226434856, 8, 1440x900 
0x37CA2318, 38092269467272272, 226434918, 226434926, 8, 1440x900 
0x37CA2318, 38092269467927248, 226434983, 226434991, 8, 1440x900 
0x37CA2318, 38092269468584504, 226435047, 226435056, 9, 1440x900 
0x37CA2318, 38092269469251128, 226435113, 226435121, 8, 1440x900 
0x37CA2318, 38092269469913480, 226435178, 226435186, 8, 1440x900 
0x37CA2318, 38092269470571352, 226435243, 226435252, 9, 1440x900 
0x37CA2318, 38092269471233048, 226435313, 226435322, 9, 1440x900 
0x37CA2318, 38092269471889400, 226435378, 226435386, 8, 1440x900 
0x37CA2318, 38092269472549440, 226435443, 226435451, 8, 1440x900 
0x37CA2318, 38092269473207904, 226435507, 226435514, 7, 1440x900 
0x37CA2318, 38092269473875984, 226435577, 226435586, 9, 1440x900 
0x37CA2318, 38092269474526560, 226435641, 226435649, 8, 1440x900 
0x37CA2318, 38092269475187256, 226435706, 226435714, 8, 1440x900 
0x37CA2318, 38092269475854816, 226435772, 226435780, 8, 1440x900 
0x37CA2318, 38092269476507168, 226435838, 226435845, 7, 1440x900 
0x37CA2318, 38092269477166280, 226435903, 226435911, 8, 1440x900 
0x37CA2318, 38092269477828896, 226435973, 226435981, 8, 1440x900 
0x37CA2318, 38092269478493424, 226436037, 226436045, 8, 1440x900 
0x37CA2318, 38092269479151576, 226436107, 226436115, 8, 1440x900 
0x37CA2318, 38092269479802536, 226436167, 226436175, 8, 1440x900 
0x37CA2318, 38092269480472616, 226436238, 226436246, 8, 1440x900 
0x37CA2318, 38092269481124816, 226436302, 226436309, 7, 1440x900 
0x37CA2318, 38092269481788640, 226436368, 226436376, 8, 1440x900 
0x37CA2318, 38092269482449720, 226436433, 226436441, 8, 1440x900 
0x37CA2318, 38092269483111008, 226436503, 226436511, 8, 1440x900 
0x37CA2318, 38092269483763432, 226436568, 226436575, 7, 1440x900 
0x37CA2318, 38092269484435128, 226436634, 226436642, 8, 1440x900 
0x37CA2318, 38092269485086200, 226436697, 226436705, 8, 1440x900 
0x37CA2318, 38092269485763864, 226436767, 226436776, 9, 1440x900 
0x37CA2318, 38092269486415520, 226436828, 226436837, 9, 1440x900 
0x37CA2318, 38092269487069424, 226436897, 226436905, 8, 1440x900 
0x37CA2318, 38092269487748520, 226436963, 226436971, 8, 1440x900 
0x37CA2318, 38092269488410800, 226437032, 226437040, 8, 1440x900 
0x37CA2318, 38092269489067640, 226437098, 226437106, 8, 1440x900 
0x37CA2318, 38092269489725816, 226437162, 226437170, 8, 1440x900 
0x37CA2318, 38092269490378400, 226437227, 226437235, 8, 1440x900 
0x37CA2318, 38092269491039736, 226437292, 226437300, 8, 1440x900 
0x37CA2318, 38092269491719464, 226437363, 226437371, 8, 1440x900 
0x37CA2318, 38092269492370448, 226437428, 226437436, 8, 1440x900 
0x37CA2318, 38092269493033680, 226437492, 226437500, 8, 1440x900 
0x37CA2318, 38092269494349056, 226437623, 226437631, 8, 1440x900 
0x37CA2318, 38092269495018360, 226437692, 226437700, 8, 1440x900 
0x37CA2318, 38092269495678864, 226437757, 226437765, 8, 1440x900 
0x37CA2318, 38092269496338840, 226437823, 226437831, 8, 1440x900 
0x37CA2318, 38092269497000952, 226437887, 226437896, 9, 1440x900 
0x37CA2318, 38092269497664112, 226437953, 226437961, 8, 1440x900 
0x37CA2318, 38092269498333592, 226438022, 226438030, 8, 1440x900 
0x37CA2318, 38092269498987056, 226438087, 226438095, 8, 1440x900 
0x37CA2318, 38092269499648800, 226438157, 226438165, 8, 1440x900 
0x37CA2318, 38092269500301416, 226438217, 226438225, 8, 1440x900 
0x37CA2318, 38092269500971440, 226438288, 226438296, 8, 1440x900 
0x37CA2318, 38092269501622032, 226438352, 226438360, 8, 1440x900 
0x37CA2318, 38092269502293872, 226438417, 226438425, 8, 1440x900 
0x37CA2318, 38092269502953520, 226438482, 226438490, 8, 1440x900 
0x37CA2318, 38092269503620840, 226438553, 226438561, 8, 1440x900 
0x37CA2318, 38092269504281936, 226438618, 226438626, 8, 1440x900 
0x37CA2318, 38092269504932784, 226438678, 226438686, 8, 1440x900 
0x37CA2318, 38092269505593984, 226438744, 226438752, 8, 1440x900 
0x37CA2318, 38092269506245224, 226438813, 226438821, 8, 1440x900 
0x37CA2318, 38092269506916688, 226438877, 226438884, 7, 1440x900 
0x37CA2318, 38092269507574224, 226438948, 226438956, 8, 1440x900 
0x37CA2318, 38092269508244896, 226439018, 226439026, 8, 1440x900 
0x37CA2318, 38092269508899112, 226439083, 226439091, 8, 1440x900 
0x37CA2318, 38092269509554504, 226439142, 226439151, 9, 1440x900 
0x37CA2318, 38092269510226608, 226439213, 226439220, 7, 1440x900 
0x37CA2318, 38092269510887648, 226439277, 226439285, 8, 1440x900 
0x37CA2318, 38092269511548960, 226439342, 226439350, 8, 1440x900 
0x37CA2318, 38092269512202032, 226439407, 226439416, 9, 1440x900 
0x37CA2318, 38092269512871600, 226439477, 226439485, 8, 1440x900 
0x37CA2318, 38092269513534400, 226439544, 226439551, 7, 1440x900 
0x37CA2318, 38092269514194216, 226439609, 226439616, 7, 1440x900 
0x37CA2318, 38092269514854696, 226439677, 226439684, 7, 1440x900 
0x37CA2318, 38092269515514688, 226439738, 226439745, 7, 1440x900 
0x37CA2318, 38092269516169352, 226439807, 226439815, 8, 1440x900 
0x37CA2318, 38092269516841464, 226439872, 226439880, 8, 1440x900 
0x37CA2318, 38092269517491696, 226439937, 226439945, 8, 1440x900 
0x37CA2318, 38092269518171224, 226440008, 226440016, 8, 1440x900 
0x37CA2318, 38092269518821840, 226440068, 226440075, 7, 1440x900 
0x37CA2318, 38092269519493704, 226440137, 226440145, 8, 1440x900 
0x37CA2318, 38092269520156016, 226440207, 226440215, 8, 1440x900 
0x37CA2318, 38092269520824960, 226440273, 226440281, 8, 1440x900 
0x37CA2318, 38092269521477416, 226440338, 226440346, 8, 1440x900 
0x37CA2318, 38092269522138448, 226440403, 226440411, 8, 1440x900 
0x37CA2318, 38092269522803680, 226440472, 226440480, 8, 1440x900 
0x37CA2318, 38092269523463504, 226440534, 226440542, 8, 1440x900 
0x37CA2318, 38092269524127592, 226440603, 226440611, 8, 1440x900 
0x37CA2318, 38092269524782520, 226440668, 226440676, 8, 1440x900 
0x37CA2318, 38092269525442024, 226440732, 226440740, 8, 1440x900 
0x37CA2318, 38092269526104168, 226440798, 226440805, 7, 1440x900 
0x37CA2318, 38092269526761664, 226440862, 226440869, 7, 1440x900 
0x37CA2318, 38092269527433672, 226440928, 226440936, 8, 1440x900 
0x37CA2318, 38092269528084568, 226440993, 226441001, 8, 1440x900 
0x37CA2318, 38092269528747800, 226441068, 226441076, 8, 1440x900 
0x37CA2318, 38092269529400032, 226441127, 226441135, 8, 1440x900 
0x37CA2318, 38092269530070464, 226441198, 226441206, 8, 1440x900 
0x37CA2318, 38092269530724728, 226441264, 226441271, 7, 1440x900 
0x37CA2318, 38092269531391872, 226441327, 226441335, 8, 1440x900 
0x37CA2318, 38092269532054768, 226441398, 226441406, 8, 1440x900 
0x37CA2318, 38092269532724128, 226441459, 226441467, 8, 1440x900 
0x37CA2318, 38092269533392032, 226441528, 226441534, 6, 1440x900 
0x37CA2318, 38092269534043000, 226441588, 226441596, 8, 1440x900 
0x37CA2318, 38092269534712792, 226441657, 226441664, 7, 1440x900 
0x37CA2318, 38092269535366624, 226441722, 226441730, 8, 1440x900 
0x37CA2318, 38092269536033328, 226441788, 226441796, 8, 1440x900 
0x37CA2318, 38092269536691632, 226441858, 226441865, 7, 1440x900 
0x37CA2318, 38092269537352864, 226441922, 226441929, 7, 1440x900 
0x37CA2318, 38092269538006000, 226441987, 226441995, 8, 1440x900 
0x37CA2318, 38092269538668728, 226442053, 226442061, 8, 1440x900 
0x37CA2318, 38092269539320080, 226442122, 226442129, 7, 1440x900 
0x37CA2318, 38092269539983272, 226442188, 226442196, 8, 1440x900 
0x37CA2318, 38092269540660232, 226442257, 226442265, 8, 1440x900 
0x37CA2318, 38092269541319496, 226442322, 226442329, 7, 1440x900 
0x37CA2318, 38092269541777248, 226442363, 226442371, 8, 1440x900 
0x37CA2318, 38092269542436680, 226442432, 226442439, 7, 1440x900 
0x37CA2318, 38092269543291240, 226442513, 226442521, 8, 1440x900 
0x37CA2318, 38092269543944616, 226442578, 226442586, 8, 1440x900 
0x37CA2318, 38092269544607112, 226442646, 226442653, 7, 1440x900 
0x37CA2318, 38092269545269872, 226442712, 226442719, 7, 1440x900 
0x37CA2318, 38092269545934248, 226442779, 226442786, 7, 1440x900 
0x37CA2318, 38092269546593896, 226442847, 226442855, 8, 1440x900 
0x37CA2318, 38092269547244168, 226442909, 226442916, 7, 1440x900 
0x37CA2318, 38092269547914368, 226442978, 226442985, 7, 1440x900 
0x37CA2318, 38092269548575256, 226443047, 226443054, 7, 1440x900 
0x37CA2318, 38092269549240752, 226443113, 226443121, 8, 1440x900 
0x37CA2318, 38092269549897680, 226443177, 226443186, 9, 1440x900 
0x37CA2318, 38092269550552528, 226443247, 226443255, 8, 1440x900 
0x37CA2318, 38092269551219376, 226443309, 226443317, 8, 1440x900 
0x37CA2318, 38092269551869672, 226443378, 226443386, 8, 1440x900 
0x37CA2318, 38092269552541288, 226443443, 226443451, 8, 1440x900 
0x37CA2318, 38092269553201616, 226443507, 226443516, 9, 1440x900 
0x37CA2318, 38092269553864096, 226443574, 226443580, 6, 1440x900 
0x37CA2318, 38092269554523696, 226443642, 226443650, 8, 1440x900 
0x37CA2318, 38092269555229568, 226443708, 226443716, 8, 1440x900 
0x37CA2318, 38092269555691560, 226443757, 226443764, 7, 1440x900 
0x37CA2318, 38092269556542496, 226443843, 226443852, 9, 1440x900 
0x37CA2318, 38092269557202344, 226443911, 226443919, 8, 1440x900 
0x37CA2318, 38092269557865568, 226443978, 226443986, 8, 1440x900 
0x37CA2318, 38092269558523968, 226444043, 226444051, 8, 1440x900 
0x37CA2318, 38092269559183568, 226444107, 226444115, 8, 1440x900 
0x37CA2318, 38092269559845752, 226444172, 226444179, 7, 1440x900 
0x37CA2318, 38092269560514368, 226444238, 226444245, 7, 1440x900 
0x37CA2318, 38092269561174496, 226444309, 226444317, 8, 1440x900 
0x37CA2318, 38092269561826952, 226444373, 226444381, 8, 1440x900 
0x37CA2318, 38092269562479192, 226444437, 226444445, 8, 1440x900 
0x37CA2318, 38092269563143440, 226444502, 226444510, 8, 1440x900 
0x37CA2318, 38092269563803552, 226444567, 226444575, 8, 1440x900 
0x37CA2318, 38092269564474744, 226444634, 226444642, 8, 1440x900 
0x37CA2318, 38092269565126496, 226444702, 226444710, 8, 1440x900 
0x37CA2318, 38092269565779272, 226444768, 226444776, 8, 1440x900 
0x37CA2318, 38092269566452176, 226444833, 226444841, 8, 1440x900 
0x37CA2318, 38092269567114928, 226444899, 226444907, 8, 1440x900 
0x37CA2318, 38092269567776008, 226444967, 226444975, 8, 1440x900 
0x37CA2318, 38092269568427536, 226445033, 226445041, 8, 1440x900 
0x37CA2318, 38092269569097896, 226445097, 226445105, 8, 1440x900 
0x37CA2318, 38092269569759112, 226445168, 226445177, 9, 1440x900 
0x37CA2318, 38092269570429600, 226445233, 226445241, 8, 1440x900 
0x37CA2318, 38092269571089120, 226445298, 226445306, 8, 1440x900 
0x37CA2318, 38092269571742368, 226445363, 226445371, 8, 1440x900 
0x37CA2318, 38092269572397264, 226445427, 226445436, 9, 1440x900 
0x37CA2318, 38092269573061112, 226445493, 226445501, 8, 1440x900 
0x37CA2318, 38092269573727560, 226445562, 226445570, 8, 1440x900 
0x37CA2318, 38092269574380800, 226445628, 226445636, 8, 1440x900 
0x37CA2318, 38092269575038672, 226445692, 226445700, 8, 1440x900 
0x37CA2318, 38092269575700696, 226445758, 226445767, 9, 1440x900 
0x37CA2318, 38092269576361432, 226445828, 226445836, 8, 1440x900 
0x37CA2318, 38092269577022016, 226445893, 226445901, 8, 1440x900 
0x37CA2318, 38092269578338832, 226446023, 226446031, 8, 1440x900 
0x37CA2318, 38092269579017304, 226446087, 226446095, 8, 1440x900 
0x37CA2318, 38092269579669472, 226446158, 226446167, 9, 1440x900 
0x37CA2318, 38092269580331832, 226446222, 226446230, 8, 1440x900 
0x37CA2318, 38092269580994968, 226446289, 226446297, 8, 1440x900 
0x37CA2318, 38092269581654032, 226446352, 226446360, 8, 1440x900 
0x37CA2318, 38092269582323768, 226446423, 226446431, 8, 1440x900 
0x37CA2318, 38092269582974728, 226446488, 226446496, 8, 1440x900 
0x37CA2318, 38092269583626808, 226446553, 226446561, 8, 1440x900 
0x37CA2318, 38092269584287848, 226446617, 226446625, 8, 1440x900 
0x37CA2318, 38092269584956384, 226446687, 226446695, 8, 1440x900 
0x37CA2318, 38092269585617256, 226446748, 226446757, 9, 1440x900 
0x37CA2318, 38092269586279160, 226446818, 226446826, 8, 1440x900 
0x37CA2318, 38092269586945376, 226446883, 226446891, 8, 1440x900 
0x37CA2318, 38092269587606104, 226446947, 226446956, 9, 1440x900 
0x37CA2318, 38092269588255816, 226447014, 226447022, 8, 1440x900 
0x37CA2318, 38092269588925736, 226447082, 226447090, 8, 1440x900 
0x37CA2318, 38092269589585824, 226447147, 226447155, 8, 1440x900 
0x37CA2318, 38092269590234480, 226447213, 226447220, 7, 1440x900 
0x37CA2318, 38092269590905656, 226447282, 226447290, 8, 1440x900 
0x37CA2318, 38092269591567832, 226447347, 226447355, 8, 1440x900 
0x37CA2318, 38092269592229400, 226447413, 226447420, 7, 1440x900 
0x37CA2318, 38092269592880936, 226447477, 226447486, 9, 1440x900 
0x37CA2318, 38092269593550344, 226447542, 226447550, 8, 1440x900 
0x37CA2318, 38092269594220128, 226447608, 226447615, 7, 1440x900 
0x37CA2318, 38092269594873496, 226447673, 226447681, 8, 1440x900 
0x37CA2318, 38092269595540280, 226447741, 226447749, 8, 1440x900 
0x37CA2318, 38092269596202480, 226447808, 226447816, 8, 1440x900 
0x37CA2318, 38092269596854688, 226447873, 226447882, 9, 1440x900 
0x37CA2318, 38092269597518128, 226447942, 226447950, 8, 1440x900 
0x37CA2318, 38092269598169976, 226448003, 226448012, 9, 1440x900 
0x37CA2318, 38092269598837680, 226448073, 226448081, 8, 1440x900 
0x37CA2318, 38092269599502152, 226448138, 226448146, 8, 1440x900 
0x37CA2318, 38092269600165896, 226448205, 226448214, 9, 1440x900 
0x37CA2318, 38092269600830920, 226448267, 226448275, 8, 1440x900 
0x37CA2318, 38092269601530808, 226448338, 226448345, 7, 1440x900 
0x37CA2318, 38092269602200336, 226448407, 226448414, 7, 1440x900 
0x37CA2318, 38092269602850688, 226448472, 226448479, 7, 1440x900 
0x37CA2318, 38092269603512304, 226448541, 226448549, 8, 1440x900 
0x37CA2318, 38092269604172400, 226448603, 226448610, 7, 1440x900 
0x37CA2318, 38092269604825936, 226448668, 226448676, 8, 1440x900 
0x37CA2318, 38092269605495568, 226448737, 226448745, 8, 1440x900 
0x37CA2318, 38092269606155848, 226448802, 226448810, 8, 1440x900 
0x37CA2318, 38092269606825160, 226448868, 226448876, 8, 1440x900 
0x37CA2318, 38092269607483768, 226448934, 226448942, 8, 1440x900 
0x37CA2318, 38092269608144128, 226448999, 226449007, 8, 1440x900 
0x37CA2318, 38092269608813664, 226449066, 226449074, 8, 1440x900 
0x37CA2318, 38092269609483344, 226449135, 226449143, 8, 1440x900 
0x37CA2318, 38092269610142896, 226449198, 226449206, 8, 1440x900 
0x37CA2318, 38092269610812480, 226449264, 226449272, 8, 1440x900 
0x37CA2318, 38092269611472376, 226449332, 226449340, 8, 1440x900 
0x37CA2318, 38092269612122296, 226449397, 226449404, 7, 1440x900 
0x37CA2318, 38092269612801888, 226449467, 226449474, 7, 1440x900 
0x37CA2318, 38092269613461640, 226449532, 226449539, 7, 1440x900 
0x37CA2318, 38092269614131184, 226449598, 226449606, 8, 1440x900 
0x37CA2318, 38092269614800816, 226449663, 226449672, 9, 1440x900 
0x37CA2318, 38092269615460280, 226449730, 226449738, 8, 1440x900 
0x37CA2318, 38092269616130136, 226449797, 226449805, 8, 1440x900 
0x37CA2318, 38092269616789640, 226449867, 226449874, 7, 1440x900 
0x37CA2318, 38092269617459192, 226449934, 226449941, 7, 1440x900 
0x37CA2318, 38092269618119056, 226449997, 226450006, 9, 1440x900 
0x37CA2318, 38092269618778472, 226450062, 226450070, 8, 1440x900 
0x37CA2318, 38092269619447968, 226450128, 226450136, 8, 1440x900 
0x37CA2318, 38092269620107840, 226450197, 226450204, 7, 1440x900 
0x37CA2318, 38092269620767184, 226450262, 226450269, 7, 1440x900 
0x37CA2318, 38092269621436776, 226450327, 226450335, 8, 1440x900 
0x37CA2318, 38092269622096584, 226450397, 226450404, 7, 1440x900 
0x37CA2318, 38092269622746192, 226450462, 226450469, 7, 1440x900 
0x37CA2318, 38092269623425728, 226450528, 226450535, 7, 1440x900 
0x37CA2318, 38092269624085232, 226450592, 226450600, 8, 1440x900 
0x37CA2318, 38092269624755088, 226450663, 226450670, 7, 1440x900 
0x37CA2318, 38092269625404968, 226450727, 226450734, 7, 1440x900 
0x37CA2318, 38092269626065024, 226450793, 226450800, 7, 1440x900 
0x37CA2318, 38092269626733760, 226450859, 226450866, 7, 1440x900 
0x37CA2318, 38092269627394336, 226450927, 226450934, 7, 1440x900 
0x37CA2318, 38092269628045920, 226450991, 226450998, 7, 1440x900 
0x37CA2318, 38092269628716056, 226451058, 226451065, 7, 1440x900 
0x37CA2318, 38092269629377312, 226451128, 226451136, 8, 1440x900 
0x37CA2318, 38092269630039160, 226451193, 226451201, 8, 1440x900 
0x37CA2318, 38092269630698952, 226451258, 226451267, 9, 1440x900 
0x37CA2318, 38092269631360256, 226451328, 226451336, 8, 1440x900 
0x37CA2318, 38092269632020224, 226451389, 226451397, 8, 1440x900 
0x37CA2318, 38092269632679608, 226451458, 226451466, 8, 1440x900 
0x37CA2318, 38092269633331048, 226451522, 226451530, 8, 1440x900 
0x37CA2318, 38092269633993152, 226451588, 226451596, 8, 1440x900 
0x37CA2318, 38092269634663880, 226451653, 226451661, 8, 1440x900 
0x37CA2318, 38092269635316928, 226451718, 226451727, 9, 1440x900 
0x37CA2318, 38092269635979560, 226451788, 226451795, 7, 1440x900 
0x37CA2318, 38092269636630912, 226451852, 226451860, 8, 1440x900 
0x37CA2318, 38092269637309704, 226451923, 226451931, 8, 1440x900 
0x37CA2318, 38092269637971560, 226451988, 226451996, 8, 1440x900 
0x37CA2318, 38092269638618592, 226452052, 226452060, 8, 1440x900 
0x37CA2318, 38092269639290056, 226452118, 226452126, 8, 1440x900 
0x37CA2318, 38092269639951112, 226452182, 226452190, 8, 1440x900 
0x37CA2318, 38092269640602784, 226452247, 226452256, 9, 1440x900 
0x37CA2318, 38092269641274960, 226452317, 226452325, 8, 1440x900 
0x37CA2318, 38092269641935592, 226452383, 226452391, 8, 1440x900 
0x37CA2318, 38092269642595408, 226452452, 226452460, 8, 1440x900 
0x37CA2318, 38092269643250048, 226452512, 226452520, 8, 1440x900 
0x37CA2318, 38092269643921208, 226452582, 226452590, 8, 1440x900 
0x37CA2318, 38092269644581776, 226452647, 226452655, 8, 1440x900 
0x37CA2318, 38092269645235208, 226452713, 226452721, 8, 1440x900 
0x37CA2318, 38092269645913088, 226452782, 226452790, 8, 1440x900 
0x37CA2318, 38092269646575360, 226452848, 226452856, 8, 1440x900 
0x37CA2318, 38092269647225320, 226452913, 226452921, 8, 1440x900 
0x37CA2318, 38092269647888144, 226452978, 226452986, 8, 1440x900 
0x37CA2318, 38092269648552104, 226453043, 226453051, 8, 1440x900 
0x37CA2318, 38092269649219648, 226453113, 226453121, 8, 1440x900 
0x37CA2318, 38092269649874832, 226453174, 226453181, 7, 1440x900 
0x37CA2318, 38092269650525688, 226453238, 226453246, 8, 1440x900 
0x37CA2318, 38092269651195432, 226453307, 226453315, 8, 1440x900 
0x37CA2318, 38092269651861768, 226453372, 226453379, 7, 1440x900 
0x37CA2318, 38092269652512992, 226453437, 226453445, 8, 1440x900 
0x37CA2318, 38092269653175136, 226453503, 226453510, 7, 1440x900 
0x37CA2318, 38092269653832512, 226453573, 226453581, 8, 1440x900 
0x37CA2318, 38092269654502920, 226453643, 226453650, 7, 1440x900 
0x37CA2318, 38092269655149504, 226453707, 226453715, 8, 1440x900 
0x37CA2318, 38092269655818064, 226453772, 226453779, 7, 1440x900 
0x37CA2318, 38092269656486408, 226453837, 226453845, 8, 1440x900 
0x37CA2318, 38092269657146800, 226453907, 226453915, 8, 1440x900 
0x37CA2318, 38092269657798240, 226453967, 226453976, 9, 1440x900 
0x37CA2318, 38092269658459680, 226454037, 226454045, 8, 1440x900 
0x37CA2318, 38092269659117816, 226454102, 226454110, 8, 1440x900 
0x37CA2318, 38092269659781256, 226454167, 226454175, 8, 1440x900 
0x37CA2318, 38092269660448344, 226454233, 226454241, 8, 1440x900 
0x37CA2318, 38092269661100864, 226454298, 226454307, 9, 1440x900 
0x37CA2318, 38092269661753632, 226454362, 226454371, 9, 1440x900 
0x37CA2318, 38092269662419776, 226454433, 226454441, 8, 1440x900 
0x37CA2318, 38092269663083672, 226454497, 226454505, 8, 1440x900 
0x37CA2318, 38092269663741056, 226454561, 226454569, 8, 1440x900 
0x37CA2318, 38092269664397688, 226454628, 226454636, 8, 1440x900 
0x37CA2318, 38092269665066496, 226454693, 226454702, 9, 1440x900 
0x37CA2318, 38092269665718416, 226454762, 226454770, 8, 1440x900 
0x37CA2318, 38092269666386600, 226454832, 226454840, 8, 1440x900 
0x37CA2318, 38092269667049600, 226454892, 226454901, 9, 1440x900 
0x37CA2318, 38092269667714984, 226454962, 226454970, 8, 1440x900 
0x37CA2318, 38092269668369176, 226455028, 226455036, 8, 1440x900 
0x37CA2318, 38092269669026040, 226455092, 226455099, 7, 1440x900 
0x37CA2318, 38092269669698480, 226455157, 226455165, 8, 1440x900 
0x37CA2318, 38092269670361768, 226455227, 226455235, 8, 1440x900 
0x37CA2318, 38092269671681392, 226455358, 226455366, 8, 1440x900 
0x37CA2318, 38092269672342632, 226455423, 226455431, 8, 1440x900 
0x37CA2318, 38092269672993440, 226455487, 226455495, 8, 1440x900 
0x37CA2318, 38092269673666128, 226455557, 226455565, 8, 1440x900 
0x37CA2318, 38092269674320112, 226455623, 226455631, 8, 1440x900 
0x37CA2318, 38092269674983512, 226455688, 226455696, 8, 1440x900 
0x37CA2318, 38092269675636016, 226455753, 226455761, 8, 1440x900 
0x37CA2318, 38092269676298592, 226455817, 226455826, 9, 1440x900 
0x37CA2318, 38092269676970352, 226455888, 226455896, 8, 1440x900 
0x37CA2318, 38092269677631368, 226455951, 226455960, 9, 1440x900 
0x37CA2318, 38092269678291856, 226456018, 226456026, 8, 1440x900 
0x37CA2318, 38092269678947712, 226456082, 226456090, 8, 1440x900 
0x37CA2318, 38092269679614232, 226456152, 226456160, 8, 1440x900 
0x37CA2318, 38092269680274992, 226456217, 226456225, 8, 1440x900 
0x37CA2318, 38092269680938016, 226456282, 226456290, 8, 1440x900 
0x37CA2318, 38092269681598592, 226456348, 226456356, 8, 1440x900 
0x37CA2318, 38092269682258600, 226456417, 226456425, 8, 1440x900 
0x37CA2318, 38092269682920656, 226456482, 226456490, 8, 1440x900 
0x37CA2318, 38092269683588856, 226456547, 226456555, 8, 1440x900 
0x37CA2318, 38092269684240344, 226456612, 226456620, 8, 1440x900 
0x37CA2318, 38092269684901552, 226456678, 226456686, 8, 1440x900 
0x37CA2318, 38092269685561952, 226456742, 226456749, 7, 1440x900 
0x37CA2318, 38092269686215760, 226456813, 226456821, 8, 1440x900 
0x37CA2318, 38092269686886736, 226456878, 226456886, 8, 1440x900 
0x37CA2318, 38092269687556344, 226456943, 226456951, 8, 1440x900 
0x37CA2318, 38092269688216424, 226457013, 226457021, 8, 1440x900 
0x37CA2318, 38092269688868960, 226457074, 226457082, 8, 1440x900 
0x37CA2318, 38092269689527840, 226457143, 226457151, 8, 1440x900 
0x37CA2318, 38092269690188896, 226457208, 226457215, 7, 1440x900 
0x37CA2318, 38092269690845864, 226457273, 226457281, 8, 1440x900 
0x37CA2318, 38092269691507672, 226457342, 226457350, 8, 1440x900 
0x37CA2318, 38092269692172608, 226457408, 226457416, 8, 1440x900 
0x37CA2318, 38092269692833536, 226457467, 226457475, 8, 1440x900 
0x37CA2318, 38092269693495576, 226457537, 226457544, 7, 1440x900 
0x37CA2318, 38092269694156680, 226457602, 226457609, 7, 1440x900 
0x37CA2318, 38092269694820048, 226457672, 226457680, 8, 1440x900 
0x37CA2318, 38092269695481320, 226457738, 226457746, 8, 1440x900 
0x37CA2318, 38092269696140432, 226457802, 226457809, 7, 1440x900 
0x37CA2318, 38092269696802784, 226457868, 226457876, 8, 1440x900 
0x37CA2318, 38092269697463248, 226457933, 226457942, 9, 1440x900 
0x37CA2318, 38092269698124208, 226458003, 226458010, 7, 1440x900 
0x37CA2318, 38092269698784880, 226458068, 226458076, 8, 1440x900 
0x37CA2318, 38092269699445968, 226458133, 226458141, 8, 1440x900 
0x37CA2318, 38092269700106648, 226458197, 226458206, 9, 1440x900 
0x37CA2318, 38092269700759368, 226458263, 226458272, 9, 1440x900 
0x37CA2318, 38092269701422392, 226458332, 226458340, 8, 1440x900 
0x37CA2318, 38092269702089168, 226458402, 226458409, 7, 1440x900 
0x37CA2318, 38092269702741008, 226458458, 226458466, 8, 1440x900 
0x37CA2318, 38092269703421088, 226458529, 226458537, 8, 1440x900 
0x37CA2318, 38092269704072208, 226458598, 226458606, 8, 1440x900 
0x37CA2318, 38092269704723880, 226458664, 226458671, 7, 1440x900 
0x37CA2318, 38092269705391808, 226458728, 226458736, 8, 1440x900 
0x37CA2318, 38092269706052520, 226458792, 226458801, 9, 1440x900 
0x37CA2318, 38092269706704320, 226458863, 226458872, 9, 1440x900 
0x37CA2318, 38092269707367104, 226458927, 226458935, 8, 1440x900 
0x37CA2318, 38092269708045040, 226458997, 226459005, 8, 1440x900 
0x37CA2318, 38092269708704976, 226459059, 226459067, 8, 1440x900 
0x37CA2318, 38092269709366552, 226459128, 226459136, 8, 1440x900 
0x37CA2318, 38092269710036192, 226459193, 226459201, 8, 1440x900 
0x37CA2318, 38092269710692744, 226459257, 226459265, 8, 1440x900 
0x37CA2318, 38092269711354064, 226459324, 226459333, 9, 1440x900 
0x37CA2318, 38092269712016040, 226459389, 226459397, 8, 1440x900 
0x37CA2318, 38092269712685344, 226459458, 226459465, 7, 1440x900 
0x37CA2318, 38092269713328920, 226459518, 226459526, 8, 1440x900 
0x37CA2318, 38092269713992112, 226459588, 226459596, 8, 1440x900 
0x37CA2318, 38092269714667744, 226459653, 226459662, 9, 1440x900 
0x37CA2318, 38092269715318824, 226459723, 226459731, 8, 1440x900 
0x37CA2318, 38092269715975136, 226459789, 226459796, 7, 1440x900 
0x37CA2318, 38092269716652488, 226459857, 226459865, 8, 1440x900 
0x37CA2318, 38092269717302496, 226459916, 226459923, 7, 1440x900 
0x37CA2318, 38092269717961272, 226459983, 226459991, 8, 1440x900 
0x37CA2318, 38092269718629832, 226460053, 226460061, 8, 1440x900 
0x37CA2318, 38092269719283672, 226460117, 226460125, 8, 1440x900 
0x37CA2318, 38092269719945728, 226460183, 226460191, 8, 1440x900 
0x37CA2318, 38092269720604632, 226460248, 226460256, 8, 1440x900 
0x37CA2318, 38092269721258888, 226460313, 226460321, 8, 1440x900 
0x37CA2318, 38092269721937440, 226460382, 226460390, 8, 1440x900 
0x37CA2318, 38092269722588112, 226460447, 226460455, 8, 1440x900 
0x37CA2318, 38092269723258224, 226460517, 226460525, 8, 1440x900 
0x37CA2318, 38092269723915696, 226460578, 226460587, 9, 1440x900 
0x37CA2318, 38092269724569888, 226460647, 226460655, 8, 1440x900 
0x37CA2318, 38092269725225192, 226460713, 226460721, 8, 1440x900 
0x37CA2318, 38092269725887136, 226460777, 226460785, 8, 1440x900 
0x37CA2318, 38092269726552312, 226460847, 226460855, 8, 1440x900 
0x37CA2318, 38092269727215840, 226460912, 226460920, 8, 1440x900 
0x37CA2318, 38092269727867200, 226460978, 226460986, 8, 1440x900 
0x37CA2318, 38092269728538216, 226461042, 226461050, 8, 1440x900 
0x37CA2318, 38092269729206912, 226461108, 226461116, 8, 1440x900 
0x37CA2318, 38092269729858560, 226461177, 226461185, 8, 1440x900 
0x37CA2318, 38092269730520016, 226461242, 226461250, 8, 1440x900 
0x37CA2318, 38092269731186368, 226461308, 226461316, 8, 1440x900 
0x37CA2318, 38092269731838544, 226461373, 226461381, 8, 1440x900 
0x37CA2318, 38092269732511760, 226461438, 226461446, 8, 1440x900 
0x37CA2318, 38092269733163160, 226461503, 226461511, 8, 1440x900 
0x37CA2318, 38092269733824624, 226461568, 226461577, 9, 1440x900 
0x37CA2318, 38092269734483720, 226461637, 226461645, 8, 1440x900 
0x37CA2318, 38092269735144680, 226461704, 226461712, 8, 1440x900 
0x37CA2318, 38092269735806600, 226461772, 226461780, 8, 1440x900 
0x37CA2318, 38092269736465560, 226461833, 226461842, 9, 1440x900 
0x37CA2318, 38092269737129632, 226461898, 226461906, 8, 1440x900 
0x37CA2318, 38092269737782080, 226461967, 226461974, 7, 1440x900 
0x37CA2318, 38092269738450320, 226462033, 226462041, 8, 1440x900 
0x37CA2318, 38092269739112888, 226462098, 226462106, 8, 1440x900 
0x37CA2318, 38092269739766112, 226462168, 226462175, 7, 1440x900 
0x37CA2318, 38092269740435272, 226462232, 226462240, 8, 1440x900 
0x37CA2318, 38092269741106048, 226462298, 226462306, 8, 1440x900 
0x37CA2318, 38092269741755784, 226462362, 226462371, 9, 1440x900 
0x37CA2318, 38092269742419184, 226462433, 226462441, 8, 1440x900 
0x37CA2318, 38092269743076752, 226462498, 226462506, 8, 1440x900 
0x37CA2318, 38092269743745800, 226462563, 226462571, 8, 1440x900 
0x37CA2318, 38092269744397896, 226462627, 226462635, 8, 1440x900 
0x37CA2318, 38092269745055728, 226462693, 226462701, 8, 1440x900 
0x37CA2318, 38092269745725784, 226462762, 226462770, 8, 1440x900 
0x37CA2318, 38092269746377608, 226462827, 226462834, 7, 1440x900 
0x37CA2318, 38092269747047648, 226462893, 226462901, 8, 1440x900 
0x37CA2318, 38092269747700784, 226462958, 226462966, 8, 1440x900 
0x37CA2318, 38092269748358928, 226463027, 226463035, 8, 1440x900 
0x37CA2318, 38092269749027736, 226463093, 226463101, 8, 1440x900 
0x37CA2318, 38092269750341640, 226463222, 226463230, 8, 1440x900 
0x37CA2318, 38092269750992608, 226463287, 226463295, 8, 1440x900 
0x37CA2318, 38092269751654384, 226463352, 226463361, 9, 1440x900 
0x37CA2318, 38092269752317904, 226463422, 226463430, 8, 1440x900 
0x37CA2318, 38092269752986544, 226463486, 226463494, 8, 1440x900 
0x37CA2318, 38092269753645576, 226463551, 226463558, 7, 1440x900 
0x37CA2318, 38092269754303288, 226463617, 226463624, 7, 1440x900 
0x37CA2318, 38092269754966616, 226463683, 226463691, 8, 1440x900 
0x37CA2318, 38092269755637120, 226463753, 226463760, 7, 1440x900 
0x37CA2318, 38092269756298800, 226463817, 226463825, 8, 1440x900 
0x37CA2318, 38092269756958512, 226463882, 226463891, 9, 1440x900 
0x37CA2318, 38092269757618104, 226463952, 226463960, 8, 1440x900 
0x37CA2318, 38092269758271888, 226464013, 226464020, 7, 1440x900 
0x37CA2318, 38092269758932536, 226464078, 226464086, 8, 1440x900 
0x37CA2318, 38092269759602744, 226464147, 226464154, 7, 1440x900 
0x37CA2318, 38092269760255120, 226464213, 226464221, 8, 1440x900 
0x37CA2318, 38092269760916616, 226464282, 226464289, 7, 1440x900 
0x37CA2318, 38092269761574784, 226464349, 226464357, 8, 1440x900 
0x37CA2318, 38092269762228064, 226464413, 226464421, 8, 1440x900 
0x37CA2318, 38092269762896680, 226464478, 226464486, 8, 1440x900 
0x37CA2318, 38092269763547096, 226464543, 226464551, 8, 1440x900 
0x37CA2318, 38092269764227136, 226464613, 226464621, 8, 1440x900 
0x37CA2318, 38092269764875528, 226464672, 226464680, 8, 1440x900 
0x37CA2318, 38092269765548240, 226464742, 226464749, 7, 1440x900 
0x37CA2318, 38092269766206760, 226464807, 226464814, 7, 1440x900 
0x37CA2318, 38092269766861480, 226464872, 226464881, 9, 1440x900 
0x37CA2318, 38092269767529136, 226464942, 226464950, 8, 1440x900 
0x37CA2318, 38092269768185568, 226465007, 226465015, 8, 1440x900 
0x37CA2318, 38092269768865320, 226465073, 226465082, 9, 1440x900 
0x37CA2318, 38092269769516656, 226465138, 226465147, 9, 1440x900 
0x37CA2318, 38092269770170288, 226465207, 226465215, 8, 1440x900 
0x37CA2318, 38092269770838000, 226465273, 226465281, 8, 1440x900 
0x37CA2318, 38092269771503128, 226465337, 226465345, 8, 1440x900 
0x37CA2318, 38092269772154968, 226465403, 226465410, 7, 1440x900 
0x37CA2318, 38092269772818368, 226465473, 226465481, 8, 1440x900 
0x37CA2318, 38092269773488328, 226465537, 226465545, 8, 1440x900 
0x37CA2318, 38092269774140144, 226465602, 226465610, 8, 1440x900 
0x37CA2318, 38092269774807096, 226465668, 226465676, 8, 1440x900 
0x37CA2318, 38092269775462488, 226465733, 226465741, 8, 1440x900 
0x37CA2318, 38092269776122064, 226465803, 226465811, 8, 1440x900 
0x37CA2318, 38092269776777416, 226465868, 226465876, 8, 1440x900 
0x37CA2318, 38092269777455640, 226465932, 226465939, 7, 1440x900 
0x37CA2318, 38092269778109320, 226465997, 226466004, 7, 1440x900 
0x37CA2318, 38092269778776832, 226466067, 226466075, 8, 1440x900 
0x37CA2318, 38092269779429472, 226466133, 226466141, 8, 1440x900 
0x37CA2318, 38092269780090968, 226466198, 226466206, 8, 1440x900 
0x37CA2318, 38092269780740560, 226466263, 226466271, 8, 1440x900 
0x37CA2318, 38092269781413352, 226466328, 226466336, 8, 1440x900 
0x37CA2318, 38092269782077688, 226466398, 226466406, 8, 1440x900 
0x37CA2318, 38092269782739480, 226466463, 226466471, 8, 1440x900 
0x37CA2318, 38092269783394000, 226466528, 226466537, 9, 1440x900 
0x37CA2318, 38092269784073368, 226466594, 226466602, 8, 1440x900 
0x37CA2318, 38092269784733880, 226466664, 226466672, 8, 1440x900 
0x37CA2318, 38092269785380880, 226466727, 226466735, 8, 1440x900 
0x37CA2318, 38092269786053656, 226466793, 226466801, 8, 1440x900 
0x37CA2318, 38092269786707016, 226466862, 226466870, 8, 1440x900 
0x37CA2318, 38092269787357360, 226466923, 226466931, 8, 1440x900 
0x37CA2318, 38092269788019832, 226466988, 226466997, 9, 1440x900 
0x37CA2318, 38092269788682472, 226467058, 226467066, 8, 1440x900 
0x37CA2318, 38092269789353752, 226467127, 226467135, 8, 1440x900 
0x37CA2318, 38092269790005968, 226467187, 226467196, 9, 1440x900 
0x37CA2318, 38092269790669176, 226467254, 226467262, 8, 1440x900 
0x37CA2318, 38092269791329472, 226467322, 226467330, 8, 1440x900 
0x37CA2318, 38092269792000136, 226467387, 226467396, 9, 1440x900 
0x37CA2318, 38092269792659296, 226467457, 226467465, 8, 1440x900 
0x37CA2318, 38092269793363720, 226467528, 226467536, 8, 1440x900 
0x37CA2318, 38092269793980240, 226467587, 226467595, 8, 1440x900 
0x37CA2318, 38092269794638048, 226467653, 226467661, 8, 1440x900 
0x37CA2318, 38092269795308416, 226467722, 226467730, 8, 1440x900 
0x37CA2318, 38092269795957560, 226467787, 226467795, 8, 1440x900 
0x37CA2318, 38092269796629448, 226467853, 226467861, 8, 1440x900 
0x37CA2318, 38092269797281808, 226467917, 226467925, 8, 1440x900 
0x37CA2318, 38092269797950760, 226467983, 226467991, 8, 1440x900 
0x37CA2318, 38092269798603608, 226468048, 226468056, 8, 1440x900 
0x37CA2318, 38092269799268968, 226468117, 226468125, 8, 1440x900 
0x37CA2318, 38092269799921664, 226468179, 226468187, 8, 1440x900 
0x37CA2318, 38092269800589504, 226468247, 226468255, 8, 1440x900 
0x37CA2318, 38092269801239976, 226468311, 226468318, 7, 1440x900 
0x37CA2318, 38092269801910432, 226468382, 226468390, 8, 1440x900 
0x37CA2318, 38092269802564864, 226468443, 226468452, 9, 1440x900 
0x37CA2318, 38092269803223792, 226468512, 226468524, 12, 1440x900 
0x37CA2318, 38092269803875952, 226468577, 226468585, 8, 1440x900 
0x37CA2318, 38092269804548576, 226468643, 226468651, 8, 1440x900 
0x37CA2318, 38092269805202280, 226468707, 226468715, 8, 1440x900 
0x37CA2318, 38092269805872848, 226468777, 226468785, 8, 1440x900 
0x37CA2318, 38092269806525968, 226468843, 226468851, 8, 1440x900 
0x37CA2318, 38092269807200056, 226468912, 226468920, 8, 1440x900 
0x37CA2318, 38092269807858120, 226468977, 226468985, 8, 1440x900 
0x37CA2318, 38092269808511008, 226469038, 226469047, 9, 1440x900 
0x37CA2318, 38092269809177048, 226469103, 226469111, 8, 1440x900 
0x37CA2318, 38092269809839160, 226469172, 226469180, 8, 1440x900 
0x37CA2318, 38092269810490872, 226469237, 226469245, 8, 1440x900 
0x37CA2318, 38092269811152952, 226469308, 226469316, 8, 1440x900 
0x37CA2318, 38092269811814024, 226469372, 226469380, 8, 1440x900 
0x37CA2318, 38092269812473624, 226469438, 226469446, 8, 1440x900 
0x37CA2318, 38092269813135672, 226469503, 226469511, 8, 1440x900 
0x37CA2318, 38092269813796288, 226469568, 226469576, 8, 1440x900 
0x37CA2318, 38092269814451112, 226469633, 226469641, 8, 1440x900 
0x37CA2318, 38092269815122048, 226469699, 226469707, 8, 1440x900 
0x37CA2318, 38092269815785008, 226469768, 226469776, 8, 1440x900 
0x37CA2318, 38092269816436160, 226469833, 226469841, 8, 1440x900 
0x37CA2318, 38092269817107544, 226469898, 226469907, 9, 1440x900 
0x37CA2318, 38092269817767488, 226469968, 226469976, 8, 1440x900 
0x37CA2318, 38092269818421176, 226470033, 226470041, 8, 1440x900 
0x37CA2318, 38092269819084608, 226470097, 226470105, 8, 1440x900 
0x37CA2318, 38092269819753120, 226470162, 226470169, 7, 1440x900 
0x37CA2318, 38092269820402448, 226470227, 226470234, 7, 1440x900 
0x37CA2318, 38092269821065288, 226470298, 226470306, 8, 1440x900 
0x37CA2318, 38092269821719728, 226470363, 226470371, 8, 1440x900 
0x37CA2318, 38092269822383264, 226470428, 226470436, 8, 1440x900 
0x37CA2318, 38092269823061080, 226470492, 226470501, 9, 1440x900 
0x37CA2318, 38092269823713568, 226470562, 226470571, 9, 1440x900 
0x37CA2318, 38092269824376408, 226470627, 226470635, 8, 1440x900 
0x37CA2318, 38092269825041880, 226470693, 226470702, 9, 1440x900 
0x37CA2318, 38092269825696672, 226470757, 226470765, 8, 1440x900 
0x37CA2318, 38092269826354768, 226470822, 226470830, 8, 1440x900 
0x37CA2318, 38092269827028768, 226470892, 226470899, 7, 1440x900 
0x37CA2318, 38092269828348840, 226471028, 226471036, 8, 1440x900 
0x37CA2318, 38092269829011976, 226471088, 226471096, 8, 1440x900 
0x37CA2318, 38092269829673000, 226471158, 226471166, 8, 1440x900 
0x37CA2318, 38092269830324280, 226471223, 226471231, 8, 1440x900 
0x37CA2318, 38092269830986040, 226471287, 226471295, 8, 1440x900 
0x37CA2318, 38092269831655336, 226471353, 226471361, 8, 1440x900 
0x37CA2318, 38092269832317032, 226471420, 226471428, 8, 1440x900 
0x37CA2318, 38092269832979584, 226471488, 226471496, 8, 1440x900 
0x37CA2318, 38092269833639304, 226471552, 226471560, 8, 1440x900 
0x37CA2318, 38092269834292288, 226471617, 226471625, 8, 1440x900 
0x37CA2318, 38092269834955568, 226471683, 226471691, 8, 1440x900 
0x37CA2318, 38092269835610432, 226471747, 226471756, 9, 1440x900 
0x37CA2318, 38092269836276832, 226471818, 226471826, 8, 1440x900 
0x37CA2318, 38092269836945040, 226471884, 226471891, 7, 1440x900 
0x37CA2318, 38092269837596352, 226471947, 226471955, 8, 1440x900 
0x37CA2318, 38092269838257808, 226472013, 226472021, 8, 1440x900 
0x37CA2318, 38092269838920144, 226472083, 226472091, 8, 1440x900 
0x37CA2318, 38092269839572696, 226472144, 226472152, 8, 1440x900 
0x37CA2318, 38092269840243624, 226472213, 226472221, 8, 1440x900 
0x37CA2318, 38092269840907840, 226472277, 226472286, 9, 1440x900 
0x37CA2318, 38092269841562056, 226472347, 226472355, 8, 1440x900 
0x37CA2318, 38092269842223912, 226472413, 226472421, 8, 1440x900 
0x37CA2318, 38092269842875280, 226472477, 226472485, 8, 1440x900 
0x37CA2318, 38092269843535272, 226472542, 226472551, 9, 1440x900 
0x37CA2318, 38092269844198656, 226472607, 226472615, 8, 1440x900 
0x37CA2318, 38092269844876368, 226472677, 226472685, 8, 1440x900 
0x37CA2318, 38092269845545488, 226472747, 226472755, 8, 1440x900 
0x37CA2318, 38092269846207648, 226472808, 226472816, 8, 1440x900 
0x37CA2318, 38092269846859320, 226472873, 226472881, 8, 1440x900 
0x37CA2318, 38092269847520600, 226472942, 226472950, 8, 1440x900 
0x37CA2318, 38092269848182128, 226473008, 226473016, 8, 1440x900 
0x37CA2318, 38092269848850536, 226473072, 226473080, 8, 1440x900 
0x37CA2318, 38092269849501792, 226473138, 226473146, 8, 1440x900 
0x37CA2318, 38092269850162456, 226473207, 226473215, 8, 1440x900 
0x37CA2318, 38092269850823592, 226473272, 226473280, 8, 1440x900 
0x37CA2318, 38092269851477800, 226473338, 226473345, 7, 1440x900 
0x37CA2318, 38092269852145624, 226473403, 226473411, 8, 1440x900 
0x37CA2318, 38092269852807152, 226473468, 226473476, 8, 1440x900 
0x37CA2318, 38092269853468336, 226473533, 226473542, 9, 1440x900 
0x37CA2318, 38092269854127280, 226473603, 226473611, 8, 1440x900 
0x37CA2318, 38092269854787824, 226473667, 226473674, 7, 1440x900 
0x37CA2318, 38092269855266264, 226473712, 226473719, 7, 1440x900 
0x37CA2318, 38092269855932392, 226473777, 226473785, 8, 1440x900 
0x37CA2318, 38092269856765032, 226473863, 226473872, 9, 1440x900 
0x37CA2318, 38092269857437392, 226473933, 226473941, 8, 1440x900 
0x37CA2318, 38092269858095672, 226473997, 226474005, 8, 1440x900 
0x37CA2318, 38092269858769416, 226474066, 226474073, 7, 1440x900 
0x37CA2318, 38092269859438440, 226474132, 226474140, 8, 1440x900 
0x37CA2318, 38092269860100208, 226474196, 226474204, 8, 1440x900 
0x37CA2318, 38092269860753088, 226474262, 226474270, 8, 1440x900 
0x37CA2318, 38092269861427912, 226474333, 226474341, 8, 1440x900 
0x37CA2318, 38092269862086200, 226474397, 226474405, 8, 1440x900 
0x37CA2318, 38092269862741072, 226474463, 226474471, 8, 1440x900 
0x37CA2318, 38092269863407600, 226474532, 226474540, 8, 1440x900 
0x37CA2318, 38092269864064496, 226474593, 226474603, 10, 1440x900 
0x37CA2318, 38092269864835040, 226474678, 226474686, 8, 1440x900 
0x37CA2318, 38092269865390912, 226474726, 226474733, 7, 1440x900 
0x37CA2318, 38092269866042768, 226474793, 226474801, 8, 1440x900 
0x37CA2318, 38092269866703112, 226474858, 226474866, 8, 1440x900 
0x37CA2318, 38092269867381720, 226474927, 226474935, 8, 1440x900 
0x37CA2318, 38092269868033000, 226474992, 226475000, 8, 1440x900 
0x37CA2318, 38092269868693736, 226475057, 226475066, 9, 1440x900 
0x37CA2318, 38092269869345032, 226475124, 226475132, 8, 1440x900 
0x37CA2318, 38092269870006880, 226475188, 226475196, 8, 1440x900 
0x37CA2318, 38092269870678064, 226475258, 226475266, 8, 1440x900 
0x37CA2318, 38092269871339680, 226475322, 226475330, 8, 1440x900 
0x37CA2318, 38092269872000408, 226475387, 226475396, 9, 1440x900 
0x37CA2318, 38092269872664504, 226475453, 226475461, 8, 1440x900 
0x37CA2318, 38092269873333824, 226475523, 226475531, 8, 1440x900 
0x37CA2318, 38092269873993472, 226475588, 226475597, 9, 1440x900 
0x37CA2318, 38092269874653616, 226475652, 226475661, 9, 1440x900 
0x37CA2318, 38092269875305728, 226475717, 226475726, 9, 1440x900 
0x37CA2318, 38092269875966192, 226475785, 226475794, 9, 1440x900 
0x37CA2318, 38092269876617760, 226475847, 226475854, 7, 1440x900 
0x37CA2318, 38092269877287632, 226475918, 226475926, 8, 1440x900 
0x37CA2318, 38092269877940304, 226475983, 226475991, 8, 1440x900 
0x37CA2318, 38092269878612928, 226476048, 226476056, 8, 1440x900 
0x37CA2318, 38092269879282432, 226476118, 226476126, 8, 1440x900 
0x37CA2318, 38092269879934904, 226476184, 226476192, 8, 1440x900 
0x37CA2318, 38092269880595232, 226476247, 226476255, 8, 1440x900 
0x37CA2318, 38092269881256352, 226476312, 226476321, 9, 1440x900 
0x37CA2318, 38092269881920920, 226476383, 226476391, 8, 1440x900 
0x37CA2318, 38092269882587896, 226476447, 226476455, 8, 1440x900 
0x37CA2318, 38092269883239488, 226476513, 226476521, 8, 1440x900 
0x37CA2318, 38092269883894264, 226476578, 226476586, 8, 1440x900 
0x37CA2318, 38092269884565712, 226476648, 226476656, 8, 1440x900 
0x37CA2318, 38092269885220280, 226476712, 226476720, 8, 1440x900 
0x37CA2318, 38092269885883360, 226476778, 226476786, 8, 1440x900 
0x37CA2318, 38092269886546248, 226476843, 226476852, 9, 1440x900 
0x37CA2318, 38092269887207392, 226476908, 226476916, 8, 1440x900 
0x37CA2318, 38092269887858312, 226476972, 226476979, 7, 1440x900 
0x37CA2318, 38092269888523648, 226477038, 226477047, 9, 1440x900 
0x37CA2318, 38092269889185552, 226477108, 226477116, 8, 1440x900 
0x37CA2318, 38092269889850680, 226477177, 226477185, 8, 1440x900 
0x37CA2318, 38092269890504192, 226477238, 226477245, 7, 1440x900 
0x37CA2318, 38092269891174816, 226477308, 226477316, 8, 1440x900 
0x37CA2318, 38092269891834096, 226477372, 226477380, 8, 1440x900 
0x37CA2318, 38092269892495992, 226477437, 226477445, 8, 1440x900 
0x37CA2318, 38092269893157024, 226477507, 226477515, 8, 1440x900 
0x37CA2318, 38092269893810064, 226477572, 226477580, 8, 1440x900 
0x37CA2318, 38092269894471472, 226477638, 226477646, 8, 1440x900 
0x37CA2318, 38092269895133888, 226477703, 226477711, 8, 1440x900 
0x37CA2318, 38092269895794912, 226477768, 226477776, 8, 1440x900 
0x37CA2318, 38092269896465736, 226477838, 226477847, 9, 1440x900 
0x37CA2318, 38092269897115424, 226477898, 226477905, 7, 1440x900 
0x37CA2318, 38092269897785456, 226477966, 226477974, 8, 1440x900 
0x37CA2318, 38092269898427024, 226478028, 226478036, 8, 1440x900 
0x37CA2318, 38092269899098456, 226478097, 226478104, 7, 1440x900 
0x37CA2318, 38092269899749880, 226478167, 226478175, 8, 1440x900 
0x37CA2318, 38092269900420416, 226478229, 226478237, 8, 1440x900 
0x37CA2318, 38092269901080744, 226478298, 226478306, 8, 1440x900 
0x37CA2318, 38092269901743392, 226478362, 226478370, 8, 1440x900 
0x37CA2318, 38092269902402544, 226478428, 226478436, 8, 1440x900 
0x37CA2318, 38092269903062616, 226478492, 226478501, 9, 1440x900 
0x37CA2318, 38092269903728096, 226478563, 226478571, 8, 1440x900 
0x37CA2318, 38092269904379352, 226478627, 226478635, 8, 1440x900 
0x37CA2318, 38092269905049480, 226478692, 226478700, 8, 1440x900 
0x37CA2318, 38092269905709784, 226478758, 226478766, 8, 1440x900 
0x37CA2318, 38092269906372656, 226478827, 226478835, 8, 1440x900 
0x37CA2318, 38092269907032248, 226478892, 226478899, 7, 1440x900 
0x37CA2318, 38092269907693360, 226478957, 226478965, 8, 1440x900 
0x37CA2318, 38092269908355896, 226479023, 226479031, 8, 1440x900 
0x37CA2318, 38092269909675936, 226479158, 226479166, 8, 1440x900 
0x37CA2318, 38092269910328352, 226479222, 226479230, 8, 1440x900 
0x37CA2318, 38092269910999632, 226479292, 226479300, 8, 1440x900 
0x37CA2318, 38092269911657496, 226479357, 226479365, 8, 1440x900 
0x37CA2318, 38092269912327408, 226479423, 226479431, 8, 1440x900 
0x37CA2318, 38092269912986784, 226479488, 226479496, 8, 1440x900 
0x37CA2318, 38092269913647120, 226479553, 226479561, 8, 1440x900 
0x37CA2318, 38092269914307128, 226479618, 226479626, 8, 1440x900 
0x37CA2318, 38092269914952064, 226479682, 226479690, 8, 1440x900 
0x37CA2318, 38092269915631008, 226479752, 226479760, 8, 1440x900 
0x37CA2318, 38092269916283568, 226479817, 226479826, 9, 1440x900 
0x37CA2318, 38092269916953552, 226479883, 226479891, 8, 1440x900 
0x37CA2318, 38092269917607232, 226479952, 226479960, 8, 1440x900 
0x37CA2318, 38092269918259392, 226480013, 226480021, 8, 1440x900 
0x37CA2318, 38092269918921744, 226480078, 226480087, 9, 1440x900 
0x37CA2318, 38092269919583536, 226480148, 226480157, 9, 1440x900 
0x37CA2318, 38092269920252016, 226480213, 226480221, 8, 1440x900 
0x37CA2318, 38092269920898448, 226480277, 226480286, 9, 1440x900 
0x37CA2318, 38092269921571080, 226480343, 226480352, 9, 1440x900 
0x37CA2318, 38092269922233440, 226480413, 226480421, 8, 1440x900 
0x37CA2318, 38092269922898176, 226480477, 226480485, 8, 1440x900 
0x37CA2318, 38092269923547720, 226480543, 226480551, 8, 1440x900 
0x37CA2318, 38092269924202336, 226480607, 226480615, 8, 1440x900 
0x37CA2318, 38092269924875016, 226480677, 226480685, 8, 1440x900 
0x37CA2318, 38092269925535456, 226480743, 226480750, 7, 1440x900 
0x37CA2318, 38092269926193032, 226480808, 226480816, 8, 1440x900 
0x37CA2318, 38092269926850352, 226480873, 226480882, 9, 1440x900 
0x37CA2318, 38092269927512656, 226480938, 226480946, 8, 1440x900 
0x37CA2318, 38092269928170360, 226481007, 226481015, 8, 1440x900 
0x37CA2318, 38092269928847104, 226481073, 226481081, 8, 1440x900 
0x37CA2318, 38092269929503824, 226481137, 226481145, 8, 1440x900 
0x37CA2318, 38092269930167728, 226481207, 226481215, 8, 1440x900 
0x37CA2318, 38092269930826016, 226481273, 226481281, 8, 1440x900 
0x37CA2318, 38092269931485744, 226481336, 226481344, 8, 1440x900 
0x37CA2318, 38092269932157288, 226481407, 226481415, 8, 1440x900 
0x37CA2318, 38092269932807312, 226481472, 226481480, 8, 1440x900 
0x37CA2318, 38092269933471288, 226481538, 226481546, 8, 1440x900 
0x37CA2318, 38092269934138968, 226481602, 226481610, 8, 1440x900 
0x37CA2318, 38092269934786960, 226481668, 226481676, 8, 1440x900 
0x37CA2318, 38092269935466808, 226481737, 226481745, 8, 1440x900 
0x37CA2318, 38092269936117176, 226481803, 226481811, 8, 1440x900 
0x37CA2318, 38092269936776120, 226481868, 226481876, 8, 1440x900 
0x37CA2318, 38092269937445024, 226481938, 226481946, 8, 1440x900 
0x37CA2318, 38092269938096696, 226481998, 226482005, 7, 1440x900 
0x37CA2318, 38092269938765696, 226482064, 226482072, 8, 1440x900 
0x37CA2318, 38092269939428208, 226482133, 226482141, 8, 1440x900 
0x37CA2318, 38092269940087648, 226482198, 226482206, 8, 1440x900 
0x37CA2318, 38092269940738464, 226482262, 226482270, 8, 1440x900 
0x37CA2318, 38092269941400032, 226482327, 226482335, 8, 1440x900 
0x37CA2318, 38092269942051840, 226482398, 226482406, 8, 1440x900 
0x37CA2318, 38092269942720208, 226482457, 226482465, 8, 1440x900 
0x37CA2318, 38092269943382152, 226482528, 226482536, 8, 1440x900 
0x37CA2318, 38092269944040008, 226482593, 226482601, 8, 1440x900 
0x37CA2318, 38092269944701880, 226482658, 226482666, 8, 1440x900 
0x37CA2318, 38092269945358040, 226482727, 226482735, 8, 1440x900 
0x37CA2318, 38092269946029264, 226482792, 226482800, 8, 1440x900 
0x37CA2318, 38092269946680056, 226482857, 226482865, 8, 1440x900 
0x37CA2318, 38092269947342248, 226482922, 226482930, 8, 1440x900 
0x37CA2318, 38092269948001880, 226482987, 226482995, 8, 1440x900 
0x37CA2318, 38092269948665856, 226483058, 226483071, 13, 1440x900 
0x37CA2318, 38092269949326696, 226483122, 226483130, 8, 1440x900 
0x37CA2318, 38092269949985488, 226483193, 226483201, 8, 1440x900 
0x37CA2318, 38092269950655040, 226483258, 226483266, 8, 1440x900 
0x37CA2318, 38092269951305728, 226483323, 226483331, 8, 1440x900 
0x37CA2318, 38092269951966112, 226483387, 226483395, 8, 1440x900 
0x37CA2318, 38092269952630680, 226483452, 226483460, 8, 1440x900 
0x37CA2318, 38092269953288000, 226483518, 226483526, 8, 1440x900 
0x37CA2318, 38092269953949624, 226483583, 226483591, 8, 1440x900 
0x37CA2318, 38092269954609912, 226483653, 226483661, 8, 1440x900 
0x37CA2318, 38092269955261456, 226483713, 226483721, 8, 1440x900 
0x37CA2318, 38092269955931504, 226483783, 226483791, 8, 1440x900 
0x37CA2318, 38092269956603096, 226483852, 226483860, 8, 1440x900 
0x37CA2318, 38092269957262320, 226483913, 226483921, 8, 1440x900 
0x37CA2318, 38092269957912808, 226483983, 226483991, 8, 1440x900 
0x37CA2318, 38092269958575896, 226484043, 226484051, 8, 1440x900 
0x37CA2318, 38092269959239120, 226484111, 226484119, 8, 1440x900 
0x37CA2318, 38092269959894192, 226484177, 226484184, 7, 1440x900 
0x37CA2318, 38092269960549752, 226484242, 226484250, 8, 1440x900 
0x37CA2318, 38092269961218520, 226484308, 226484315, 7, 1440x900 
0x37CA2318, 38092269961873960, 226484379, 226484387, 8, 1440x900 
0x37CA2318, 38092269962537480, 226484443, 226484451, 8, 1440x900 
0x37CA2318, 38092269963197696, 226484507, 226484515, 8, 1440x900 
0x37CA2318, 38092269963857480, 226484572, 226484580, 8, 1440x900 
0x37CA2318, 38092269964526480, 226484638, 226484646, 8, 1440x900 
0x37CA2318, 38092269965178952, 226484703, 226484711, 8, 1440x900 
0x37CA2318, 38092269965839128, 226484771, 226484778, 7, 1440x900 
0x37CA2318, 38092269966509376, 226484843, 226484851, 8, 1440x900 
0x37CA2318, 38092269967159952, 226484907, 226484915, 8, 1440x900 
0x37CA2318, 38092269967828576, 226484973, 226484981, 8, 1440x900 
0x37CA2318, 38092269968480960, 226485038, 226485046, 8, 1440x900 
0x37CA2318, 38092269969149536, 226485103, 226485111, 8, 1440x900 
0x37CA2318, 38092269969801248, 226485168, 226485176, 8, 1440x900 
0x37CA2318, 38092269970455112, 226485232, 226485241, 9, 1440x900 
0x37CA2318, 38092269971133472, 226485303, 226485311, 8, 1440x900 
0x37CA2318, 38092269971792576, 226485368, 226485376, 8, 1440x900 
0x37CA2318, 38092269972456800, 226485437, 226485445, 8, 1440x900 
0x37CA2318, 38092269973107720, 226485497, 226485506, 9, 1440x900 
0x37CA2318, 38092269973768960, 226485563, 226485572, 9, 1440x900 
0x37CA2318, 38092269974420928, 226485628, 226485635, 7, 1440x900 
0x37CA2318, 38092269975083104, 226485697, 226485705, 8, 1440x900 
0x37CA2318, 38092269975747304, 226485763, 226485771, 8, 1440x900 
0x37CA2318, 38092269976413952, 226485828, 226485836, 8, 1440x900 
0x37CA2318, 38092269977065976, 226485897, 226485905, 8, 1440x900 
0x37CA2318, 38092269977737104, 226485963, 226485971, 8, 1440x900 
0x37CA2318, 38092269978399592, 226486031, 226486039, 8, 1440x900 
0x37CA2318, 38092269979060960, 226486092, 226486100, 8, 1440x900 
0x37CA2318, 38092269979722104, 226486158, 226486167, 9, 1440x900 
0x37CA2318, 38092269980381600, 226486224, 226486233, 9, 1440x900 
0x37CA2318, 38092269981038176, 226486292, 226486300, 8, 1440x900 
0x37CA2318, 38092269981705168, 226486362, 226486370, 8, 1440x900 
0x37CA2318, 38092269982360408, 226486423, 226486431, 8, 1440x900 
0x37CA2318, 38092269983677536, 226486558, 226486566, 8, 1440x900 
0x37CA2318, 38092269984338648, 226486618, 226486626, 8, 1440x900 
0x37CA2318, 38092269985000320, 226486687, 226486696, 9, 1440x900 
0x37CA2318, 38092269985662224, 226486757, 226486765, 8, 1440x900 
0x37CA2318, 38092269986320336, 226486818, 226486827, 9, 1440x900 
0x37CA2318, 38092269986980560, 226486888, 226486896, 8, 1440x900 
0x37CA2318, 38092269987650368, 226486953, 226486961, 8, 1440x900 
0x37CA2318, 38092269988307600, 226487018, 226487026, 8, 1440x900 
0x37CA2318, 38092269988976136, 226487087, 226487094, 7, 1440x900 
0x37CA2318, 38092269989628176, 226487151, 226487159, 8, 1440x900 
0x37CA2318, 38092269990290808, 226487216, 226487224, 8, 1440x900 
0x37CA2318, 38092269990942632, 226487282, 226487290, 8, 1440x900 
0x37CA2318, 38092269991613936, 226487347, 226487355, 8, 1440x900 
0x37CA2318, 38092269992277584, 226487413, 226487421, 8, 1440x900 
0x37CA2318, 38092269992944280, 226487482, 226487490, 8, 1440x900 
0x37CA2318, 38092269993608424, 226487547, 226487556, 9, 1440x900 
0x37CA2318, 38092269994258192, 226487614, 226487622, 8, 1440x900 
0x37CA2318, 38092269994921872, 226487682, 226487690, 8, 1440x900 
0x37CA2318, 38092269995573912, 226487748, 226487757, 9, 1440x900 
0x37CA2318, 38092269996237800, 226487813, 226487821, 8, 1440x900 
0x37CA2318, 38092269996899296, 226487878, 226487886, 8, 1440x900 
0x37CA2318, 38092269997569808, 226487945, 226487953, 8, 1440x900 
0x37CA2318, 38092269998218592, 226488012, 226488020, 8, 1440x900 
0x37CA2318, 38092269998888184, 226488082, 226488090, 8, 1440x900 
0x37CA2318, 38092269999541912, 226488143, 226488151, 8, 1440x900 
0x37CA2318, 38092270000200792, 226488208, 226488216, 8, 1440x900 
0x37CA2318, 38092270000862392, 226488273, 226488282, 9, 1440x900 
0x37CA2318, 38092270001516552, 226488342, 226488349, 7, 1440x900 
0x37CA2318, 38092270002181264, 226488408, 226488416, 8, 1440x900 
0x37CA2318, 38092270002842016, 226488472, 226488480, 8, 1440x900 
0x37CA2318, 38092270003510192, 226488542, 226488550, 8, 1440x900 
0x37CA2318, 38092270004160480, 226488604, 226488612, 8, 1440x900 
0x37CA2318, 38092270004832688, 226488673, 226488681, 8, 1440x900 
0x37CA2318, 38092270005483656, 226488733, 226488741, 8, 1440x900 
0x37CA2318, 38092270006159672, 226488803, 226488811, 8, 1440x900 
0x37CA2318, 38092270006825200, 226488873, 226488881, 8, 1440x900 
0x37CA2318, 38092270007482464, 226488938, 226488946, 8, 1440x900 
0x37CA2318, 38092270008137144, 226489003, 226489011, 8, 1440x900 
0x37CA2318, 38092270008798080, 226489067, 226489075, 8, 1440x900 
0x37CA2318, 38092270009459640, 226489133, 226489142, 9, 1440x900 
0x37CA2318, 38092270010111344, 226489198, 226489206, 8, 1440x900 
0x37CA2318, 38092270010782080, 226489267, 226489275, 8, 1440x900 
0x37CA2318, 38092270011435032, 226489333, 226489341, 8, 1440x900 
0x37CA2318, 38092270012100584, 226489397, 226489405, 8, 1440x900 
0x37CA2318, 38092270012755920, 226489462, 226489471, 9, 1440x900 
0x37CA2318, 38092270013423944, 226489533, 226489542, 9, 1440x900 
0x37CA2318, 38092270014082480, 226489597, 226489605, 8, 1440x900 
0x37CA2318, 38092270014742288, 226489662, 226489670, 8, 1440x900 
0x37CA2318, 38092270015408376, 226489733, 226489741, 8, 1440x900 
0x37CA2318, 38092270016062944, 226489792, 226489799, 7, 1440x900 
0x37CA2318, 38092270016726192, 226489863, 226489871, 8, 1440x900 
0x37CA2318, 38092270017388384, 226489928, 226489936, 8, 1440x900 
0x37CA2318, 38092270018039424, 226489992, 226490000, 8, 1440x900 
0x37CA2318, 38092270018703568, 226490057, 226490066, 9, 1440x900 
0x37CA2318, 38092270019364472, 226490123, 226490130, 7, 1440x900 
0x37CA2318, 38092270020021864, 226490187, 226490195, 8, 1440x900 
0x37CA2318, 38092270020683144, 226490253, 226490261, 8, 1440x900 
0x37CA2318, 38092270021345464, 226490322, 226490329, 7, 1440x900 
0x37CA2318, 38092270021999368, 226490388, 226490397, 9, 1440x900 
0x37CA2318, 38092270022672816, 226490453, 226490462, 9, 1440x900 
0x37CA2318, 38092270023333632, 226490523, 226490532, 9, 1440x900 
0x37CA2318, 38092270023995040, 226490588, 226490596, 8, 1440x900 
0x37CA2318, 38092270024656208, 226490658, 226490666, 8, 1440x900 
0x37CA2318, 38092270025326640, 226490722, 226490730, 8, 1440x900 
0x37CA2318, 38092270025972440, 226490788, 226490796, 8, 1440x900 
0x37CA2318, 38092270026633904, 226490849, 226490856, 7, 1440x900 
0x37CA2318, 38092270027307216, 226490918, 226490926, 8, 1440x900 
0x37CA2318, 38092270027958160, 226490982, 226490991, 9, 1440x900 
0x37CA2318, 38092270028619608, 226491052, 226491060, 8, 1440x900 
0x37CA2318, 38092270029276312, 226491118, 226491126, 8, 1440x900 
0x37CA2318, 38092270029947008, 226491182, 226491189, 7, 1440x900 
0x37CA2318, 38092270030612432, 226491247, 226491254, 7, 1440x900 
0x37CA2318, 38092270031264504, 226491313, 226491321, 8, 1440x900 
0x37CA2318, 38092270031936728, 226491378, 226491386, 8, 1440x900 
0x37CA2318, 38092270032605952, 226491447, 226491454, 7, 1440x900 
0x37CA2318, 38092270033265624, 226491512, 226491519, 7, 1440x900 
0x37CA2318, 38092270033935080, 226491577, 226491585, 8, 1440x900 
0x37CA2318, 38092270034604904, 226491647, 226491654, 7, 1440x900 
0x37CA2318, 38092270035256904, 226491712, 226491719, 7, 1440x900 
0x37CA2318, 38092270035916320, 226491778, 226491785, 7, 1440x900 
0x37CA2318, 38092270036571200, 226491842, 226491851, 9, 1440x900 
0x37CA2318, 38092270037241680, 226491913, 226491921, 8, 1440x900 
0x37CA2318, 38092270037911032, 226491977, 226491985, 8, 1440x900 
0x37CA2318, 38092270038566872, 226492042, 226492050, 8, 1440x900 
0x37CA2318, 38092270039236320, 226492107, 226492116, 9, 1440x900 
0x37CA2318, 38092270039896016, 226492177, 226492184, 7, 1440x900 
0x37CA2318, 38092270040556048, 226492242, 226492248, 6, 1440x900 
0x37CA2318, 38092270041214136, 226492308, 226492315, 7, 1440x900 
0x37CA2318, 38092270041876384, 226492373, 226492381, 8, 1440x900 
0x37CA2318, 38092270042546936, 226492442, 226492450, 8, 1440x900 
0x37CA2318, 38092270043199008, 226492507, 226492514, 7, 1440x900 
0x37CA2318, 38092270043857656, 226492579, 226492587, 8, 1440x900 
0x37CA2318, 38092270044521216, 226492639, 226492647, 8, 1440x900 
0x37CA2318, 38092270045174608, 226492708, 226492715, 7, 1440x900 
0x37CA2318, 38092270045846992, 226492772, 226492780, 8, 1440x900 
0x37CA2318, 38092270046499560, 226492837, 226492846, 9, 1440x900 
0x37CA2318, 38092270047151616, 226492907, 226492915, 8, 1440x900 
0x37CA2318, 38092270047818136, 226492972, 226492980, 8, 1440x900 
0x37CA2318, 38092270048479704, 226493038, 226493046, 8, 1440x900 
0x37CA2318, 38092270049148600, 226493107, 226493115, 8, 1440x900 
0x37CA2318, 38092270049809400, 226493168, 226493176, 8, 1440x900 
0x37CA2318, 38092270050461472, 226493232, 226493239, 7, 1440x900 
0x37CA2318, 38092270051128928, 226493301, 226493309, 8, 1440x900 
0x37CA2318, 38092270051789712, 226493367, 226493375, 8, 1440x900 
0x37CA2318, 38092270052439144, 226493433, 226493440, 7, 1440x900 
0x37CA2318, 38092270053101840, 226493497, 226493504, 7, 1440x900 
0x37CA2318, 38092270053762656, 226493562, 226493569, 7, 1440x900 
0x37CA2318, 38092270054422064, 226493628, 226493635, 7, 1440x900 
0x37CA2318, 38092270055084928, 226493697, 226493705, 8, 1440x900 
0x37CA2318, 38092270055744208, 226493763, 226493771, 8, 1440x900 
0x37CA2318, 38092270056412936, 226493828, 226493835, 7, 1440x900 
0x37CA2318, 38092270057064488, 226493893, 226493902, 9, 1440x900 
0x37CA2318, 38092270057725792, 226493962, 226493970, 8, 1440x900 
0x37CA2318, 38092270058378456, 226494028, 226494036, 8, 1440x900 
0x37CA2318, 38092270059045864, 226494092, 226494099, 7, 1440x900 
0x37CA2318, 38092270059697152, 226494156, 226494163, 7, 1440x900 
0x37CA2318, 38092270060368040, 226494224, 226494232, 8, 1440x900 
0x37CA2318, 38092270061025568, 226494292, 226494300, 8, 1440x900 
0x37CA2318, 38092270061689688, 226494358, 226494366, 8, 1440x900 
0x37CA2318, 38092270062358960, 226494427, 226494435, 8, 1440x900 
0x37CA2318, 38092270063673872, 226494557, 226494565, 8, 1440x900 
0x37CA2318, 38092270064325720, 226494623, 226494631, 8, 1440x900 
0x37CA2318, 38092270064994232, 226494689, 226494697, 8, 1440x900 
0x37CA2318, 38092270065655832, 226494752, 226494760, 8, 1440x900 
0x37CA2318, 38092270066316128, 226494818, 226494827, 9, 1440x900 
0x37CA2318, 38092270066984992, 226494889, 226494897, 8, 1440x900 
0x37CA2318, 38092270067645720, 226494953, 226494961, 8, 1440x900 
0x37CA2318, 38092270068297816, 226495017, 226495025, 8, 1440x900 
0x37CA2318, 38092270068959584, 226495083, 226495092, 9, 1440x900 
0x37CA2318, 38092270069612304, 226495148, 226495157, 9, 1440x900 
0x37CA2318, 38092270070290416, 226495217, 226495225, 8, 1440x900 
0x37CA2318, 38092270070952192, 226495283, 226495291, 8, 1440x900 
0x37CA2318, 38092270071600832, 226495352, 226495360, 8, 1440x900 
0x37CA2318, 38092270072263760, 226495417, 226495425, 8, 1440x900 
0x37CA2318, 38092270072915512, 226495482, 226495490, 8, 1440x900 
0x37CA2318, 38092270073594400, 226495548, 226495556, 8, 1440x900 
0x37CA2318, 38092270074248368, 226495613, 226495621, 8, 1440x900 
0x37CA2318, 38092270074900432, 226495682, 226495690, 8, 1440x900 
0x37CA2318, 38092270075565480, 226495747, 226495755, 8, 1440x900 
0x37CA2318, 38092270076225168, 226495813, 226495821, 8, 1440x900 
0x37CA2318, 38092270076881904, 226495878, 226495886, 8, 1440x900 
0x37CA2318, 38092270077543984, 226495944, 226495951, 7, 1440x900 
0x37CA2318, 38092270078215664, 226496008, 226496017, 9, 1440x900 
0x37CA2318, 38092270078876744, 226496078, 226496086, 8, 1440x900 
0x37CA2318, 38092270079533528, 226496142, 226496150, 8, 1440x900 
0x37CA2318, 38092270080212240, 226496209, 226496219, 10, 1440x900 
0x37CA2318, 38092270080863944, 226496273, 226496280, 7, 1440x900 
0x37CA2318, 38092270081524328, 226496343, 226496352, 9, 1440x900 
0x37CA2318, 38092270082185816, 226496407, 226496415, 8, 1440x900 
0x37CA2318, 38092270082854728, 226496474, 226496482, 8, 1440x900 
0x37CA2318, 38092270083510968, 226496541, 226496549, 8, 1440x900 
0x37CA2318, 38092270084177168, 226496608, 226496616, 8, 1440x900 
0x37CA2318, 38092270084827768, 226496673, 226496681, 8, 1440x900 
0x37CA2318, 38092270085488152, 226496738, 226496746, 8, 1440x900 
0x37CA2318, 38092270086143664, 226496802, 226496810, 8, 1440x900 
0x37CA2318, 38092270086814376, 226496868, 226496877, 9, 1440x900 
0x37CA2318, 38092270087480528, 226496937, 226496945, 8, 1440x900 
0x37CA2318, 38092270088132912, 226497003, 226497010, 7, 1440x900 
0x37CA2318, 38092270088786200, 226497067, 226497075, 8, 1440x900 
0x37CA2318, 38092270089458168, 226497137, 226497145, 8, 1440x900 
0x37CA2318, 38092270090124944, 226497203, 226497211, 8, 1440x900 
0x37CA2318, 38092270090779224, 226497263, 226497272, 9, 1440x900 
0x37CA2318, 38092270091446336, 226497332, 226497340, 8, 1440x900 
0x37CA2318, 38092270092103312, 226497398, 226497406, 8, 1440x900 
0x37CA2318, 38092270092764624, 226497463, 226497472, 9, 1440x900 
0x37CA2318, 38092270093424320, 226497532, 226497540, 8, 1440x900 
0x37CA2318, 38092270094085064, 226497597, 226497605, 8, 1440x900 
0x37CA2318, 38092270094750096, 226497667, 226497675, 8, 1440x900 
0x37CA2318, 38092270095410384, 226497732, 226497740, 8, 1440x900 
0x37CA2318, 38092270096061608, 226497797, 226497805, 8, 1440x900 
0x37CA2318, 38092270096727912, 226497863, 226497871, 8, 1440x900 
0x37CA2318, 38092270097390944, 226497927, 226497935, 8, 1440x900 
0x37CA2318, 38092270098059360, 226497997, 226498005, 8, 1440x900 
0x37CA2318, 38092270098718888, 226498058, 226498067, 9, 1440x900 
0x37CA2318, 38092270099370504, 226498127, 226498135, 8, 1440x900 
0x37CA2318, 38092270100039512, 226498193, 226498201, 8, 1440x900 
0x37CA2318, 38092270100701712, 226498262, 226498270, 8, 1440x900 
0x37CA2318, 38092270101353888, 226498322, 226498331, 9, 1440x900 
0x37CA2318, 38092270102005416, 226498392, 226498400, 8, 1440x900 
0x37CA2318, 38092270102667808, 226498457, 226498465, 8, 1440x900 
0x37CA2318, 38092270103337720, 226498523, 226498531, 8, 1440x900 
0x37CA2318, 38092270103998512, 226498587, 226498595, 8, 1440x900 
0x37CA2318, 38092270104662808, 226498653, 226498661, 8, 1440x900 
0x37CA2318, 38092270105325320, 226498723, 226498731, 8, 1440x900 
0x37CA2318, 38092270105982544, 226498788, 226498796, 8, 1440x900 
0x37CA2318, 38092270106638904, 226498853, 226498861, 8, 1440x900 
0x37CA2318, 38092270107308336, 226498918, 226498926, 8, 1440x900 
0x37CA2318, 38092270107959696, 226498983, 226498991, 8, 1440x900 
0x37CA2318, 38092270108621424, 226499053, 226499061, 8, 1440x900 
0x37CA2318, 38092270109277008, 226499118, 226499126, 8, 1440x900 
0x37CA2318, 38092270109942464, 226499183, 226499191, 8, 1440x900 
0x37CA2318, 38092270110596928, 226499247, 226499255, 8, 1440x900 
0x37CA2318, 38092270111270728, 226499318, 226499326, 8, 1440x900 
0x37CA2318, 38092270111925032, 226499382, 226499391, 9, 1440x900 
0x37CA2318, 38092270112585136, 226499447, 226499454, 7, 1440x900 
0x37CA2318, 38092270113236896, 226499513, 226499521, 8, 1440x900 
0x37CA2318, 38092270113908736, 226499578, 226499586, 8, 1440x900 
0x37CA2318, 38092270114570872, 226499643, 226499652, 9, 1440x900 
0x37CA2318, 38092270115229016, 226499713, 226499721, 8, 1440x900 
0x37CA2318, 38092270115894464, 226499779, 226499787, 8, 1440x900 
0x37CA2318, 38092270116551824, 226499847, 226499855, 8, 1440x900 
0x37CA2318, 38092270117210584, 226499907, 226499916, 9, 1440x900 
0x37CA2318, 38092270117865976, 226499973, 226499982, 9, 1440x900 
0x37CA2318, 38092270118539576, 226500043, 226500051, 8, 1440x900 
0x37CA2318, 38092270119187704, 226500107, 226500115, 8, 1440x900 
0x37CA2318, 38092270119850688, 226500172, 226500180, 8, 1440x900 
0x37CA2318, 38092270120519112, 226500242, 226500250, 8, 1440x900 
0x37CA2318, 38092270121188216, 226500307, 226500314, 7, 1440x900 
0x37CA2318, 38092270121833256, 226500371, 226500379, 8, 1440x900 
0x37CA2318, 38092270122495752, 226500437, 226500446, 9, 1440x900 
0x37CA2318, 38092270123167880, 226500508, 226500516, 8, 1440x900 
0x37CA2318, 38092270123828000, 226500573, 226500581, 8, 1440x900 
0x37CA2318, 38092270124488480, 226500637, 226500645, 8, 1440x900 
0x37CA2318, 38092270125151424, 226500702, 226500710, 8, 1440x900 
0x37CA2318, 38092270125811064, 226500769, 226500777, 8, 1440x900 
0x37CA2318, 38092270126465448, 226500837, 226500846, 9, 1440x900 
0x37CA2318, 38092270127128840, 226500902, 226500910, 8, 1440x900 
0x37CA2318, 38092270127799448, 226500972, 226500980, 8, 1440x900 
0x37CA2318, 38092270128457352, 226501038, 226501046, 8, 1440x900 
0x37CA2318, 38092270129118064, 226501103, 226501110, 7, 1440x900 
0x37CA2318, 38092270129778816, 226501168, 226501176, 8, 1440x900 
0x37CA2318, 38092270130442160, 226501232, 226501240, 8, 1440x900 
0x37CA2318, 38092270131103464, 226501298, 226501306, 8, 1440x900 
0x37CA2318, 38092270131756080, 226501363, 226501371, 8, 1440x900 
0x37CA2318, 38092270132428424, 226501432, 226501440, 8, 1440x900 
0x37CA2318, 38092270133081328, 226501497, 226501505, 8, 1440x900 
0x37CA2318, 38092270133741848, 226501568, 226501576, 8, 1440x900 
0x37CA2318, 38092270134405152, 226501627, 226501636, 9, 1440x900 
0x37CA2318, 38092270135060000, 226501693, 226501701, 8, 1440x900 
0x37CA2318, 38092270135729344, 226501758, 226501768, 10, 1440x900 
0x37CA2318, 38092270137058608, 226501892, 226501899, 7, 1440x900 
0x37CA2318, 38092270137718352, 226501958, 226501965, 7, 1440x900 
0x37CA2318, 38092270138379208, 226502023, 226502030, 7, 1440x900 
0x37CA2318, 38092270139036696, 226502088, 226502096, 8, 1440x900 
0x37CA2318, 38092270139698792, 226502157, 226502164, 7, 1440x900 
0x37CA2318, 38092270140359336, 226502227, 226502235, 8, 1440x900 
0x37CA2318, 38092270141020104, 226502293, 226502301, 8, 1440x900 
0x37CA2318, 38092270141681576, 226502357, 226502365, 8, 1440x900 
0x37CA2318, 38092270142337712, 226502424, 226502434, 10, 1440x900 
0x37CA2318, 38092270142812840, 226502472, 226502480, 8, 1440x900 
0x37CA2318, 38092270143662688, 226502554, 226502562, 8, 1440x900 
0x37CA2318, 38092270144330960, 226502617, 226502627, 10, 1440x900 
0x37CA2318, 38092270144788016, 226502662, 226502670, 8, 1440x900 
0x37CA2318, 38092270145644672, 226502752, 226502758, 6, 1440x900 
0x37CA2318, 38092270146310080, 226502817, 226502824, 7, 1440x900 
0x37CA2318, 38092270146961296, 226502887, 226502894, 7, 1440x900 
0x37CA2318, 38092270147623496, 226502948, 226502956, 8, 1440x900 
0x37CA2318, 38092270148293440, 226503018, 226503026, 8, 1440x900 
0x37CA2318, 38092270148956208, 226503083, 226503091, 8, 1440x900 
0x37CA2318, 38092270149609200, 226503148, 226503156, 8, 1440x900 
0x37CA2318, 38092270150274840, 226503218, 226503225, 7, 1440x900 
0x37CA2318, 38092270150936096, 226503283, 226503291, 8, 1440x900 
0x37CA2318, 38092270151598936, 226503349, 226503357, 8, 1440x900 
0x37CA2318, 38092270152251672, 226503411, 226503419, 8, 1440x900 
0x37CA2318, 38092270152921408, 226503482, 226503490, 8, 1440x900 
0x37CA2318, 38092270153590616, 226503547, 226503555, 8, 1440x900 
0x37CA2318, 38092270154248192, 226503612, 226503620, 8, 1440x900 
0x37CA2318, 38092270154906920, 226503693, 226503701, 8, 1440x900 
0x37CA2318, 38092270155443328, 226503732, 226503739, 7, 1440x900 
0x37CA2318, 38092270156039320, 226503788, 226503796, 8, 1440x900 
0x37CA2318, 38092270156900504, 226503876, 226503884, 8, 1440x900 
0x37CA2318, 38092270157560760, 226503947, 226503955, 8, 1440x900 
0x37CA2318, 38092270158212320, 226504008, 226504017, 9, 1440x900 
0x37CA2318, 38092270158881792, 226504077, 226504085, 8, 1440x900 
0x37CA2318, 38092270159550792, 226504143, 226504151, 8, 1440x900 
0x37CA2318, 38092270160202376, 226504206, 226504213, 7, 1440x900 
0x37CA2318, 38092270160861408, 226504277, 226504285, 8, 1440x900 
0x37CA2318, 38092270161522376, 226504342, 226504350, 8, 1440x900 
0x37CA2318, 38092270162179792, 226504408, 226504416, 8, 1440x900 
0x37CA2318, 38092270162845400, 226504472, 226504481, 9, 1440x900 
0x37CA2318, 38092270163508368, 226504543, 226504551, 8, 1440x900 
0x37CA2318, 38092270164168704, 226504603, 226504612, 9, 1440x900 
0x37CA2318, 38092270164830232, 226504673, 226504681, 8, 1440x900 
0x37CA2318, 38092270165495024, 226504743, 226504751, 8, 1440x900 
0x37CA2318, 38092270166151152, 226504802, 226504810, 8, 1440x900 
0x37CA2318, 38092270166812080, 226504867, 226504875, 8, 1440x900 
0x37CA2318, 38092270167481680, 226504936, 226504944, 8, 1440x900 
0x37CA2318, 38092270168131992, 226505002, 226505010, 8, 1440x900 
0x37CA2318, 38092270168794288, 226505069, 226505077, 8, 1440x900 
0x37CA2318, 38092270169454344, 226505133, 226505141, 8, 1440x900 
0x37CA2318, 38092270170110488, 226505198, 226505207, 9, 1440x900 
0x37CA2318, 38092270170777144, 226505268, 226505276, 8, 1440x900 
0x37CA2318, 38092270171430552, 226505333, 226505341, 8, 1440x900 
0x37CA2318, 38092270172102336, 226505402, 226505411, 9, 1440x900 
0x37CA2318, 38092270172753328, 226505462, 226505471, 9, 1440x900 
0x37CA2318, 38092270173415512, 226505528, 226505535, 7, 1440x900 
0x37CA2318, 38092270174095008, 226505598, 226505606, 8, 1440x900 
0x37CA2318, 38092270174746056, 226505667, 226505675, 8, 1440x900 
0x37CA2318, 38092270175408656, 226505729, 226505737, 8, 1440x900 
0x37CA2318, 38092270176069264, 226505798, 226505805, 7, 1440x900 
0x37CA2318, 38092270176730840, 226505858, 226505866, 8, 1440x900 
0x37CA2318, 38092270177382648, 226505923, 226505932, 9, 1440x900 
0x37CA2318, 38092270178051888, 226505992, 226506001, 9, 1440x900 
0x37CA2318, 38092270178720496, 226506062, 226506070, 8, 1440x900 
0x37CA2318, 38092270179371984, 226506123, 226506132, 9, 1440x900 
0x37CA2318, 38092270180026088, 226506192, 226506200, 8, 1440x900 
0x37CA2318, 38092270180691888, 226506258, 226506266, 8, 1440x900 
0x37CA2318, 38092270181353696, 226506322, 226506331, 9, 1440x900 
0x37CA2318, 38092270182015944, 226506388, 226506397, 9, 1440x900 
0x37CA2318, 38092270182675176, 226506453, 226506461, 8, 1440x900 
0x37CA2318, 38092270183335616, 226506523, 226506531, 8, 1440x900 
0x37CA2318, 38092270183994024, 226506589, 226506596, 7, 1440x900 
0x37CA2318, 38092270184656112, 226506657, 226506665, 8, 1440x900 
0x37CA2318, 38092270185324928, 226506724, 226506731, 7, 1440x900 
0x37CA2318, 38092270185986904, 226506787, 226506795, 8, 1440x900 
0x37CA2318, 38092270186649072, 226506853, 226506861, 8, 1440x900 
0x37CA2318, 38092270187297752, 226506917, 226506924, 7, 1440x900 
0x37CA2318, 38092270187959992, 226506982, 226506989, 7, 1440x900 
0x37CA2318, 38092270188625232, 226507053, 226507061, 8, 1440x900 
0x37CA2318, 38092270189290640, 226507117, 226507125, 8, 1440x900 
0x37CA2318, 38092270189946136, 226507182, 226507190, 8, 1440x900 
0x37CA2318, 38092270190599512, 226507248, 226507256, 8, 1440x900 
0x37CA2318, 38092270191262048, 226507317, 226507325, 8, 1440x900 
0x37CA2318, 38092270191930648, 226507382, 226507390, 8, 1440x900 
0x37CA2318, 38092270192591808, 226507448, 226507455, 7, 1440x900 
0x37CA2318, 38092270193258232, 226507512, 226507519, 7, 1440x900 
0x37CA2318, 38092270193918560, 226507583, 226507591, 8, 1440x900 
0x37CA2318, 38092270194580768, 226507647, 226507655, 8, 1440x900 
0x37CA2318, 38092270195234560, 226507714, 226507722, 8, 1440x900 
0x37CA2318, 38092270195911760, 226507783, 226507791, 8, 1440x900 
0x37CA2318, 38092270196565496, 226507849, 226507857, 8, 1440x900 
0x37CA2318, 38092270197224464, 226507913, 226507921, 8, 1440x900 
0x37CA2318, 38092270197892920, 226507978, 226507986, 8, 1440x900 
0x37CA2318, 38092270198547200, 226508043, 226508051, 8, 1440x900 
0x37CA2318, 38092270199209584, 226508108, 226508117, 9, 1440x900 
0x37CA2318, 38092270199871192, 226508178, 226508186, 8, 1440x900 
0x37CA2318, 38092270200530368, 226508243, 226508251, 8, 1440x900 
0x37CA2318, 38092270201194624, 226508308, 226508316, 8, 1440x900 
0x37CA2318, 38092270201852704, 226508373, 226508382, 9, 1440x900 
0x37CA2318, 38092270202512248, 226508438, 226508446, 8, 1440x900 
0x37CA2318, 38092270203174728, 226508509, 226508517, 8, 1440x900 
0x37CA2318, 38092270203833968, 226508572, 226508580, 8, 1440x900 
0x37CA2318, 38092270204492824, 226508637, 226508645, 8, 1440x900 
0x37CA2318, 38092270205152560, 226508702, 226508711, 9, 1440x900 
0x37CA2318, 38092270205819280, 226508769, 226508777, 8, 1440x900 
0x37CA2318, 38092270206474808, 226508837, 226508846, 9, 1440x900 
0x37CA2318, 38092270207134728, 226508903, 226508911, 8, 1440x900 
0x37CA2318, 38092270207803536, 226508964, 226508972, 8, 1440x900 
0x37CA2318, 38092270208463392, 226509032, 226509039, 7, 1440x900 
0x37CA2318, 38092270209132856, 226509097, 226509104, 7, 1440x900 
0x37CA2318, 38092270209792552, 226509167, 226509174, 7, 1440x900 
0x37CA2318, 38092270210462080, 226509232, 226509239, 7, 1440x900 
0x37CA2318, 38092270211121680, 226509297, 226509305, 8, 1440x900 
0x37CA2318, 38092270211781120, 226509362, 226509370, 8, 1440x900 
0x37CA2318, 38092270212431888, 226509428, 226509435, 7, 1440x900 
0x37CA2318, 38092270213102848, 226509497, 226509505, 8, 1440x900 
0x37CA2318, 38092270213755728, 226509567, 226509575, 8, 1440x900 
0x37CA2318, 38092270214415360, 226509633, 226509641, 8, 1440x900 
0x37CA2318, 38092270215066888, 226509697, 226509705, 8, 1440x900 
0x37CA2318, 38092270215730896, 226509763, 226509771, 8, 1440x900 
0x37CA2318, 38092270216403376, 226509827, 226509836, 9, 1440x900 
0x37CA2318, 38092270217724576, 226509963, 226509971, 8, 1440x900 
0x37CA2318, 38092270218375968, 226510029, 226510037, 8, 1440x900 
0x37CA2318, 38092270219046176, 226510093, 226510102, 9, 1440x900 
0x37CA2318, 38092270219706608, 226510158, 226510166, 8, 1440x900 
0x37CA2318, 38092270220368816, 226510227, 226510235, 8, 1440x900 
0x37CA2318, 38092270221028472, 226510292, 226510300, 8, 1440x900 
0x37CA2318, 38092270221698512, 226510357, 226510365, 8, 1440x900 
0x37CA2318, 38092270222351960, 226510422, 226510431, 9, 1440x900 
0x37CA2318, 38092270223003272, 226510492, 226510500, 8, 1440x900 
0x37CA2318, 38092270223682472, 226510558, 226510566, 8, 1440x900 
0x37CA2318, 38092270224332776, 226510622, 226510630, 8, 1440x900 
0x37CA2318, 38092270224993408, 226510687, 226510695, 8, 1440x900 
0x37CA2318, 38092270225659056, 226510757, 226510765, 8, 1440x900 
0x37CA2318, 38092270226310840, 226510822, 226510830, 8, 1440x900 
0x37CA2318, 38092270226981616, 226510888, 226510896, 8, 1440x900 
0x37CA2318, 38092270227641904, 226510953, 226510961, 8, 1440x900 
0x37CA2318, 38092270228307200, 226511022, 226511030, 8, 1440x900 
0x37CA2318, 38092270228959968, 226511083, 226511091, 8, 1440x900 
0x37CA2318, 38092270229638144, 226511152, 226511159, 7, 1440x900 
0x37CA2318, 38092270230299312, 226511217, 226511224, 7, 1440x900 
0x37CA2318, 38092270230958848, 226511282, 226511289, 7, 1440x900 
0x37CA2318, 38092270231614936, 226511353, 226511361, 8, 1440x900 
0x37CA2318, 38092270232266976, 226511418, 226511426, 8, 1440x900 
0x37CA2318, 38092270232936216, 226511482, 226511490, 8, 1440x900 
0x37CA2318, 38092270233589536, 226511547, 226511554, 7, 1440x900 
0x37CA2318, 38092270234250440, 226511613, 226511621, 8, 1440x900 
0x37CA2318, 38092270234913408, 226511682, 226511690, 8, 1440x900 
0x37CA2318, 38092270235570696, 226511748, 226511756, 8, 1440x900 
0x37CA2318, 38092270236233432, 226511813, 226511821, 8, 1440x900 
0x37CA2318, 38092270236902448, 226511882, 226511890, 8, 1440x900 
0x37CA2318, 38092270237555304, 226511947, 226511955, 8, 1440x900 
0x37CA2318, 38092270238218904, 226512012, 226512020, 8, 1440x900 
0x37CA2318, 38092270238885288, 226512077, 226512084, 7, 1440x900 
0x37CA2318, 38092270239544216, 226512143, 226512151, 8, 1440x900 
0x37CA2318, 38092270240205424, 226512207, 226512214, 7, 1440x900 
0x37CA2318, 38092270240858312, 226512272, 226512279, 7, 1440x900 
0x37CA2318, 38092270241521704, 226512339, 226512348, 9, 1440x900 
0x37CA2318, 38092270242197008, 226512413, 226512421, 8, 1440x900 
0x37CA2318, 38092270242859336, 226512473, 226512481, 8, 1440x900 
0x37CA2318, 38092270243504432, 226512543, 226512551, 8, 1440x900 
0x37CA2318, 38092270244174376, 226512603, 226512611, 8, 1440x900 
0x37CA2318, 38092270244840984, 226512672, 226512680, 8, 1440x900 
0x37CA2318, 38092270245495144, 226512737, 226512745, 8, 1440x900 
0x37CA2318, 38092270246146896, 226512802, 226512810, 8, 1440x900 
0x37CA2318, 38092270246826392, 226512872, 226512880, 8, 1440x900 
0x37CA2318, 38092270247486448, 226512937, 226512945, 8, 1440x900 
0x37CA2318, 38092270248138848, 226513002, 226513010, 8, 1440x900 
0x37CA2318, 38092270248805360, 226513072, 226513080, 8, 1440x900 
0x37CA2318, 38092270249459576, 226513137, 226513145, 8, 1440x900 
0x37CA2318, 38092270250124872, 226513203, 226513211, 8, 1440x900 
0x37CA2318, 38092270250778168, 226513267, 226513274, 7, 1440x900 
0x37CA2318, 38092270251440008, 226513332, 226513340, 8, 1440x900 
0x37CA2318, 38092270252108528, 226513403, 226513411, 8, 1440x900 
0x37CA2318, 38092270252767552, 226513467, 226513475, 8, 1440x900 
0x37CA2318, 38092270253422912, 226513533, 226513540, 7, 1440x900 
0x37CA2318, 38092270254082272, 226513593, 226513601, 8, 1440x900 
0x37CA2318, 38092270254738632, 226513661, 226513668, 7, 1440x900 
0x37CA2318, 38092270255410416, 226513727, 226513735, 8, 1440x900 
0x37CA2318, 38092270256062960, 226513792, 226513799, 7, 1440x900 
0x37CA2318, 38092270256732024, 226513862, 226513870, 8, 1440x900 
0x37CA2318, 38092270257394800, 226513933, 226513941, 8, 1440x900 
0x37CA2318, 38092270258046448, 226513993, 226514001, 8, 1440x900 
0x37CA2318, 38092270258708680, 226514062, 226514070, 8, 1440x900 
0x37CA2318, 38092270259378864, 226514127, 226514135, 8, 1440x900 
0x37CA2318, 38092270260040016, 226514193, 226514201, 8, 1440x900 
0x37CA2318, 38092270260691832, 226514258, 226514266, 8, 1440x900 
0x37CA2318, 38092270261364504, 226514329, 226514337, 8, 1440x900 
0x37CA2318, 38092270262014968, 226514393, 226514401, 8, 1440x900 
0x37CA2318, 38092270262677064, 226514457, 226514465, 8, 1440x900 
0x37CA2318, 38092270263337304, 226514527, 226514535, 8, 1440x900 
0x37CA2318, 38092270263998680, 226514590, 226514598, 8, 1440x900 
0x37CA2318, 38092270264659816, 226514657, 226514665, 8, 1440x900 
0x37CA2318, 38092270265313144, 226514718, 226514727, 9, 1440x900 
0x37CA2318, 38092270265981672, 226514787, 226514795, 8, 1440x900 
0x37CA2318, 38092270266634632, 226514854, 226514862, 8, 1440x900 
0x37CA2318, 38092270267313728, 226514918, 226514926, 8, 1440x900 
0x37CA2318, 38092270267973488, 226514984, 226514992, 8, 1440x900 
0x37CA2318, 38092270268634704, 226515053, 226515061, 8, 1440x900 
0x37CA2318, 38092270269285632, 226515118, 226515126, 8, 1440x900 
0x37CA2318, 38092270269945408, 226515183, 226515191, 8, 1440x900 
0x37CA2318, 38092270270607488, 226515248, 226515256, 8, 1440x900 
0x37CA2318, 38092270271269536, 226515313, 226515322, 9, 1440x900 
0x37CA2318, 38092270271929232, 226515383, 226515391, 8, 1440x900 
0x37CA2318, 38092270272590520, 226515447, 226515455, 8, 1440x900 
0x37CA2318, 38092270273250936, 226515513, 226515521, 8, 1440x900 
0x37CA2318, 38092270273920224, 226515578, 226515587, 9, 1440x900 
0x37CA2318, 38092270274580664, 226515647, 226515655, 8, 1440x900 
0x37CA2318, 38092270275243368, 226515713, 226515721, 8, 1440x900 
0x37CA2318, 38092270275896392, 226515778, 226515786, 8, 1440x900 
0x37CA2318, 38092270276575208, 226515847, 226515855, 8, 1440x900 
0x37CA2318, 38092270277235568, 226515913, 226515921, 8, 1440x900 
0x37CA2318, 38092270277898848, 226515978, 226515985, 7, 1440x900 
0x37CA2318, 38092270278559344, 226516042, 226516051, 9, 1440x900 
0x37CA2318, 38092270279210120, 226516107, 226516116, 9, 1440x900 
0x37CA2318, 38092270279880256, 226516177, 226516185, 8, 1440x900 
0x37CA2318, 38092270280540424, 226516243, 226516251, 8, 1440x900 
0x37CA2318, 38092270281194496, 226516313, 226516321, 8, 1440x900 
0x37CA2318, 38092270281858640, 226516374, 226516383, 9, 1440x900 
0x37CA2318, 38092270282527344, 226516438, 226516446, 8, 1440x900 
0x37CA2318, 38092270283189416, 226516507, 226516515, 8, 1440x900 
0x37CA2318, 38092270283840720, 226516572, 226516580, 8, 1440x900 
0x37CA2318, 38092270284511552, 226516642, 226516650, 8, 1440x900 
0x37CA2318, 38092270285163232, 226516707, 226516715, 8, 1440x900 
0x37CA2318, 38092270285825568, 226516773, 226516780, 7, 1440x900 
0x37CA2318, 38092270286486216, 226516838, 226516847, 9, 1440x900 
0x37CA2318, 38092270287139632, 226516903, 226516911, 8, 1440x900 
0x37CA2318, 38092270287804672, 226516972, 226516980, 8, 1440x900 
0x37CA2318, 38092270288466960, 226517038, 226517046, 8, 1440x900 
0x37CA2318, 38092270289119808, 226517103, 226517111, 8, 1440x900 
0x37CA2318, 38092270289798880, 226517168, 226517176, 8, 1440x900 
0x37CA2318, 38092270290451632, 226517232, 226517240, 8, 1440x900 
0x37CA2318, 38092270291112464, 226517302, 226517310, 8, 1440x900 
0x37CA2318, 38092270291766560, 226517363, 226517372, 9, 1440x900 
0x37CA2318, 38092270292436432, 226517433, 226517441, 8, 1440x900 
0x37CA2318, 38092270293097992, 226517503, 226517511, 8, 1440x900 
0x37CA2318, 38092270293759704, 226517563, 226517571, 8, 1440x900 
0x37CA2318, 38092270294412216, 226517633, 226517641, 8, 1440x900 
0x37CA2318, 38092270295081568, 226517693, 226517701, 8, 1440x900 
0x37CA2318, 38092270295741696, 226517763, 226517771, 8, 1440x900 
0x37CA2318, 38092270296405152, 226517828, 226517836, 8, 1440x900 
0x37CA2318, 38092270297721648, 226517963, 226517971, 8, 1440x900 
0x37CA2318, 38092270298384840, 226518028, 226518036, 8, 1440x900 
0x37CA2318, 38092270299044176, 226518092, 226518100, 8, 1440x900 
0x37CA2318, 38092270299704784, 226518162, 226518170, 8, 1440x900 
0x37CA2318, 38092270300368128, 226518227, 226518235, 8, 1440x900 
0x37CA2318, 38092270301025952, 226518292, 226518300, 8, 1440x900 
0x37CA2318, 38092270301687960, 226518358, 226518366, 8, 1440x900 
0x37CA2318, 38092270302345912, 226518422, 226518431, 9, 1440x900 
0x37CA2318, 38092270303007488, 226518487, 226518496, 9, 1440x900 
0x37CA2318, 38092270303669112, 226518557, 226518565, 8, 1440x900 
0x37CA2318, 38092270304328864, 226518623, 226518631, 8, 1440x900 
0x37CA2318, 38092270304988608, 226518687, 226518695, 8, 1440x900 
0x37CA2318, 38092270305650280, 226518752, 226518760, 8, 1440x900 
0x37CA2318, 38092270306314456, 226518819, 226518826, 7, 1440x900 
0x37CA2318, 38092270306982112, 226518883, 226518892, 9, 1440x900 
0x37CA2318, 38092270307636104, 226518953, 226518961, 8, 1440x900 
0x37CA2318, 38092270308289864, 226519017, 226519025, 8, 1440x900 
0x37CA2318, 38092270308957888, 226519087, 226519095, 8, 1440x900 
0x37CA2318, 38092270309608616, 226519149, 226519157, 8, 1440x900 
0x37CA2318, 38092270310279552, 226519218, 226519226, 8, 1440x900 
0x37CA2318, 38092270310942416, 226519283, 226519291, 8, 1440x900 
0x37CA2318, 38092270311594808, 226519347, 226519355, 8, 1440x900 
0x37CA2318, 38092270312265080, 226519418, 226519426, 8, 1440x900 
0x37CA2318, 38092270312926336, 226519483, 226519491, 8, 1440x900 
0x37CA2318, 38092270313594048, 226519547, 226519556, 9, 1440x900 
0x37CA2318, 38092270314238736, 226519613, 226519621, 8, 1440x900 
0x37CA2318, 38092270314900640, 226519677, 226519685, 8, 1440x900 
0x37CA2318, 38092270315569320, 226519743, 226519750, 7, 1440x900 
0x37CA2318, 38092270316229512, 226519812, 226519820, 8, 1440x900 
0x37CA2318, 38092270316898280, 226519878, 226519886, 8, 1440x900 
0x37CA2318, 38092270317560368, 226519943, 226519952, 9, 1440x900 
0x37CA2318, 38092270318210288, 226520012, 226520020, 8, 1440x900 
0x37CA2318, 38092270318877792, 226520077, 226520085, 8, 1440x900 
0x37CA2318, 38092270319533056, 226520142, 226520150, 8, 1440x900 
0x37CA2318, 38092270320185368, 226520208, 226520216, 8, 1440x900 
0x37CA2318, 38092270320864944, 226520274, 226520282, 8, 1440x900 
0x37CA2318, 38092270321509088, 226520338, 226520346, 8, 1440x900 
0x37CA2318, 38092270322184528, 226520408, 226520416, 8, 1440x900 
0x37CA2318, 38092270322835616, 226520473, 226520481, 8, 1440x900 
0x37CA2318, 38092270323505000, 226520539, 226520547, 8, 1440x900 
0x37CA2318, 38092270324156224, 226520603, 226520611, 8, 1440x900 
0x37CA2318, 38092270324817136, 226520668, 226520677, 9, 1440x900 
0x37CA2318, 38092270325471056, 226520733, 226520740, 7, 1440x900 
0x37CA2318, 38092270326147176, 226520807, 226520815, 8, 1440x900 
0x37CA2318, 38092270326799560, 226520872, 226520880, 8, 1440x900 
0x37CA2318, 38092270327459168, 226520937, 226520945, 8, 1440x900 
0x37CA2318, 38092270328120624, 226520998, 226521007, 9, 1440x900 
0x37CA2318, 38092270328774752, 226521068, 226521076, 8, 1440x900 
0x37CA2318, 38092270329438624, 226521132, 226521140, 8, 1440x900 
0x37CA2318, 38092270330109104, 226521198, 226521206, 8, 1440x900 
0x37CA2318, 38092270330768704, 226521267, 226521275, 8, 1440x900 
0x37CA2318, 38092270331428896, 226521333, 226521341, 8, 1440x900 
0x37CA2318, 38092270332090608, 226521399, 226521407, 8, 1440x900 
0x37CA2318, 38092270332748000, 226521462, 226521470, 8, 1440x900 
0x37CA2318, 38092270333412672, 226521532, 226521540, 8, 1440x900 
0x37CA2318, 38092270334069296, 226521597, 226521604, 7, 1440x900 
0x37CA2318, 38092270334740328, 226521662, 226521670, 8, 1440x900 
0x37CA2318, 38092270335401968, 226521728, 226521737, 9, 1440x900 
0x37CA2318, 38092270336052568, 226521792, 226521800, 8, 1440x900 
0x37CA2318, 38092270336731016, 226521858, 226521865, 7, 1440x900 
0x37CA2318, 38092270337386240, 226521928, 226521935, 7, 1440x900 
0x37CA2318, 38092270338039984, 226521993, 226522001, 8, 1440x900 
0x37CA2318, 38092270338703120, 226522057, 226522065, 8, 1440x900 
0x37CA2318, 38092270339374184, 226522123, 226522132, 9, 1440x900 
0x37CA2318, 38092270340035944, 226522192, 226522201, 9, 1440x900 
0x37CA2318, 38092270340690848, 226522258, 226522266, 8, 1440x900 
0x37CA2318, 38092270341361824, 226522328, 226522335, 7, 1440x900 
0x37CA2318, 38092270342025328, 226522388, 226522396, 8, 1440x900 
0x37CA2318, 38092270342688096, 226522457, 226522465, 8, 1440x900 
0x37CA2318, 38092270343357488, 226522527, 226522535, 8, 1440x900 
0x37CA2318, 38092270344008480, 226522588, 226522597, 9, 1440x900 
0x37CA2318, 38092270344670384, 226522658, 226522666, 8, 1440x900 
0x37CA2318, 38092270345332328, 226522722, 226522730, 8, 1440x900 
0x37CA2318, 38092270345992128, 226522787, 226522795, 8, 1440x900 
0x37CA2318, 38092270346662168, 226522857, 226522865, 8, 1440x900 
0x37CA2318, 38092270347312352, 226522923, 226522931, 8, 1440x900 
0x37CA2318, 38092270347974216, 226522987, 226522995, 8, 1440x900 
0x37CA2318, 38092270348635448, 226523053, 226523061, 8, 1440x900 
0x37CA2318, 38092270349288448, 226523117, 226523125, 8, 1440x900 
0x37CA2318, 38092270349958184, 226523183, 226523191, 8, 1440x900 
0x37CA2318, 38092270350618696, 226523253, 226523261, 8, 1440x900 
0x37CA2318, 38092270351278384, 226523318, 226523326, 8, 1440x900 
0x37CA2318, 38092270351939232, 226523382, 226523390, 8, 1440x900 
0x37CA2318, 38092270352606624, 226523448, 226523456, 8, 1440x900 
0x37CA2318, 38092270353258928, 226523517, 226523525, 8, 1440x900 
0x37CA2318, 38092270353938104, 226523582, 226523590, 8, 1440x900 
0x37CA2318, 38092270354588944, 226523647, 226523655, 8, 1440x900 
0x37CA2318, 38092270355251552, 226523717, 226523725, 8, 1440x900 
0x37CA2318, 38092270355901744, 226523779, 226523787, 8, 1440x900 
0x37CA2318, 38092270356570448, 226523848, 226523856, 8, 1440x900 
0x37CA2318, 38092270357230592, 226523913, 226523921, 8, 1440x900 
0x37CA2318, 38092270357881112, 226523973, 226523981, 8, 1440x900 
0x37CA2318, 38092270358552752, 226524042, 226524050, 8, 1440x900 
0x37CA2318, 38092270359211272, 226524108, 226524116, 8, 1440x900 
0x37CA2318, 38092270359870544, 226524173, 226524182, 9, 1440x900 
0x37CA2318, 38092270360532680, 226524243, 226524251, 8, 1440x900 
0x37CA2318, 38092270361186768, 226524308, 226524316, 8, 1440x900 
0x37CA2318, 38092270361849872, 226524377, 226524386, 9, 1440x900 
0x37CA2318, 38092270362508376, 226524437, 226524446, 9, 1440x900 
0x37CA2318, 38092270363170128, 226524507, 226524515, 8, 1440x900 
0x37CA2318, 38092270363832312, 226524573, 226524581, 8, 1440x900 
0x37CA2318, 38092270364494256, 226524638, 226524646, 8, 1440x900 
0x37CA2318, 38092270365154168, 226524703, 226524711, 8, 1440x900 
0x37CA2318, 38092270365813912, 226524767, 226524777, 10, 1440x900 
0x37CA2318, 38092270366474248, 226524839, 226524847, 8, 1440x900 
0x37CA2318, 38092270367142960, 226524903, 226524911, 8, 1440x900 
0x37CA2318, 38092270367803784, 226524968, 226524977, 9, 1440x900 
0x37CA2318, 38092270368459424, 226525038, 226525046, 8, 1440x900 
0x37CA2318, 38092270369131064, 226525103, 226525111, 8, 1440x900 
0x37CA2318, 38092270369781808, 226525167, 226525175, 8, 1440x900 
0x37CA2318, 38092270370442592, 226525232, 226525241, 9, 1440x900 
0x37CA2318, 38092270371103568, 226525297, 226525305, 8, 1440x900 
0x37CA2318, 38092270371764000, 226525367, 226525375, 8, 1440x900 
0x37CA2318, 38092270372426672, 226525432, 226525440, 8, 1440x900 
0x37CA2318, 38092270373089280, 226525497, 226525505, 8, 1440x900 
0x37CA2318, 38092270373744576, 226525563, 226525571, 8, 1440x900 
0x37CA2318, 38092270374420832, 226525628, 226525637, 9, 1440x900 
0x37CA2318, 38092270375083192, 226525698, 226525706, 8, 1440x900 
0x37CA2318, 38092270375743768, 226525763, 226525771, 8, 1440x900 
0x37CA2318, 38092270376404576, 226525829, 226525838, 9, 1440x900 
0x37CA2318, 38092270377064448, 226525893, 226525900, 7, 1440x900 
0x37CA2318, 38092270377725776, 226525962, 226525970, 8, 1440x900 
0x37CA2318, 38092270379042376, 226526092, 226526100, 8, 1440x900 
0x37CA2318, 38092270379713744, 226526157, 226526165, 8, 1440x900 
0x37CA2318, 38092270380371264, 226526227, 226526236, 9, 1440x900 
0x37CA2318, 38092270381026192, 226526292, 226526300, 8, 1440x900 
0x37CA2318, 38092270381697496, 226526358, 226526366, 8, 1440x900 
0x37CA2318, 38092270382358736, 226526427, 226526435, 8, 1440x900 
0x37CA2318, 38092270383013328, 226526488, 226526497, 9, 1440x900 
0x37CA2318, 38092270383680584, 226526557, 226526565, 8, 1440x900 
0x37CA2318, 38092270384341080, 226526622, 226526630, 8, 1440x900 
0x37CA2318, 38092270385002160, 226526687, 226526695, 8, 1440x900 
0x37CA2318, 38092270385656888, 226526758, 226526766, 8, 1440x900 
0x37CA2318, 38092270386319168, 226526823, 226526831, 8, 1440x900 
0x37CA2318, 38092270386989280, 226526888, 226526896, 8, 1440x900 
0x37CA2318, 38092270387650056, 226526952, 226526960, 8, 1440x900 
0x37CA2318, 38092270388313760, 226527018, 226527026, 8, 1440x900 
0x37CA2318, 38092270388971688, 226527087, 226527095, 8, 1440x900 
0x37CA2318, 38092270389632224, 226527153, 226527161, 8, 1440x900 
0x37CA2318, 38092270390292400, 226527217, 226527225, 8, 1440x900 
0x37CA2318, 38092270390950552, 226527282, 226527290, 8, 1440x900 
0x37CA2318, 38092270391618328, 226527352, 226527360, 8, 1440x900 
0x37CA2318, 38092270392287912, 226527418, 226527426, 8, 1440x900 
0x37CA2318, 38092270392938816, 226527482, 226527490, 8, 1440x900 
0x37CA2318, 38092270393595776, 226527552, 226527560, 8, 1440x900 
0x37CA2318, 38092270394262792, 226527613, 226527621, 8, 1440x900 
0x37CA2318, 38092270394926144, 226527683, 226527691, 8, 1440x900 
0x37CA2318, 38092270395589072, 226527747, 226527755, 8, 1440x900 
0x37CA2318, 38092270396254656, 226527813, 226527822, 9, 1440x900 
0x37CA2318, 38092270396913184, 226527882, 226527890, 8, 1440x900 
0x37CA2318, 38092270397566704, 226527943, 226527952, 9, 1440x900 
0x37CA2318, 38092270398227152, 226528013, 226528021, 8, 1440x900 
0x37CA2318, 38092270398887592, 226528077, 226528085, 8, 1440x900 
0x37CA2318, 38092270399549320, 226528144, 226528152, 8, 1440x900 
0x37CA2318, 38092270400206624, 226528212, 226528219, 7, 1440x900 
0x37CA2318, 38092270400868896, 226528278, 226528286, 8, 1440x900 
0x37CA2318, 38092270401522592, 226528338, 226528347, 9, 1440x900 
0x37CA2318, 38092270402194496, 226528408, 226528416, 8, 1440x900 
0x37CA2318, 38092270402857792, 226528473, 226528481, 8, 1440x900 
0x37CA2318, 38092270403508112, 226528538, 226528547, 9, 1440x900 
0x37CA2318, 38092270404177776, 226528608, 226528615, 7, 1440x900 
0x37CA2318, 38092270404839080, 226528672, 226528680, 8, 1440x900 
0x37CA2318, 38092270405503488, 226528742, 226528750, 8, 1440x900 
0x37CA2318, 38092270406156040, 226528807, 226528815, 8, 1440x900 
0x37CA2318, 38092270406828320, 226528872, 226528880, 8, 1440x900 
0x37CA2318, 38092270407478016, 226528938, 226528946, 8, 1440x900 
0x37CA2318, 38092270408140168, 226529002, 226529010, 8, 1440x900 
0x37CA2318, 38092270408799144, 226529067, 226529076, 9, 1440x900 
0x37CA2318, 38092270409460616, 226529137, 226529145, 8, 1440x900 
0x37CA2318, 38092270410115064, 226529199, 226529208, 9, 1440x900 
0x37CA2318, 38092270410782568, 226529267, 226529275, 8, 1440x900 
0x37CA2318, 38092270411443424, 226529333, 226529341, 8, 1440x900 
0x37CA2318, 38092270412097584, 226529402, 226529410, 8, 1440x900 
0x37CA2318, 38092270412769832, 226529463, 226529470, 7, 1440x900 
0x37CA2318, 38092270413437192, 226529532, 226529540, 8, 1440x900 
0x37CA2318, 38092270414089296, 226529597, 226529605, 8, 1440x900 
0x37CA2318, 38092270414749584, 226529663, 226529671, 8, 1440x900 
0x37CA2318, 38092270415410672, 226529728, 226529736, 8, 1440x900 
0x37CA2318, 38092270416074240, 226529798, 226529806, 8, 1440x900 
0x37CA2318, 38092270416725232, 226529863, 226529870, 7, 1440x900 
0x37CA2318, 38092270417395920, 226529928, 226529936, 8, 1440x900 
0x37CA2318, 38092270418048720, 226529992, 226530001, 9, 1440x900 
0x37CA2318, 38092270418718888, 226530062, 226530070, 8, 1440x900 
0x37CA2318, 38092270419373552, 226530128, 226530136, 8, 1440x900 
0x37CA2318, 38092270420032568, 226530192, 226530200, 8, 1440x900 
0x37CA2318, 38092270420693792, 226530257, 226530265, 8, 1440x900 
0x37CA2318, 38092270421355664, 226530328, 226530336, 8, 1440x900 
0x37CA2318, 38092270422009256, 226530393, 226530401, 8, 1440x900 
0x37CA2318, 38092270422680072, 226530453, 226530461, 8, 1440x900 
0x37CA2318, 38092270423341048, 226530518, 226530527, 9, 1440x900 
0x37CA2318, 38092270423995936, 226530586, 226530592, 6, 1440x900 
0x37CA2318, 38092270424663200, 226530652, 226530659, 7, 1440x900 
0x37CA2318, 38092270425322128, 226530718, 226530726, 8, 1440x900 
0x37CA2318, 38092270425986656, 226530788, 226530795, 7, 1440x900 
0x37CA2318, 38092270426637040, 226530853, 226530860, 7, 1440x900 
0x37CA2318, 38092270427320368, 226530923, 226530930, 7, 1440x900 
0x37CA2318, 38092270427966504, 226530982, 226530990, 8, 1440x900 
0x37CA2318, 38092270428619320, 226531049, 226531057, 8, 1440x900 
0x37CA2318, 38092270429277560, 226531117, 226531125, 8, 1440x900 
0x37CA2318, 38092270429943584, 226531183, 226531192, 9, 1440x900 
0x37CA2318, 38092270430603904, 226531248, 226531255, 7, 1440x900 
0x37CA2318, 38092270431267928, 226531313, 226531320, 7, 1440x900 
0x37CA2318, 38092270431923752, 226531378, 226531385, 7, 1440x900 
0x37CA2318, 38092270432588192, 226531447, 226531455, 8, 1440x900 
0x37CA2318, 38092270433249536, 226531512, 226531520, 8, 1440x900 
0x37CA2318, 38092270433912160, 226531583, 226531592, 9, 1440x900 
0x37CA2318, 38092270434565032, 226531643, 226531650, 7, 1440x900 
0x37CA2318, 38092270435235768, 226531709, 226531717, 8, 1440x900 
0x37CA2318, 38092270435895624, 226531777, 226531785, 8, 1440x900 
0x37CA2318, 38092270436562736, 226531848, 226531856, 8, 1440x900 
0x37CA2318, 38092270437223264, 226531912, 226531920, 8, 1440x900 
0x37CA2318, 38092270437875376, 226531978, 226531987, 9, 1440x900 
0x37CA2318, 38092270438541672, 226532041, 226532048, 7, 1440x900 
0x37CA2318, 38092270439201504, 226532107, 226532115, 8, 1440x900 
0x37CA2318, 38092270439856064, 226532172, 226532179, 7, 1440x900 
0x37CA2318, 38092270440517472, 226532238, 226532245, 7, 1440x900 
0x37CA2318, 38092270441171680, 226532307, 226532315, 8, 1440x900 
0x37CA2318, 38092270441837840, 226532372, 226532380, 8, 1440x900 
0x37CA2318, 38092270442500224, 226532438, 226532446, 8, 1440x900 
0x37CA2318, 38092270443156800, 226532503, 226532511, 8, 1440x900 
0x37CA2318, 38092270443821696, 226532573, 226532581, 8, 1440x900 
0x37CA2318, 38092270444481296, 226532638, 226532646, 8, 1440x900 
0x37CA2318, 38092270445132992, 226532703, 226532711, 8, 1440x900 
0x37CA2318, 38092270445803224, 226532767, 226532775, 8, 1440x900 
0x37CA2318, 38092270446463600, 226532833, 226532841, 8, 1440x900 
0x37CA2318, 38092270447123752, 226532898, 226532905, 7, 1440x900 
0x37CA2318, 38092270447793088, 226532967, 226532975, 8, 1440x900 
0x37CA2318, 38092270448453080, 226533032, 226533040, 8, 1440x900 
0x37CA2318, 38092270449102776, 226533098, 226533106, 8, 1440x900 
0x37CA2318, 38092270449763928, 226533163, 226533171, 8, 1440x900 
0x37CA2318, 38092270450427624, 226533232, 226533240, 8, 1440x900 
0x37CA2318, 38092270451086616, 226533297, 226533305, 8, 1440x900 
0x37CA2318, 38092270451756184, 226533363, 226533371, 8, 1440x900 
0x37CA2318, 38092270452413880, 226533432, 226533440, 8, 1440x900 
0x37CA2318, 38092270453083592, 226533497, 226533505, 8, 1440x900 
0x37CA2318, 38092270453736480, 226533562, 226533570, 8, 1440x900 
0x37CA2318, 38092270455066880, 226533698, 226533708, 10, 1440x900 
0x37CA2318, 38092270455525448, 226533737, 226533746, 9, 1440x900 
0x37CA2318, 38092270456195576, 226533808, 226533816, 8, 1440x900 
0x37CA2318, 38092270457049040, 226533893, 226533901, 8, 1440x900 
0x37CA2318, 38092270457708696, 226533962, 226533970, 8, 1440x900 
0x37CA2318, 38092270458377808, 226534028, 226534035, 7, 1440x900 
0x37CA2318, 38092270459038272, 226534092, 226534100, 8, 1440x900 
0x37CA2318, 38092270459690480, 226534157, 226534165, 8, 1440x900 
0x37CA2318, 38092270460342568, 226534223, 226534231, 8, 1440x900 
0x37CA2318, 38092270461004560, 226534292, 226534300, 8, 1440x900 
0x37CA2318, 38092270461683872, 226534358, 226534366, 8, 1440x900 
0x37CA2318, 38092270462334240, 226534423, 226534431, 8, 1440x900 
0x37CA2318, 38092270463003920, 226534488, 226534496, 8, 1440x900 
0x37CA2318, 38092270463655024, 226534554, 226534562, 8, 1440x900 
0x37CA2318, 38092270464324136, 226534623, 226534631, 8, 1440x900 
0x37CA2318, 38092270464993888, 226534687, 226534695, 8, 1440x900 
0x37CA2318, 38092270465644096, 226534754, 226534762, 8, 1440x900 
0x37CA2318, 38092270466304384, 226534823, 226534831, 8, 1440x900 
0x37CA2318, 38092270466973992, 226534888, 226534896, 8, 1440x900 
0x37CA2318, 38092270467633424, 226534952, 226534960, 8, 1440x900 
0x37CA2318, 38092270468295680, 226535017, 226535025, 8, 1440x900 
0x37CA2318, 38092270468960920, 226535082, 226535090, 8, 1440x900 
0x37CA2318, 38092270469623576, 226535148, 226535155, 7, 1440x900 
0x37CA2318, 38092270470284832, 226535219, 226535227, 8, 1440x900 
0x37CA2318, 38092270470948360, 226535282, 226535291, 9, 1440x900 
0x37CA2318, 38092270471606864, 226535352, 226535360, 8, 1440x900 
0x37CA2318, 38092270472267720, 226535417, 226535425, 8, 1440x900 
0x37CA2318, 38092270472928336, 226535482, 226535490, 8, 1440x900 
0x37CA2318, 38092270473587648, 226535547, 226535555, 8, 1440x900 
0x37CA2318, 38092270474247888, 226535612, 226535620, 8, 1440x900 
0x37CA2318, 38092270474917264, 226535683, 226535690, 7, 1440x900 
0x37CA2318, 38092270475577648, 226535748, 226535756, 8, 1440x900 
0x37CA2318, 38092270476229728, 226535813, 226535821, 8, 1440x900 
0x37CA2318, 38092270476889432, 226535877, 226535885, 8, 1440x900 
0x37CA2318, 38092270477558448, 226535943, 226535951, 8, 1440x900 
0x37CA2318, 38092270478212808, 226536008, 226536016, 8, 1440x900 
0x37CA2318, 38092270478876280, 226536076, 226536083, 7, 1440x900 
0x37CA2318, 38092270479530920, 226536143, 226536151, 8, 1440x900 
0x37CA2318, 38092270480190824, 226536208, 226536216, 8, 1440x900 
0x37CA2318, 38092270480846432, 226536273, 226536281, 8, 1440x900 
0x37CA2318, 38092270481518336, 226536338, 226536347, 9, 1440x900 
0x37CA2318, 38092270482180288, 226536408, 226536416, 8, 1440x900 
0x37CA2318, 38092270482840080, 226536472, 226536480, 8, 1440x900 
0x37CA2318, 38092270483501336, 226536537, 226536545, 8, 1440x900 
0x37CA2318, 38092270484163640, 226536603, 226536611, 8, 1440x900 
0x37CA2318, 38092270484824656, 226536673, 226536681, 8, 1440x900 
0x37CA2318, 38092270485477312, 226536738, 226536746, 8, 1440x900 
0x37CA2318, 38092270486139440, 226536803, 226536811, 8, 1440x900 
0x37CA2318, 38092270486814296, 226536872, 226536880, 8, 1440x900 
0x37CA2318, 38092270487472280, 226536933, 226536940, 7, 1440x900 
0x37CA2318, 38092270488130624, 226537003, 226537011, 8, 1440x900 
0x37CA2318, 38092270488805624, 226537073, 226537081, 8, 1440x900 
0x37CA2318, 38092270489461568, 226537137, 226537145, 8, 1440x900 
0x37CA2318, 38092270490118888, 226537203, 226537211, 8, 1440x900 
0x37CA2318, 38092270490779488, 226537268, 226537276, 8, 1440x900 
0x37CA2318, 38092270491436680, 226537332, 226537341, 9, 1440x900 
0x37CA2318, 38092270492101368, 226537402, 226537410, 8, 1440x900 
0x37CA2318, 38092270492762576, 226537463, 226537472, 9, 1440x900 
0x37CA2318, 38092270493423744, 226537529, 226537538, 9, 1440x900 
0x37CA2318, 38092270494083664, 226537597, 226537605, 8, 1440x900 
0x37CA2318, 38092270494746528, 226537662, 226537670, 8, 1440x900 
0x37CA2318, 38092270495409800, 226537732, 226537740, 8, 1440x900 
0x37CA2318, 38092270496078976, 226537798, 226537806, 8, 1440x900 
0x37CA2318, 38092270496738560, 226537862, 226537870, 8, 1440x900 
0x37CA2318, 38092270497391632, 226537928, 226537936, 8, 1440x900 
0x37CA2318, 38092270498052072, 226537998, 226538006, 8, 1440x900 
0x37CA2318, 38092270498712632, 226538057, 226538065, 8, 1440x900 
0x37CA2318, 38092270499371776, 226538123, 226538130, 7, 1440x900 
0x37CA2318, 38092270500032912, 226538188, 226538196, 8, 1440x900 
0x37CA2318, 38092270500694328, 226538258, 226538266, 8, 1440x900 
0x37CA2318, 38092270501353368, 226538323, 226538331, 8, 1440x900 
0x37CA2318, 38092270502014272, 226538392, 226538400, 8, 1440x900 
0x37CA2318, 38092270502666416, 226538453, 226538462, 9, 1440x900 
0x37CA2318, 38092270503330832, 226538523, 226538531, 8, 1440x900 
0x37CA2318, 38092270503994136, 226538588, 226538596, 8, 1440x900 
0x37CA2318, 38092270504663928, 226538657, 226538666, 9, 1440x900 
0x37CA2318, 38092270505311712, 226538718, 226538727, 9, 1440x900 
0x37CA2318, 38092270505976504, 226538788, 226538796, 8, 1440x900 
0x37CA2318, 38092270506641792, 226538853, 226538861, 8, 1440x900 
0x37CA2318, 38092270507303384, 226538918, 226538926, 8, 1440x900 
0x37CA2318, 38092270507965824, 226538984, 226538992, 8, 1440x900 
0x37CA2318, 38092270508617368, 226539049, 226539057, 8, 1440x900 
0x37CA2318, 38092270509283312, 226539118, 226539127, 9, 1440x900 
0x37CA2318, 38092270509952376, 226539182, 226539190, 8, 1440x900 
0x37CA2318, 38092270510603632, 226539247, 226539254, 7, 1440x900 
0x37CA2318, 38092270511263728, 226539313, 226539322, 9, 1440x900 
0x37CA2318, 38092270511925048, 226539383, 226539391, 8, 1440x900 
0x37CA2318, 38092270512586592, 226539448, 226539456, 8, 1440x900 
0x37CA2318, 38092270513247352, 226539513, 226539521, 8, 1440x900 
0x37CA2318, 38092270513902904, 226539582, 226539590, 8, 1440x900 
0x37CA2318, 38092270514564592, 226539648, 226539656, 8, 1440x900 
0x37CA2318, 38092270515228232, 226539713, 226539721, 8, 1440x900 
0x37CA2318, 38092270515881496, 226539777, 226539785, 8, 1440x900 
0x37CA2318, 38092270516548640, 226539843, 226539852, 9, 1440x900 
0x37CA2318, 38092270517199056, 226539913, 226539921, 8, 1440x900 
0x37CA2318, 38092270517860968, 226539973, 226539981, 8, 1440x900 
0x37CA2318, 38092270518527104, 226540043, 226540051, 8, 1440x900 
0x37CA2318, 38092270519181696, 226540107, 226540115, 8, 1440x900 
0x37CA2318, 38092270519852320, 226540178, 226540186, 8, 1440x900 
0x37CA2318, 38092270520512240, 226540237, 226540244, 7, 1440x900 
0x37CA2318, 38092270521174376, 226540303, 226540312, 9, 1440x900 
0x37CA2318, 38092270521835472, 226540373, 226540381, 8, 1440x900 
0x37CA2318, 38092270522495112, 226540439, 226540447, 8, 1440x900 
0x37CA2318, 38092270523156576, 226540502, 226540511, 9, 1440x900 
0x37CA2318, 38092270523810576, 226540568, 226540577, 9, 1440x900 
0x37CA2318, 38092270524472944, 226540638, 226540646, 8, 1440x900 
0x37CA2318, 38092270525143888, 226540703, 226540711, 8, 1440x900 
0x37CA2318, 38092270525805328, 226540769, 226540777, 8, 1440x900 
0x37CA2318, 38092270526456816, 226540837, 226540846, 9, 1440x900 
0x37CA2318, 38092270527127920, 226540903, 226540911, 8, 1440x900 
0x37CA2318, 38092270527786144, 226540968, 226540976, 8, 1440x900 
0x37CA2318, 38092270528439568, 226541032, 226541040, 8, 1440x900 
0x37CA2318, 38092270529102992, 226541102, 226541110, 8, 1440x900 
0x37CA2318, 38092270529770736, 226541169, 226541179, 10, 1440x900 
0x37CA2318, 38092270530431768, 226541233, 226541241, 8, 1440x900 
0x37CA2318, 38092270531083536, 226541298, 226541306, 8, 1440x900 
0x37CA2318, 38092270531764304, 226541368, 226541375, 7, 1440x900 
0x37CA2318, 38092270532417600, 226541429, 226541437, 8, 1440x900 
0x37CA2318, 38092270533086616, 226541497, 226541505, 8, 1440x900 
0x37CA2318, 38092270533739552, 226541563, 226541571, 8, 1440x900 
0x37CA2318, 38092270534400464, 226541628, 226541636, 8, 1440x900 
0x37CA2318, 38092270535715504, 226541759, 226541767, 8, 1440x900 
0x37CA2318, 38092270536380208, 226541827, 226541835, 8, 1440x900 
0x37CA2318, 38092270537050040, 226541892, 226541901, 9, 1440x900 
0x37CA2318, 38092270537700304, 226541957, 226541966, 9, 1440x900 
0x37CA2318, 38092270538363184, 226542027, 226542035, 8, 1440x900 
0x37CA2318, 38092270539016880, 226542089, 226542097, 8, 1440x900 
0x37CA2318, 38092270539686752, 226542158, 226542166, 8, 1440x900 
0x37CA2318, 38092270540347664, 226542222, 226542230, 8, 1440x900 
0x37CA2318, 38092270541013176, 226542292, 226542300, 8, 1440x900 
0x37CA2318, 38092270541663016, 226542353, 226542362, 9, 1440x900 
0x37CA2318, 38092270542334120, 226542423, 226542430, 7, 1440x900 
0x37CA2318, 38092270542993792, 226542488, 226542496, 8, 1440x900 
0x37CA2318, 38092270543649808, 226542558, 226542566, 8, 1440x900 
0x37CA2318, 38092270544301584, 226542617, 226542625, 8, 1440x900 
0x37CA2318, 38092270544965136, 226542689, 226542698, 9, 1440x900 
0x37CA2318, 38092270545628584, 226542753, 226542761, 8, 1440x900 
0x37CA2318, 38092270546289032, 226542818, 226542826, 8, 1440x900 
0x37CA2318, 38092270546950992, 226542882, 226542891, 9, 1440x900 
0x37CA2318, 38092270547610960, 226542948, 226542956, 8, 1440x900 
0x37CA2318, 38092270548271296, 226543018, 226543026, 8, 1440x900 
0x37CA2318, 38092270548936384, 226543083, 226543091, 8, 1440x900 
0x37CA2318, 38092270549597232, 226543147, 226543155, 8, 1440x900 
0x37CA2318, 38092270550257528, 226543213, 226543220, 7, 1440x900 
0x37CA2318, 38092270550920416, 226543283, 226543291, 8, 1440x900 
0x37CA2318, 38092270551582336, 226543348, 226543356, 8, 1440x900 
0x37CA2318, 38092270552243288, 226543412, 226543420, 8, 1440x900 
0x37CA2318, 38092270552904344, 226543478, 226543486, 8, 1440x900 
0x37CA2318, 38092270553560256, 226543542, 226543549, 7, 1440x900 
0x37CA2318, 38092270554232416, 226543613, 226543621, 8, 1440x900 
0x37CA2318, 38092270554892848, 226543678, 226543686, 8, 1440x900 
0x37CA2318, 38092270555545216, 226543742, 226543749, 7, 1440x900 
0x37CA2318, 38092270556207600, 226543807, 226543814, 7, 1440x900 
0x37CA2318, 38092270556859496, 226543873, 226543881, 8, 1440x900 
0x37CA2318, 38092270557530776, 226543943, 226543951, 8, 1440x900 
0x37CA2318, 38092270558182920, 226544008, 226544016, 8, 1440x900 
0x37CA2318, 38092270558847048, 226544073, 226544081, 8, 1440x900 
0x37CA2318, 38092270559508408, 226544142, 226544150, 8, 1440x900 
0x37CA2318, 38092270560177800, 226544207, 226544215, 8, 1440x900 
0x37CA2318, 38092270560831272, 226544268, 226544276, 8, 1440x900 
0x37CA2318, 38092270561493056, 226544338, 226544346, 8, 1440x900 
0x37CA2318, 38092270562153192, 226544403, 226544410, 7, 1440x900 
0x37CA2318, 38092270562813184, 226544467, 226544475, 8, 1440x900 
0x37CA2318, 38092270563473392, 226544533, 226544541, 8, 1440x900 
0x37CA2318, 38092270564135944, 226544607, 226544615, 8, 1440x900 
0x37CA2318, 38092270564799632, 226544668, 226544676, 8, 1440x900 
0x37CA2318, 38092270565459472, 226544732, 226544741, 9, 1440x900 
0x37CA2318, 38092270566120800, 226544798, 226544807, 9, 1440x900 
0x37CA2318, 38092270566782168, 226544868, 226544876, 8, 1440x900 
0x37CA2318, 38092270567451192, 226544937, 226544945, 8, 1440x900 
0x37CA2318, 38092270568102832, 226544998, 226545007, 9, 1440x900 
0x37CA2318, 38092270568765400, 226545063, 226545072, 9, 1440x900 
0x37CA2318, 38092270569426208, 226545133, 226545141, 8, 1440x900 
0x37CA2318, 38092270570088040, 226545198, 226545206, 8, 1440x900 
0x37CA2318, 38092270570739968, 226545262, 226545270, 8, 1440x900 
0x37CA2318, 38092270571403200, 226545328, 226545336, 8, 1440x900 
0x37CA2318, 38092270572072224, 226545397, 226545405, 8, 1440x900 
0x37CA2318, 38092270572733352, 226545462, 226545470, 8, 1440x900 
0x37CA2318, 38092270573376240, 226545528, 226545536, 8, 1440x900 
0x37CA2318, 38092270574050608, 226545592, 226545600, 8, 1440x900 
0x37CA2318, 38092270574713560, 226545657, 226545666, 9, 1440x900 
0x37CA2318, 38092270575357896, 226545722, 226545730, 8, 1440x900 
0x37CA2318, 38092270576028544, 226545793, 226545801, 8, 1440x900 
0x37CA2318, 38092270576689704, 226545858, 226545866, 8, 1440x900 
0x37CA2318, 38092270577350200, 226545922, 226545931, 9, 1440x900 
0x37CA2318, 38092270578014032, 226545989, 226545997, 8, 1440x900 
0x37CA2318, 38092270578682072, 226546058, 226546066, 8, 1440x900 
0x37CA2318, 38092270579350320, 226546122, 226546131, 9, 1440x900 
0x37CA2318, 38092270580002696, 226546188, 226546196, 8, 1440x900 
0x37CA2318, 38092270580664040, 226546257, 226546265, 8, 1440x900 
0x37CA2318, 38092270581321144, 226546318, 226546325, 7, 1440x900 
0x37CA2318, 38092270581987272, 226546386, 226546394, 8, 1440x900 
0x37CA2318, 38092270582648864, 226546452, 226546460, 8, 1440x900 
0x37CA2318, 38092270583311360, 226546518, 226546527, 9, 1440x900 
0x37CA2318, 38092270583962912, 226546587, 226546595, 8, 1440x900 
0x37CA2318, 38092270584634720, 226546652, 226546660, 8, 1440x900 
0x37CA2318, 38092270585285688, 226546713, 226546721, 8, 1440x900 
0x37CA2318, 38092270585966128, 226546788, 226546794, 6, 1440x900 
0x37CA2318, 38092270586616024, 226546852, 226546859, 7, 1440x900 
0x37CA2318, 38092270587279168, 226546917, 226546924, 7, 1440x900 
0x37CA2318, 38092270587948520, 226546982, 226546990, 8, 1440x900 
0x37CA2318, 38092270588600336, 226547047, 226547054, 7, 1440x900 
0x37CA2318, 38092270589262088, 226547112, 226547122, 10, 1440x900 
0x37CA2318, 38092270589919224, 226547183, 226547191, 8, 1440x900 
0x37CA2318, 38092270590580912, 226547247, 226547255, 8, 1440x900 
0x37CA2318, 38092270591240048, 226547312, 226547320, 8, 1440x900 
0x37CA2318, 38092270591901792, 226547378, 226547386, 8, 1440x900 
0x37CA2318, 38092270592557072, 226547448, 226547456, 8, 1440x900 
0x37CA2318, 38092270593219312, 226547513, 226547521, 8, 1440x900 
0x37CA2318, 38092270593882272, 226547577, 226547585, 8, 1440x900 
0x37CA2318, 38092270594534088, 226547643, 226547651, 8, 1440x900 
0x37CA2318, 38092270595205472, 226547708, 226547717, 9, 1440x900 
0x37CA2318, 38092270595859928, 226547773, 226547781, 8, 1440x900 
0x37CA2318, 38092270596530216, 226547843, 226547851, 8, 1440x900 
0x37CA2318, 38092270597189528, 226547907, 226547915, 8, 1440x900 
0x37CA2318, 38092270597851040, 226547973, 226547981, 8, 1440x900 
0x37CA2318, 38092270598502856, 226548038, 226548046, 8, 1440x900 
0x37CA2318, 38092270599174400, 226548108, 226548116, 8, 1440x900 
0x37CA2318, 38092270599836240, 226548173, 226548181, 8, 1440x900 
0x37CA2318, 38092270600498008, 226548237, 226548246, 9, 1440x900 
0x37CA2318, 38092270601167968, 226548308, 226548316, 8, 1440x900 
0x37CA2318, 38092270601816880, 226548368, 226548375, 7, 1440x900 
0x37CA2318, 38092270602479920, 226548436, 226548444, 8, 1440x900 
0x37CA2318, 38092270603140664, 226548501, 226548509, 8, 1440x900 
0x37CA2318, 38092270603793568, 226548566, 226548574, 8, 1440x900 
0x37CA2318, 38092270604463448, 226548632, 226548639, 7, 1440x900 
0x37CA2318, 38092270605117296, 226548698, 226548705, 7, 1440x900 
0x37CA2318, 38092270605780440, 226548767, 226548775, 8, 1440x900 
0x37CA2318, 38092270606441448, 226548833, 226548841, 8, 1440x900 
0x37CA2318, 38092270607096096, 226548897, 226548904, 7, 1440x900 
0x37CA2318, 38092270607769344, 226548963, 226548970, 7, 1440x900 
0x37CA2318, 38092270608414648, 226549028, 226549035, 7, 1440x900 
0x37CA2318, 38092270609094272, 226549097, 226549104, 7, 1440x900 
0x37CA2318, 38092270609745008, 226549162, 226549169, 7, 1440x900 
0x37CA2318, 38092270610410608, 226549233, 226549241, 8, 1440x900 
0x37CA2318, 38092270611070400, 226549297, 226549305, 8, 1440x900 
0x37CA2318, 38092270612393880, 226549428, 226549436, 8, 1440x900 
0x37CA2318, 38092270613055768, 226549493, 226549501, 8, 1440x900 
0x37CA2318, 38092270613716576, 226549563, 226549571, 8, 1440x900 
0x37CA2318, 38092270614378408, 226549632, 226549640, 8, 1440x900 
0x37CA2318, 38092270614992184, 226549687, 226549696, 9, 1440x900 
0x37CA2318, 38092270615500800, 226549737, 226549744, 7, 1440x900 
0x37CA2318, 38092270616355336, 226549823, 226549830, 7, 1440x900 
0x37CA2318, 38092270617016472, 226549888, 226549896, 8, 1440x900 
0x37CA2318, 38092270617670464, 226549952, 226549960, 8, 1440x900 
0x37CA2318, 38092270618339968, 226550023, 226550031, 8, 1440x900 
0x37CA2318, 38092270618998936, 226550088, 226550096, 8, 1440x900 
0x37CA2318, 38092270619670608, 226550158, 226550167, 9, 1440x900 
0x37CA2318, 38092270620319552, 226550218, 226550227, 9, 1440x900 
0x37CA2318, 38092270620982216, 226550288, 226550296, 8, 1440x900 
0x37CA2318, 38092270621639448, 226550352, 226550361, 9, 1440x900 
0x37CA2318, 38092270622295696, 226550417, 226550425, 8, 1440x900 
0x37CA2318, 38092270622966032, 226550488, 226550496, 8, 1440x900 
0x37CA2318, 38092270623623384, 226550552, 226550560, 8, 1440x900 
0x37CA2318, 38092270624276104, 226550618, 226550626, 8, 1440x900 
0x37CA2318, 38092270624944864, 226550688, 226550696, 8, 1440x900 
0x37CA2318, 38092270625596840, 226550748, 226550756, 8, 1440x900 
0x37CA2318, 38092270626267104, 226550813, 226550822, 9, 1440x900 
0x37CA2318, 38092270626927472, 226550882, 226550890, 8, 1440x900 
0x37CA2318, 38092270627589304, 226550948, 226550956, 8, 1440x900 
0x37CA2318, 38092270628249320, 226551017, 226551025, 8, 1440x900 
0x37CA2318, 38092270628910376, 226551082, 226551090, 8, 1440x900 
0x37CA2318, 38092270629576712, 226551148, 226551156, 8, 1440x900 
0x37CA2318, 38092270630241296, 226551212, 226551220, 8, 1440x900 
0x37CA2318, 38092270630895768, 226551277, 226551286, 9, 1440x900 
0x37CA2318, 38092270631562504, 226551342, 226551350, 8, 1440x900 
0x37CA2318, 38092270632223664, 226551412, 226551420, 8, 1440x900 
0x37CA2318, 38092270632882688, 226551478, 226551486, 8, 1440x900 
0x37CA2318, 38092270633547160, 226551543, 226551551, 8, 1440x900 
0x37CA2318, 38092270634206848, 226551608, 226551617, 9, 1440x900 
0x37CA2318, 38092270634873152, 226551677, 226551685, 8, 1440x900 
0x37CA2318, 38092270635540248, 226551742, 226551750, 8, 1440x900 
0x37CA2318, 38092270636201280, 226551807, 226551815, 8, 1440x900 
0x37CA2318, 38092270636861736, 226551873, 226551881, 8, 1440x900 
0x37CA2318, 38092270637521776, 226551940, 226551948, 8, 1440x900 
0x37CA2318, 38092270638182376, 226552008, 226552016, 8, 1440x900 
0x37CA2318, 38092270638842960, 226552072, 226552080, 8, 1440x900 
0x37CA2318, 38092270639500912, 226552137, 226552145, 8, 1440x900 
0x37CA2318, 38092270640164240, 226552203, 226552212, 9, 1440x900 
0x37CA2318, 38092270640820664, 226552273, 226552281, 8, 1440x900 
0x37CA2318, 38092270641480352, 226552337, 226552345, 8, 1440x900 
0x37CA2318, 38092270642150576, 226552407, 226552415, 8, 1440x900 
0x37CA2318, 38092270642811008, 226552468, 226552476, 8, 1440x900 
0x37CA2318, 38092270643472432, 226552534, 226552542, 8, 1440x900 
0x37CA2318, 38092270644136296, 226552603, 226552611, 8, 1440x900 
0x37CA2318, 38092270644797520, 226552668, 226552676, 8, 1440x900 
0x37CA2318, 38092270645456504, 226552733, 226552741, 8, 1440x900 
0x37CA2318, 38092270646108520, 226552803, 226552811, 8, 1440x900 
0x37CA2318, 38092270646770912, 226552867, 226552875, 8, 1440x900 
0x37CA2318, 38092270647441928, 226552932, 226552940, 8, 1440x900 
0x37CA2318, 38092270648108064, 226553002, 226553010, 8, 1440x900 
0x37CA2318, 38092270648767712, 226553067, 226553075, 8, 1440x900 
0x37CA2318, 38092270649424848, 226553133, 226553141, 8, 1440x900 
0x37CA2318, 38092270650087752, 226553193, 226553201, 8, 1440x900 
0x37CA2318, 38092270650754568, 226553264, 226553271, 7, 1440x900 
0x37CA2318, 38092270651421872, 226553332, 226553340, 8, 1440x900 
0x37CA2318, 38092270652077360, 226553398, 226553406, 8, 1440x900 
0x37CA2318, 38092270652731096, 226553458, 226553466, 8, 1440x900 
0x37CA2318, 38092270653400960, 226553528, 226553536, 8, 1440x900 
0x37CA2318, 38092270654065208, 226553598, 226553606, 8, 1440x900 
0x37CA2318, 38092270654718272, 226553659, 226553667, 8, 1440x900 
0x37CA2318, 38092270655379176, 226553728, 226553737, 9, 1440x900 
0x37CA2318, 38092270656034640, 226553792, 226553800, 8, 1440x900 
0x37CA2318, 38092270656700760, 226553858, 226553866, 8, 1440x900 
0x37CA2318, 38092270657370264, 226553928, 226553936, 8, 1440x900 
0x37CA2318, 38092270658023320, 226553988, 226553997, 9, 1440x900 
0x37CA2318, 38092270658674224, 226554059, 226554067, 8, 1440x900 
0x37CA2318, 38092270659345760, 226554123, 226554131, 8, 1440x900 
0x37CA2318, 38092270660016184, 226554188, 226554196, 8, 1440x900 
0x37CA2318, 38092270660658320, 226554253, 226554260, 7, 1440x900 
0x37CA2318, 38092270661326584, 226554322, 226554330, 8, 1440x900 
0x37CA2318, 38092270661989816, 226554388, 226554396, 8, 1440x900 
0x37CA2318, 38092270662648208, 226554457, 226554464, 7, 1440x900 
0x37CA2318, 38092270663299656, 226554517, 226554525, 8, 1440x900 
0x37CA2318, 38092270663963128, 226554583, 226554591, 8, 1440x900 
0x37CA2318, 38092270664634552, 226554654, 226554662, 8, 1440x900 
0x37CA2318, 38092270665294904, 226554717, 226554725, 8, 1440x900 
0x37CA2318, 38092270665956192, 226554787, 226554795, 8, 1440x900 
0x37CA2318, 38092270666609000, 226554852, 226554860, 8, 1440x900 
0x37CA2318, 38092270667268936, 226554917, 226554925, 8, 1440x900 
0x37CA2318, 38092270667931632, 226554983, 226554991, 8, 1440x900 
0x37CA2318, 38092270668585248, 226555048, 226555055, 7, 1440x900 
0x37CA2318, 38092270669255064, 226555117, 226555125, 8, 1440x900 
0x37CA2318, 38092270669916184, 226555178, 226555187, 9, 1440x900 
0x37CA2318, 38092270670571304, 226555247, 226555255, 8, 1440x900 
0x37CA2318, 38092270671235112, 226555313, 226555321, 8, 1440x900 
0x37CA2318, 38092270671897112, 226555377, 226555385, 8, 1440x900 
0x37CA2318, 38092270672549336, 226555443, 226555450, 7, 1440x900 
0x37CA2318, 38092270673220872, 226555508, 226555517, 9, 1440x900 
0x37CA2318, 38092270673880400, 226555578, 226555586, 8, 1440x900 
0x37CA2318, 38092270674533640, 226555643, 226555651, 8, 1440x900 
0x37CA2318, 38092270675197536, 226555707, 226555714, 7, 1440x900 
0x37CA2318, 38092270675867200, 226555773, 226555780, 7, 1440x900 
0x37CA2318, 38092270676525856, 226555838, 226555847, 9, 1440x900 
0x37CA2318, 38092270677196344, 226555906, 226555914, 8, 1440x900 
0x37CA2318, 38092270677857800, 226555973, 226555980, 7, 1440x900 
0x37CA2318, 38092270678508448, 226556037, 226556045, 8, 1440x900 
0x37CA2318, 38092270679162248, 226556102, 226556109, 7, 1440x900 
0x37CA2318, 38092270679826720, 226556173, 226556181, 8, 1440x900 
0x37CA2318, 38092270680490056, 226556238, 226556246, 8, 1440x900 
0x37CA2318, 38092270681145784, 226556302, 226556310, 8, 1440x900 
0x37CA2318, 38092270681808704, 226556368, 226556377, 9, 1440x900 
0x37CA2318, 38092270682472520, 226556438, 226556446, 8, 1440x900 
0x37CA2318, 38092270683141544, 226556508, 226556517, 9, 1440x900 
0x37CA2318, 38092270683793816, 226556568, 226556576, 8, 1440x900 
0x37CA2318, 38092270684454360, 226556633, 226556642, 9, 1440x900 
0x37CA2318, 38092270685106520, 226556698, 226556705, 7, 1440x900 
0x37CA2318, 38092270685775680, 226556767, 226556775, 8, 1440x900 
0x37CA2318, 38092270686436272, 226556833, 226556841, 8, 1440x900 
0x37CA2318, 38092270687106232, 226556898, 226556906, 8, 1440x900 
0x37CA2318, 38092270687758424, 226556967, 226556975, 8, 1440x900 
0x37CA2318, 38092270688419856, 226557032, 226557040, 8, 1440x900 
0x37CA2318, 38092270689080336, 226557098, 226557106, 8, 1440x900 
0x37CA2318, 38092270689733456, 226557163, 226557170, 7, 1440x900 
0x37CA2318, 38092270691057968, 226557292, 226557301, 9, 1440x900 
0x37CA2318, 38092270691723976, 226557359, 226557367, 8, 1440x900 
0x37CA2318, 38092270692376976, 226557428, 226557436, 8, 1440x900 
0x37CA2318, 38092270693041424, 226557492, 226557500, 8, 1440x900 
0x37CA2318, 38092270693702512, 226557558, 226557566, 8, 1440x900 
0x37CA2318, 38092270694355864, 226557623, 226557631, 8, 1440x900 
0x37CA2318, 38092270695028320, 226557693, 226557701, 8, 1440x900 
0x37CA2318, 38092270695696344, 226557758, 226557766, 8, 1440x900 
0x37CA2318, 38092270696348768, 226557827, 226557835, 8, 1440x900 
0x37CA2318, 38092270697009432, 226557892, 226557900, 8, 1440x900 
0x37CA2318, 38092270697678576, 226557957, 226557965, 8, 1440x900 
0x37CA2318, 38092270698340016, 226558022, 226558030, 8, 1440x900 
0x37CA2318, 38092270698991240, 226558087, 226558095, 8, 1440x900 
0x37CA2318, 38092270699650768, 226558152, 226558160, 8, 1440x900 
0x37CA2318, 38092270700311680, 226558218, 226558226, 8, 1440x900 
0x37CA2318, 38092270700973792, 226558287, 226558295, 8, 1440x900 
0x37CA2318, 38092270701635704, 226558353, 226558360, 7, 1440x900 
0x37CA2318, 38092270702293032, 226558417, 226558425, 8, 1440x900 
0x37CA2318, 38092270702953256, 226558487, 226558495, 8, 1440x900 
0x37CA2318, 38092270703614176, 226558553, 226558561, 8, 1440x900 
0x37CA2318, 38092270704274696, 226558619, 226558627, 8, 1440x900 
0x37CA2318, 38092270704935936, 226558683, 226558691, 8, 1440x900 
0x37CA2318, 38092270705588368, 226558748, 226558756, 8, 1440x900 
0x37CA2318, 38092270706268336, 226558818, 226558826, 8, 1440x900 
0x37CA2318, 38092270706928112, 226558883, 226558891, 8, 1440x900 
0x37CA2318, 38092270707579704, 226558948, 226558956, 8, 1440x900 
0x37CA2318, 38092270708246160, 226559017, 226559025, 8, 1440x900 
0x37CA2318, 38092270708904120, 226559082, 226559091, 9, 1440x900 
0x37CA2318, 38092270709563856, 226559143, 226559152, 9, 1440x900 
0x37CA2318, 38092270710227048, 226559213, 226559221, 8, 1440x900 
0x37CA2318, 38092270710886632, 226559278, 226559285, 7, 1440x900 
0x37CA2318, 38092270711556848, 226559347, 226559354, 7, 1440x900 
0x37CA2318, 38092270712207456, 226559408, 226559417, 9, 1440x900 
0x37CA2318, 38092270712877096, 226559478, 226559486, 8, 1440x900 
0x37CA2318, 38092270713530896, 226559542, 226559550, 8, 1440x900 
0x37CA2318, 38092270714191024, 226559608, 226559616, 8, 1440x900 
0x37CA2318, 38092270714862096, 226559678, 226559686, 8, 1440x900 
0x37CA2318, 38092270715512760, 226559742, 226559750, 8, 1440x900 
0x37CA2318, 38092270716174232, 226559808, 226559816, 8, 1440x900 
0x37CA2318, 38092270716831616, 226559872, 226559880, 8, 1440x900 
0x37CA2318, 38092270717494080, 226559937, 226559945, 8, 1440x900 
0x37CA2318, 38092270718160032, 226560003, 226560011, 8, 1440x900 
0x37CA2318, 38092270718812432, 226560068, 226560076, 8, 1440x900 
0x37CA2318, 38092270719483784, 226560137, 226560145, 8, 1440x900 
0x37CA2318, 38092270720141520, 226560203, 226560211, 8, 1440x900 
0x37CA2318, 38092270720804168, 226560272, 226560281, 9, 1440x900 
0x37CA2318, 38092270721464536, 226560338, 226560346, 8, 1440x900 
0x37CA2318, 38092270722125696, 226560403, 226560411, 8, 1440x900 
0x37CA2318, 38092270722781336, 226560468, 226560476, 8, 1440x900 
0x37CA2318, 38092270723445848, 226560533, 226560541, 8, 1440x900 
0x37CA2318, 38092270724108840, 226560603, 226560611, 8, 1440x900 
0x37CA2318, 38092270724767680, 226560663, 226560670, 7, 1440x900 
0x37CA2318, 38092270725429240, 226560732, 226560740, 8, 1440x900 
0x37CA2318, 38092270726099432, 226560798, 226560806, 8, 1440x900 
0x37CA2318, 38092270726748880, 226560862, 226560870, 8, 1440x900 
0x37CA2318, 38092270727410032, 226560932, 226560940, 8, 1440x900 
0x37CA2318, 38092270728064528, 226560998, 226561005, 7, 1440x900 
0x37CA2318, 38092270728727008, 226561063, 226561071, 8, 1440x900 
0x37CA2318, 38092270729389168, 226561128, 226561136, 8, 1440x900 
0x37CA2318, 38092270730050320, 226561192, 226561201, 9, 1440x900 
0x37CA2318, 38092270730708936, 226561263, 226561271, 8, 1440x900 
0x37CA2318, 38092270731372520, 226561327, 226561335, 8, 1440x900 
0x37CA2318, 38092270732025992, 226561393, 226561401, 8, 1440x900 
0x37CA2318, 38092270732697208, 226561462, 226561470, 8, 1440x900 
0x37CA2318, 38092270733356520, 226561527, 226561535, 8, 1440x900 
0x37CA2318, 38092270734019360, 226561593, 226561601, 8, 1440x900 
0x37CA2318, 38092270734681024, 226561658, 226561665, 7, 1440x900 
0x37CA2318, 38092270735335368, 226561723, 226561732, 9, 1440x900 
0x37CA2318, 38092270735997504, 226561787, 226561794, 7, 1440x900 
0x37CA2318, 38092270736667192, 226561852, 226561860, 8, 1440x900 
0x37CA2318, 38092270737318088, 226561917, 226561924, 7, 1440x900 
0x37CA2318, 38092270737997824, 226561988, 226561995, 7, 1440x900 
0x37CA2318, 38092270738664360, 226562052, 226562060, 8, 1440x900 
0x37CA2318, 38092270739123000, 226562097, 226562104, 7, 1440x900 
0x37CA2318, 38092270739985808, 226562183, 226562191, 8, 1440x900 
0x37CA2318, 38092270740655776, 226562253, 226562260, 7, 1440x900 
0x37CA2318, 38092270741307200, 226562317, 226562324, 7, 1440x900 
0x37CA2318, 38092270741959760, 226562382, 226562389, 7, 1440x900 
0x37CA2318, 38092270742440960, 226562431, 226562438, 7, 1440x900 
0x37CA2318, 38092270743282728, 226562518, 226562526, 8, 1440x900 
0x37CA2318, 38092270743953680, 226562587, 226562595, 8, 1440x900 
0x37CA2318, 38092270744613984, 226562648, 226562657, 9, 1440x900 
0x37CA2318, 38092270745274512, 226562713, 226562722, 9, 1440x900 
0x37CA2318, 38092270745935624, 226562781, 226562789, 8, 1440x900 
0x37CA2318, 38092270746603824, 226562848, 226562855, 7, 1440x900 
0x37CA2318, 38092270747071184, 226562893, 226562901, 8, 1440x900 
0x37CA2318, 38092270747923032, 226562978, 226562985, 7, 1440x900 
0x37CA2318, 38092270748582864, 226563043, 226563050, 7, 1440x900 
0x37CA2318, 38092270749244856, 226563113, 226563120, 7, 1440x900 
0x37CA2318, 38092270749905952, 226563178, 226563185, 7, 1440x900 
0x37CA2318, 38092270750568600, 226563243, 226563252, 9, 1440x900 
0x37CA2318, 38092270751227504, 226563312, 226563320, 8, 1440x900 
0x37CA2318, 38092270751895336, 226563377, 226563385, 8, 1440x900 
0x37CA2318, 38092270752556912, 226563443, 226563451, 8, 1440x900 
0x37CA2318, 38092270753210024, 226563508, 226563517, 9, 1440x900 
0x37CA2318, 38092270753877624, 226563577, 226563585, 8, 1440x900 
0x37CA2318, 38092270754522928, 226563643, 226563651, 8, 1440x900 
0x37CA2318, 38092270755277344, 226563712, 226563720, 8, 1440x900 
0x37CA2318, 38092270755734992, 226563762, 226563769, 7, 1440x900 
0x37CA2318, 38092270756596552, 226563852, 226563860, 8, 1440x900 
0x37CA2318, 38092270757260096, 226563917, 226563925, 8, 1440x900 
0x37CA2318, 38092270757900240, 226563977, 226563985, 8, 1440x900 
0x37CA2318, 38092270758563904, 226564047, 226564055, 8, 1440x900 
0x37CA2318, 38092270759232272, 226564113, 226564121, 8, 1440x900 
0x37CA2318, 38092270759892832, 226564178, 226564186, 8, 1440x900 
0x37CA2318, 38092270760552584, 226564242, 226564249, 7, 1440x900 
0x37CA2318, 38092270761216688, 226564308, 226564315, 7, 1440x900 
0x37CA2318, 38092270761871528, 226564378, 226564386, 8, 1440x900 
0x37CA2318, 38092270762532992, 226564443, 226564451, 8, 1440x900 
0x37CA2318, 38092270763195144, 226564508, 226564516, 8, 1440x900 
0x37CA2318, 38092270763846784, 226564572, 226564580, 8, 1440x900 
0x37CA2318, 38092270764508848, 226564638, 226564647, 9, 1440x900 
0x37CA2318, 38092270765180120, 226564708, 226564717, 9, 1440x900 
0x37CA2318, 38092270765834288, 226564777, 226564784, 7, 1440x900 
0x37CA2318, 38092270766487152, 226564837, 226564844, 7, 1440x900 
0x37CA2318, 38092270767158176, 226564903, 226564911, 8, 1440x900 
0x37CA2318, 38092270767809912, 226564968, 226564976, 8, 1440x900 
0x37CA2318, 38092270768477504, 226565038, 226565046, 8, 1440x900 
0x37CA2318, 38092270769137264, 226565101, 226565108, 7, 1440x900 
0x37CA2318, 38092270769800488, 226565168, 226565176, 8, 1440x900 
0x37CA2318, 38092270770451560, 226565233, 226565241, 8, 1440x900 
0x37CA2318, 38092270771118264, 226565302, 226565310, 8, 1440x900 
0x37CA2318, 38092270771774256, 226565368, 226565376, 8, 1440x900 
0x37CA2318, 38092270772453208, 226565432, 226565440, 8, 1440x900 
0x37CA2318, 38092270773103440, 226565497, 226565506, 9, 1440x900 
0x37CA2318, 38092270773758464, 226565567, 226565575, 8, 1440x900 
0x37CA2318, 38092270774429840, 226565632, 226565640, 8, 1440x900 
0x37CA2318, 38092270775080904, 226565697, 226565705, 8, 1440x900 
0x37CA2318, 38092270775750104, 226565762, 226565770, 8, 1440x900 
0x37CA2318, 38092270776418832, 226565828, 226565835, 7, 1440x900 
0x37CA2318, 38092270777081912, 226565897, 226565905, 8, 1440x900 
0x37CA2318, 38092270778402024, 226566027, 226566036, 9, 1440x900 
0x37CA2318, 38092270779053248, 226566094, 226566102, 8, 1440x900 
0x37CA2318, 38092270779713720, 226566162, 226566170, 8, 1440x900 
0x37CA2318, 38092270780373504, 226566223, 226566230, 7, 1440x900 
0x37CA2318, 38092270781034376, 226566289, 226566296, 7, 1440x900 
0x37CA2318, 38092270781696288, 226566357, 226566365, 8, 1440x900 
0x37CA2318, 38092270782357752, 226566422, 226566431, 9, 1440x900 
0x37CA2318, 38092270783017472, 226566492, 226566500, 8, 1440x900 
0x37CA2318, 38092270783678448, 226566558, 226566566, 8, 1440x900 
0x37CA2318, 38092270784342064, 226566623, 226566631, 8, 1440x900 
0x37CA2318, 38092270785002184, 226566687, 226566696, 9, 1440x900 
0x37CA2318, 38092270785662792, 226566757, 226566765, 8, 1440x900 
0x37CA2318, 38092270786332096, 226566823, 226566831, 8, 1440x900 
0x37CA2318, 38092270786984392, 226566888, 226566897, 9, 1440x900 
0x37CA2318, 38092270787647848, 226566957, 226566965, 8, 1440x900 
0x37CA2318, 38092270788303584, 226567018, 226567026, 8, 1440x900 
0x37CA2318, 38092270788962912, 226567082, 226567091, 9, 1440x900 
0x37CA2318, 38092270789625784, 226567152, 226567160, 8, 1440x900 
0x37CA2318, 38092270790295928, 226567218, 226567226, 8, 1440x900 
0x37CA2318, 38092270790947824, 226567282, 226567291, 9, 1440x900 
0x37CA2318, 38092270791606848, 226567352, 226567360, 8, 1440x900 
0x37CA2318, 38092270792277208, 226567417, 226567425, 8, 1440x900 
0x37CA2318, 38092270792927912, 226567483, 226567491, 8, 1440x900 
0x37CA2318, 38092270793581568, 226567548, 226567556, 8, 1440x900 
0x37CA2318, 38092270794261472, 226567613, 226567622, 9, 1440x900 
0x37CA2318, 38092270794914280, 226567678, 226567687, 9, 1440x900 
0x37CA2318, 38092270795575496, 226567747, 226567755, 8, 1440x900 
0x37CA2318, 38092270796237288, 226567813, 226567821, 8, 1440x900 
0x37CA2318, 38092270796906800, 226567878, 226567886, 8, 1440x900 
0x37CA2318, 38092270797559328, 226567943, 226567951, 8, 1440x900 
0x37CA2318, 38092270798213088, 226568008, 226568017, 9, 1440x900 
0x37CA2318, 38092270798892600, 226568078, 226568086, 8, 1440x900 
0x37CA2318, 38092270799543136, 226568143, 226568152, 9, 1440x900 
0x37CA2318, 38092270800204544, 226568207, 226568216, 9, 1440x900 
0x37CA2318, 38092270800856768, 226568277, 226568285, 8, 1440x900 
0x37CA2318, 38092270801526192, 226568343, 226568351, 8, 1440x900 
0x37CA2318, 38092270802181448, 226568402, 226568411, 9, 1440x900 
0x37CA2318, 38092270802853864, 226568472, 226568480, 8, 1440x900 
0x37CA2318, 38092270803505856, 226568539, 226568547, 8, 1440x900 
0x37CA2318, 38092270804172048, 226568607, 226568615, 8, 1440x900 
0x37CA2318, 38092270804832824, 226568673, 226568681, 8, 1440x900 
0x37CA2318, 38092270805492320, 226568738, 226568746, 8, 1440x900 
0x37CA2318, 38092270806152088, 226568803, 226568811, 8, 1440x900 
0x37CA2318, 38092270806808200, 226568868, 226568875, 7, 1440x900 
0x37CA2318, 38092270807476152, 226568933, 226568941, 8, 1440x900 
0x37CA2318, 38092270808145792, 226568998, 226569005, 7, 1440x900 
0x37CA2318, 38092270808805440, 226569067, 226569074, 7, 1440x900 
0x37CA2318, 38092270809475032, 226569132, 226569140, 8, 1440x900 
0x37CA2318, 38092270810134568, 226569202, 226569209, 7, 1440x900 
0x37CA2318, 38092270810804448, 226569266, 226569273, 7, 1440x900 
0x37CA2318, 38092270811446048, 226569332, 226569339, 7, 1440x900 
0x37CA2318, 38092270812120560, 226569398, 226569406, 8, 1440x900 
0x37CA2318, 38092270812780456, 226569463, 226569472, 9, 1440x900 
0x37CA2318, 38092270813239896, 226569508, 226569516, 8, 1440x900 
0x37CA2318, 38092270814113176, 226569597, 226569604, 7, 1440x900 
0x37CA2318, 38092270814765528, 226569663, 226569670, 7, 1440x900 
0x37CA2318, 38092270815419472, 226569729, 226569737, 8, 1440x900 
0x37CA2318, 38092270816090496, 226569797, 226569805, 8, 1440x900 
0x37CA2318, 38092270816760480, 226569862, 226569871, 9, 1440x900 
0x37CA2318, 38092270817422424, 226569933, 226569941, 8, 1440x900 
0x37CA2318, 38092270818072408, 226569994, 226570002, 8, 1440x900 
0x37CA2318, 38092270818734072, 226570063, 226570072, 9, 1440x900 
0x37CA2318, 38092270819388704, 226570132, 226570140, 8, 1440x900 
0x37CA2318, 38092270820066184, 226570193, 226570202, 9, 1440x900 
0x37CA2318, 38092270820720000, 226570258, 226570267, 9, 1440x900 
0x37CA2318, 38092270821371568, 226570324, 226570333, 9, 1440x900 
0x37CA2318, 38092270822044080, 226570393, 226570402, 9, 1440x900 
0x37CA2318, 38092270822696096, 226570457, 226570465, 8, 1440x900 
0x37CA2318, 38092270823356824, 226570527, 226570535, 8, 1440x900 
0x37CA2318, 38092270824024120, 226570588, 226570596, 8, 1440x900 
0x37CA2318, 38092270824694608, 226570657, 226570665, 8, 1440x900 
0x37CA2318, 38092270825347776, 226570723, 226570730, 7, 1440x900 
0x37CA2318, 38092270826006552, 226570792, 226570799, 7, 1440x900 
0x37CA2318, 38092270826676112, 226570858, 226570866, 8, 1440x900 
0x37CA2318, 38092270827322624, 226570918, 226570926, 8, 1440x900 
0x37CA2318, 38092270827992208, 226570987, 226570995, 8, 1440x900 
0x37CA2318, 38092270828651752, 226571052, 226571060, 8, 1440x900 
0x37CA2318, 38092270829314136, 226571118, 226571126, 8, 1440x900 
0x37CA2318, 38092270829974000, 226571188, 226571196, 8, 1440x900 
0x37CA2318, 38092270830636368, 226571253, 226571261, 8, 1440x900 
0x37CA2318, 38092270831289600, 226571317, 226571325, 8, 1440x900 
0x37CA2318, 38092270831952576, 226571383, 226571391, 8, 1440x900 
0x37CA2318, 38092270832617272, 226571452, 226571459, 7, 1440x900 
0x37CA2318, 38092270833276744, 226571517, 226571525, 8, 1440x900 
0x37CA2318, 38092270833936368, 226571583, 226571591, 8, 1440x900 
0x37CA2318, 38092270834590880, 226571648, 226571656, 8, 1440x900 
0x37CA2318, 38092270835259920, 226571713, 226571721, 8, 1440x900 
0x37CA2318, 38092270835920680, 226571783, 226571791, 8, 1440x900 
0x37CA2318, 38092270836584240, 226571849, 226571856, 7, 1440x900 
0x37CA2318, 38092270837236528, 226571911, 226571919, 8, 1440x900 
0x37CA2318, 38092270837898160, 226571977, 226571985, 8, 1440x900 
0x37CA2318, 38092270838559512, 226572047, 226572055, 8, 1440x900 
0x37CA2318, 38092270839229088, 226572113, 226572121, 8, 1440x900 
0x37CA2318, 38092270839886968, 226572177, 226572185, 8, 1440x900 
0x37CA2318, 38092270840541008, 226572242, 226572250, 8, 1440x900 
0x37CA2318, 38092270841199544, 226572308, 226572315, 7, 1440x900 
0x37CA2318, 38092270841866992, 226572378, 226572386, 8, 1440x900 
0x37CA2318, 38092270842532992, 226572443, 226572451, 8, 1440x900 
0x37CA2318, 38092270843184208, 226572508, 226572516, 8, 1440x900 
0x37CA2318, 38092270843847912, 226572573, 226572581, 8, 1440x900 
0x37CA2318, 38092270844505320, 226572642, 226572650, 8, 1440x900 
0x37CA2318, 38092270845167048, 226572707, 226572714, 7, 1440x900 
0x37CA2318, 38092270845826248, 226572767, 226572775, 8, 1440x900 
0x37CA2318, 38092270846478912, 226572837, 226572845, 8, 1440x900 
0x37CA2318, 38092270847154888, 226572908, 226572916, 8, 1440x900 
0x37CA2318, 38092270847815200, 226572972, 226572980, 8, 1440x900 
0x37CA2318, 38092270848478232, 226573037, 226573045, 8, 1440x900 
0x37CA2318, 38092270849148112, 226573102, 226573110, 8, 1440x900 
0x37CA2318, 38092270849798888, 226573168, 226573176, 8, 1440x900 
0x37CA2318, 38092270850453416, 226573238, 226573245, 7, 1440x900 
0x37CA2318, 38092270851122624, 226573302, 226573310, 8, 1440x900 
0x37CA2318, 38092270851775760, 226573367, 226573375, 8, 1440x900 
0x37CA2318, 38092270852439360, 226573432, 226573440, 8, 1440x900 
0x37CA2318, 38092270853102456, 226573497, 226573505, 8, 1440x900 
0x37CA2318, 38092270853755560, 226573562, 226573571, 9, 1440x900 
0x37CA2318, 38092270854427000, 226573633, 226573641, 8, 1440x900 
0x37CA2318, 38092270855087888, 226573698, 226573706, 8, 1440x900 
0x37CA2318, 38092270855738304, 226573758, 226573766, 8, 1440x900 
0x37CA2318, 38092270856415344, 226573833, 226573840, 7, 1440x900 
0x37CA2318, 38092270857727056, 226573961, 226573968, 7, 1440x900 
0x37CA2318, 38092270858396872, 226574026, 226574033, 7, 1440x900 
0x37CA2318, 38092270859056168, 226574093, 226574101, 8, 1440x900 
0x37CA2318, 38092270859707320, 226574158, 226574167, 9, 1440x900 
0x37CA2318, 38092270860377968, 226574228, 226574236, 8, 1440x900 
0x37CA2318, 38092270861031104, 226574292, 226574300, 8, 1440x900 
0x37CA2318, 38092270861692368, 226574358, 226574366, 8, 1440x900 
0x37CA2318, 38092270862362144, 226574427, 226574435, 8, 1440x900 
0x37CA2318, 38092270863012848, 226574492, 226574500, 8, 1440x900 
0x37CA2318, 38092270863676832, 226574557, 226574565, 8, 1440x900 
0x37CA2318, 38092270864337440, 226574622, 226574630, 8, 1440x900 
0x37CA2318, 38092270865007232, 226574688, 226574697, 9, 1440x900 
0x37CA2318, 38092270865658704, 226574753, 226574762, 9, 1440x900 
0x37CA2318, 38092270866319864, 226574822, 226574830, 8, 1440x900 
0x37CA2318, 38092270866971024, 226574883, 226574892, 9, 1440x900 
0x37CA2318, 38092270867649968, 226574953, 226574960, 7, 1440x900 
0x37CA2318, 38092270868309240, 226575018, 226575026, 8, 1440x900 
0x37CA2318, 38092270868962144, 226575087, 226575095, 8, 1440x900 
0x37CA2318, 38092270869639824, 226575153, 226575161, 8, 1440x900 
0x37CA2318, 38092270870291184, 226575217, 226575225, 8, 1440x900 
0x37CA2318, 38092270870945208, 226575283, 226575290, 7, 1440x900 
0x37CA2318, 38092270871607904, 226575348, 226575357, 9, 1440x900 
0x37CA2318, 38092270872281696, 226575418, 226575426, 8, 1440x900 
0x37CA2318, 38092270872934032, 226575482, 226575490, 8, 1440x900 
0x37CA2318, 38092270873589528, 226575547, 226575555, 8, 1440x900 
0x37CA2318, 38092270874252432, 226575617, 226575625, 8, 1440x900 
0x37CA2318, 38092270874915488, 226575678, 226575687, 9, 1440x900 
0x37CA2318, 38092270875578136, 226575748, 226575756, 8, 1440x900 
0x37CA2318, 38092270876247328, 226575812, 226575821, 9, 1440x900 
0x37CA2318, 38092270876906904, 226575877, 226575884, 7, 1440x900 
0x37CA2318, 38092270877561776, 226575943, 226575952, 9, 1440x900 
0x37CA2318, 38092270878222416, 226576013, 226576021, 8, 1440x900 
0x37CA2318, 38092270878881856, 226576078, 226576086, 8, 1440x900 
0x37CA2318, 38092270879535168, 226576143, 226576151, 8, 1440x900 
0x37CA2318, 38092270880204544, 226576208, 226576216, 8, 1440x900 
0x37CA2318, 38092270880858184, 226576277, 226576285, 8, 1440x900 
0x37CA2318, 38092270881537720, 226576342, 226576350, 8, 1440x900 
0x37CA2318, 38092270882190616, 226576408, 226576416, 8, 1440x900 
0x37CA2318, 38092270882850480, 226576477, 226576485, 8, 1440x900 
0x37CA2318, 38092270883519808, 226576542, 226576550, 8, 1440x900 
0x37CA2318, 38092270884171176, 226576607, 226576615, 8, 1440x900 
0x37CA2318, 38092270884832616, 226576673, 226576681, 8, 1440x900 
0x37CA2318, 38092270885489320, 226576738, 226576746, 8, 1440x900 
0x37CA2318, 38092270886161952, 226576802, 226576811, 9, 1440x900 
0x37CA2318, 38092270886814080, 226576868, 226576877, 9, 1440x900 
0x37CA2318, 38092270887482328, 226576933, 226576940, 7, 1440x900 
0x37CA2318, 38092270888134424, 226577004, 226577012, 8, 1440x900 
0x37CA2318, 38092270888796544, 226577073, 226577081, 8, 1440x900 
0x37CA2318, 38092270889449088, 226577133, 226577141, 8, 1440x900 
0x37CA2318, 38092270890113008, 226577198, 226577206, 8, 1440x900 
0x37CA2318, 38092270890784336, 226577269, 226577277, 8, 1440x900 
0x37CA2318, 38092270891435664, 226577333, 226577341, 8, 1440x900 
0x37CA2318, 38092270892096784, 226577397, 226577405, 8, 1440x900 
0x37CA2318, 38092270892762032, 226577463, 226577471, 8, 1440x900 
0x37CA2318, 38092270893416920, 226577532, 226577540, 8, 1440x900 
0x37CA2318, 38092270894081568, 226577598, 226577606, 8, 1440x900 
0x37CA2318, 38092270894738424, 226577667, 226577675, 8, 1440x900 
0x37CA2318, 38092270895399384, 226577727, 226577735, 8, 1440x900 
0x37CA2318, 38092270896061296, 226577793, 226577801, 8, 1440x900 
0x37CA2318, 38092270896723920, 226577862, 226577870, 8, 1440x900 
0x37CA2318, 38092270897375832, 226577928, 226577936, 8, 1440x900 
0x37CA2318, 38092270898045096, 226577993, 226578001, 8, 1440x900 
0x37CA2318, 38092270898713784, 226578058, 226578064, 6, 1440x900 
0x37CA2318, 38092270899358912, 226578122, 226578130, 8, 1440x900 
0x37CA2318, 38092270900026512, 226578188, 226578196, 8, 1440x900 
0x37CA2318, 38092270900686152, 226578256, 226578263, 7, 1440x900 
0x37CA2318, 38092270901347256, 226578322, 226578329, 7, 1440x900 
0x37CA2318, 38092270902007952, 226578387, 226578394, 7, 1440x900 
0x37CA2318, 38092270902677568, 226578453, 226578461, 8, 1440x900 
0x37CA2318, 38092270903331960, 226578518, 226578525, 7, 1440x900 
0x37CA2318, 38092270904001600, 226578587, 226578594, 7, 1440x900 
0x37CA2318, 38092270904653304, 226578652, 226578659, 7, 1440x900 
0x37CA2318, 38092270905315728, 226578722, 226578730, 8, 1440x900 
0x37CA2318, 38092270905977672, 226578788, 226578796, 8, 1440x900 
0x37CA2318, 38092270906647120, 226578853, 226578861, 8, 1440x900 
0x37CA2318, 38092270907304200, 226578922, 226578931, 9, 1440x900 
0x37CA2318, 38092270907958256, 226578983, 226578990, 7, 1440x900 
0x37CA2318, 38092270908623968, 226579053, 226579061, 8, 1440x900 
0x37CA2318, 38092270909273992, 226579117, 226579126, 9, 1440x900 
0x37CA2318, 38092270909944320, 226579183, 226579191, 8, 1440x900 
0x37CA2318, 38092270910605648, 226579253, 226579261, 8, 1440x900 
0x37CA2318, 38092270911268960, 226579317, 226579325, 8, 1440x900 
0x37CA2318, 38092270911928920, 226579383, 226579391, 8, 1440x900 
0x37CA2318, 38092270912590616, 226579448, 226579456, 8, 1440x900 
0x37CA2318, 38092270913254320, 226579518, 226579526, 8, 1440x900 
0x37CA2318, 38092270913921776, 226579582, 226579590, 8, 1440x900 
0x37CA2318, 38092270914574792, 226579649, 226579657, 8, 1440x900 
0x37CA2318, 38092270915229336, 226579713, 226579721, 8, 1440x900 
0x37CA2318, 38092270915900888, 226579782, 226579790, 8, 1440x900 
0x37CA2318, 38092270916552088, 226579847, 226579855, 8, 1440x900 
0x37CA2318, 38092270917225208, 226579914, 226579922, 8, 1440x900 
0x37CA2318, 38092270917886160, 226579977, 226579985, 8, 1440x900 
0x37CA2318, 38092270918548672, 226580047, 226580055, 8, 1440x900 
0x37CA2318, 38092270919214320, 226580109, 226580117, 8, 1440x900 
0x37CA2318, 38092270919875320, 226580176, 226580183, 7, 1440x900 
0x37CA2318, 38092270920527216, 226580243, 226580251, 8, 1440x900 
0x37CA2318, 38092270921197120, 226580308, 226580316, 8, 1440x900 
0x37CA2318, 38092270921856944, 226580377, 226580385, 8, 1440x900 
0x37CA2318, 38092270922522656, 226580442, 226580450, 8, 1440x900 
0x37CA2318, 38092270923191944, 226580507, 226580515, 8, 1440x900 
0x37CA2318, 38092270923842144, 226580573, 226580581, 8, 1440x900 
0x37CA2318, 38092270924500072, 226580637, 226580646, 9, 1440x900 
0x37CA2318, 38092270925171592, 226580703, 226580712, 9, 1440x900 
0x37CA2318, 38092270925825136, 226580773, 226580781, 8, 1440x900 
0x37CA2318, 38092270926492824, 226580838, 226580846, 8, 1440x900 
0x37CA2318, 38092270927143912, 226580903, 226580911, 8, 1440x900 
0x37CA2318, 38092270927806904, 226580973, 226580981, 8, 1440x900 
0x37CA2318, 38092270928469408, 226581038, 226581046, 8, 1440x900 
0x37CA2318, 38092270929138040, 226581102, 226581110, 8, 1440x900 
0x37CA2318, 38092270929792264, 226581168, 226581176, 8, 1440x900 
0x37CA2318, 38092270930461784, 226581232, 226581239, 7, 1440x900 
0x37CA2318, 38092270931113800, 226581298, 226581306, 8, 1440x900 
0x37CA2318, 38092270931782264, 226581368, 226581376, 8, 1440x900 
0x37CA2318, 38092270932432800, 226581433, 226581441, 8, 1440x900 
0x37CA2318, 38092270933088840, 226581497, 226581505, 8, 1440x900 
0x37CA2318, 38092270933751816, 226581563, 226581572, 9, 1440x900 
0x37CA2318, 38092270934418904, 226581628, 226581637, 9, 1440x900 
0x37CA2318, 38092270935072528, 226581697, 226581705, 8, 1440x900 
0x37CA2318, 38092270936393824, 226581827, 226581835, 8, 1440x900 
0x37CA2318, 38092270937053504, 226581893, 226581901, 8, 1440x900 
0x37CA2318, 38092270937714248, 226581958, 226581966, 8, 1440x900 
0x37CA2318, 38092270938374520, 226582028, 226582036, 8, 1440x900 
0x37CA2318, 38092270939043056, 226582092, 226582099, 7, 1440x900 
0x37CA2318, 38092270939703408, 226582157, 226582165, 8, 1440x900 
0x37CA2318, 38092270940369896, 226582223, 226582230, 7, 1440x900 
0x37CA2318, 38092270941033360, 226582288, 226582296, 8, 1440x900 
0x37CA2318, 38092270941699752, 226582357, 226582364, 7, 1440x900 
0x37CA2318, 38092270942354400, 226582422, 226582430, 8, 1440x900 
0x37CA2318, 38092270943014320, 226582489, 226582496, 7, 1440x900 
0x37CA2318, 38092270943676760, 226582558, 226582566, 8, 1440x900 
0x37CA2318, 38092270944342896, 226582622, 226582630, 8, 1440x900 
0x37CA2318, 38092270945002952, 226582687, 226582695, 8, 1440x900 
0x37CA2318, 38092270945665880, 226582757, 226582764, 7, 1440x900 
0x37CA2318, 38092270946326224, 226582823, 226582831, 8, 1440x900 
0x37CA2318, 38092270946978680, 226582888, 226582896, 8, 1440x900 
0x37CA2318, 38092270947643720, 226582953, 226582961, 8, 1440x900 
0x37CA2318, 38092270948305600, 226583023, 226583031, 8, 1440x900 
0x37CA2318, 38092270948958752, 226583088, 226583096, 8, 1440x900 
0x37CA2318, 38092270949621816, 226583148, 226583155, 7, 1440x900 
0x37CA2318, 38092270950288912, 226583217, 226583225, 8, 1440x900 
0x37CA2318, 38092270950947328, 226583281, 226583289, 8, 1440x900 
0x37CA2318, 38092270951602056, 226583346, 226583354, 8, 1440x900 
0x37CA2318, 38092270952268296, 226583418, 226583426, 8, 1440x900 
0x37CA2318, 38092270952919280, 226583478, 226583485, 7, 1440x900 
0x37CA2318, 38092270953590080, 226583546, 226583553, 7, 1440x900 
0x37CA2318, 38092270954253072, 226583612, 226583619, 7, 1440x900 
0x37CA2318, 38092270954907832, 226583677, 226583685, 8, 1440x900 
0x37CA2318, 38092270955588216, 226583748, 226583756, 8, 1440x900 
0x37CA2318, 38092270956241208, 226583812, 226583820, 8, 1440x900 
0x37CA2318, 38092270956901968, 226583877, 226583885, 8, 1440x900 
0x37CA2318, 38092270957571488, 226583943, 226583952, 9, 1440x900 
0x37CA2318, 38092270958225288, 226584013, 226584021, 8, 1440x900 
0x37CA2318, 38092270958880560, 226584078, 226584086, 8, 1440x900 
0x37CA2318, 38092270959551200, 226584147, 226584155, 8, 1440x900 
0x37CA2318, 38092270960220704, 226584212, 226584220, 8, 1440x900 
0x37CA2318, 38092270960871456, 226584277, 226584285, 8, 1440x900 
0x37CA2318, 38092270961532256, 226584342, 226584350, 8, 1440x900 
0x37CA2318, 38092270962191936, 226584407, 226584415, 8, 1440x900 
0x37CA2318, 38092270962853152, 226584472, 226584480, 8, 1440x900 
0x37CA2318, 38092270963505152, 226584538, 226584545, 7, 1440x900 
0x37CA2318, 38092270964175032, 226584608, 226584616, 8, 1440x900 
0x37CA2318, 38092270964837424, 226584672, 226584680, 8, 1440x900 
0x37CA2318, 38092270965506496, 226584738, 226584746, 8, 1440x900 
0x37CA2318, 38092270966166664, 226584803, 226584812, 9, 1440x900 
0x37CA2318, 38092270966822016, 226584868, 226584875, 7, 1440x900 
0x37CA2318, 38092270967474720, 226584934, 226584941, 7, 1440x900 
0x37CA2318, 38092270968147824, 226585002, 226585010, 8, 1440x900 
0x37CA2318, 38092270968799912, 226585067, 226585074, 7, 1440x900 
0x37CA2318, 38092270969454912, 226585133, 226585142, 9, 1440x900 
0x37CA2318, 38092270970117160, 226585202, 226585210, 8, 1440x900 
0x37CA2318, 38092270970796488, 226585268, 226585276, 8, 1440x900 
0x37CA2318, 38092270971456440, 226585333, 226585342, 9, 1440x900 
0x37CA2318, 38092270972116384, 226585402, 226585410, 8, 1440x900 
0x37CA2318, 38092270972776384, 226585467, 226585475, 8, 1440x900 
0x37CA2318, 38092270973438336, 226585532, 226585540, 8, 1440x900 
0x37CA2318, 38092270974094344, 226585597, 226585605, 8, 1440x900 
0x37CA2318, 38092270974751280, 226585667, 226585675, 8, 1440x900 
0x37CA2318, 38092270975415792, 226585733, 226585741, 8, 1440x900 
0x37CA2318, 38092270976069288, 226585794, 226585802, 8, 1440x900 
0x37CA2318, 38092270976736344, 226585862, 226585870, 8, 1440x900 
0x37CA2318, 38092270977403176, 226585928, 226585936, 8, 1440x900 
0x37CA2318, 38092270978054416, 226585994, 226586002, 8, 1440x900 
0x37CA2318, 38092270978722232, 226586058, 226586067, 9, 1440x900 
0x37CA2318, 38092270979375216, 226586128, 226586136, 8, 1440x900 
0x37CA2318, 38092270980035216, 226586191, 226586199, 8, 1440x900 
0x37CA2318, 38092270980696024, 226586257, 226586265, 8, 1440x900 
0x37CA2318, 38092270981353424, 226586322, 226586330, 8, 1440x900 
0x37CA2318, 38092270982029120, 226586393, 226586401, 8, 1440x900 
0x37CA2318, 38092270982681608, 226586457, 226586465, 8, 1440x900 
0x37CA2318, 38092270983333288, 226586523, 226586531, 8, 1440x900 
0x37CA2318, 38092270983994984, 226586589, 226586597, 8, 1440x900 
0x37CA2318, 38092270984656680, 226586652, 226586661, 9, 1440x900 
0x37CA2318, 38092270985320976, 226586722, 226586730, 8, 1440x900 
0x37CA2318, 38092270985982176, 226586787, 226586795, 8, 1440x900 
0x37CA2318, 38092270986648456, 226586857, 226586865, 8, 1440x900 
0x37CA2318, 38092270987310304, 226586918, 226586926, 8, 1440x900 
0x37CA2318, 38092270987971456, 226586987, 226586995, 8, 1440x900 
0x37CA2318, 38092270988619784, 226587052, 226587060, 8, 1440x900 
0x37CA2318, 38092270989283120, 226587118, 226587127, 9, 1440x900 
0x37CA2318, 38092270989946272, 226587184, 226587192, 8, 1440x900 
0x37CA2318, 38092270990616480, 226587253, 226587261, 8, 1440x900 
0x37CA2318, 38092270991272808, 226587313, 226587322, 9, 1440x900 
0x37CA2318, 38092270991929688, 226587382, 226587390, 8, 1440x900 
0x37CA2318, 38092270992590096, 226587448, 226587456, 8, 1440x900 
0x37CA2318, 38092270993250208, 226587512, 226587520, 8, 1440x900 
0x37CA2318, 38092270993918216, 226587582, 226587590, 8, 1440x900 
0x37CA2318, 38092270994572112, 226587648, 226587656, 8, 1440x900 
0x37CA2318, 38092270995229664, 226587712, 226587720, 8, 1440x900 
0x37CA2318, 38092270995891080, 226587778, 226587786, 8, 1440x900 
0x37CA2318, 38092270996556392, 226587848, 226587856, 8, 1440x900 
0x37CA2318, 38092270997208352, 226587907, 226587916, 9, 1440x900 
0x37CA2318, 38092270997877728, 226587977, 226587985, 8, 1440x900 
0x37CA2318, 38092270998538672, 226588047, 226588055, 8, 1440x900 
0x37CA2318, 38092270999204800, 226588107, 226588114, 7, 1440x900 
0x37CA2318, 38092270999866992, 226588178, 226588186, 8, 1440x900 
0x37CA2318, 38092271000526496, 226588238, 226588245, 7, 1440x900 
0x37CA2318, 38092271001188744, 226588303, 226588311, 8, 1440x900 
0x37CA2318, 38092271001857776, 226588372, 226588379, 7, 1440x900 
0x37CA2318, 38092271002509768, 226588437, 226588444, 7, 1440x900 
0x37CA2318, 38092271003171080, 226588508, 226588517, 9, 1440x900 
0x37CA2318, 38092271003822720, 226588571, 226588579, 8, 1440x900 
0x37CA2318, 38092271004493744, 226588637, 226588645, 8, 1440x900 
0x37CA2318, 38092271005163016, 226588707, 226588715, 8, 1440x900 
0x37CA2318, 38092271005813800, 226588769, 226588776, 7, 1440x900 
0x37CA2318, 38092271006478144, 226588838, 226588847, 9, 1440x900 
0x37CA2318, 38092271007138848, 226588902, 226588910, 8, 1440x900 
0x37CA2318, 38092271007790104, 226588967, 226588975, 8, 1440x900 
0x37CA2318, 38092271008450632, 226589032, 226589041, 9, 1440x900 
0x37CA2318, 38092271009119608, 226589098, 226589107, 9, 1440x900 
0x37CA2318, 38092271009780608, 226589167, 226589175, 8, 1440x900 
0x37CA2318, 38092271010447032, 226589238, 226589246, 8, 1440x900 
0x37CA2318, 38092271011115464, 226589303, 226589311, 8, 1440x900 
0x37CA2318, 38092271011767736, 226589363, 226589372, 9, 1440x900 
0x37CA2318, 38092271012423880, 226589432, 226589440, 8, 1440x900 
0x37CA2318, 38092271013089488, 226589498, 226589506, 8, 1440x900 
0x37CA2318, 38092271013740568, 226589563, 226589571, 8, 1440x900 
0x37CA2318, 38092271014413888, 226589632, 226589640, 8, 1440x900 
0x37CA2318, 38092271015726424, 226589763, 226589771, 8, 1440x900 
0x37CA2318, 38092271016390504, 226589827, 226589835, 8, 1440x900 
0x37CA2318, 38092271017046200, 226589893, 226589901, 8, 1440x900 
0x37CA2318, 38092271017712960, 226589958, 226589966, 8, 1440x900 
0x37CA2318, 38092271018377616, 226590027, 226590035, 8, 1440x900 
0x37CA2318, 38092271019029144, 226590093, 226590101, 8, 1440x900 
0x37CA2318, 38092271019689640, 226590156, 226590164, 8, 1440x900 
0x37CA2318, 38092271020369904, 226590228, 226590236, 8, 1440x900 
0x37CA2318, 38092271021022064, 226590293, 226590301, 8, 1440x900 
0x37CA2318, 38092271021679768, 226590357, 226590365, 8, 1440x900 
0x37CA2318, 38092271022349608, 226590422, 226590430, 8, 1440x900 
0x37CA2318, 38092271023000448, 226590487, 226590495, 8, 1440x900 
0x37CA2318, 38092271023654888, 226590558, 226590566, 8, 1440x900 
0x37CA2318, 38092271024321152, 226590623, 226590631, 8, 1440x900 
0x37CA2318, 38092271024989584, 226590688, 226590696, 8, 1440x900 
0x37CA2318, 38092271025643120, 226590752, 226590761, 9, 1440x900 
0x37CA2318, 38092271026301008, 226590818, 226590826, 8, 1440x900 
0x37CA2318, 38092271026963232, 226590887, 226590895, 8, 1440x900 
0x37CA2318, 38092271027618104, 226590953, 226590961, 8, 1440x900 
0x37CA2318, 38092271028283128, 226591018, 226591026, 8, 1440x900 
0x37CA2318, 38092271028936304, 226591083, 226591091, 8, 1440x900 
0x37CA2318, 38092271029599696, 226591147, 226591155, 8, 1440x900 
0x37CA2318, 38092271030262464, 226591213, 226591221, 8, 1440x900 
0x37CA2318, 38092271030930824, 226591283, 226591291, 8, 1440x900 
0x37CA2318, 38092271031590864, 226591348, 226591356, 8, 1440x900 
0x37CA2318, 38092271032243296, 226591417, 226591425, 8, 1440x900 
0x37CA2318, 38092271032906448, 226591478, 226591486, 8, 1440x900 
0x37CA2318, 38092271033571360, 226591548, 226591556, 8, 1440x900 
0x37CA2318, 38092271034231064, 226591613, 226591621, 8, 1440x900 
0x37CA2318, 38092271034893512, 226591677, 226591686, 9, 1440x900 
0x37CA2318, 38092271035550136, 226591742, 226591751, 9, 1440x900 
0x37CA2318, 38092271036210840, 226591812, 226591820, 8, 1440x900 
0x37CA2318, 38092271036880168, 226591878, 226591886, 8, 1440x900 
0x37CA2318, 38092271037539296, 226591942, 226591950, 8, 1440x900 
0x37CA2318, 38092271038192832, 226592008, 226592016, 8, 1440x900 
0x37CA2318, 38092271038854192, 226592074, 226592081, 7, 1440x900 
0x37CA2318, 38092271039523816, 226592141, 226592149, 8, 1440x900 
0x37CA2318, 38092271040174952, 226592203, 226592212, 9, 1440x900 
0x37CA2318, 38092271040832704, 226592273, 226592281, 8, 1440x900 
0x37CA2318, 38092271041492864, 226592337, 226592344, 7, 1440x900 
0x37CA2318, 38092271042155768, 226592403, 226592412, 9, 1440x900 
0x37CA2318, 38092271042806880, 226592467, 226592474, 7, 1440x900 
0x37CA2318, 38092271043477608, 226592533, 226592542, 9, 1440x900 
0x37CA2318, 38092271044129544, 226592603, 226592610, 7, 1440x900 
0x37CA2318, 38092271044800160, 226592667, 226592675, 8, 1440x900 
0x37CA2318, 38092271045468072, 226592733, 226592742, 9, 1440x900 
0x37CA2318, 38092271046114224, 226592798, 226592806, 8, 1440x900 
0x37CA2318, 38092271046783752, 226592868, 226592875, 7, 1440x900 
0x37CA2318, 38092271047443296, 226592933, 226592941, 8, 1440x900 
0x37CA2318, 38092271048110184, 226593002, 226593010, 8, 1440x900 
0x37CA2318, 38092271048762256, 226593067, 226593075, 8, 1440x900 
0x37CA2318, 38092271049432384, 226593133, 226593140, 7, 1440x900 
0x37CA2318, 38092271049934592, 226593177, 226593185, 8, 1440x900 
0x37CA2318, 38092271050760048, 226593262, 226593269, 7, 1440x900 
0x37CA2318, 38092271051428216, 226593327, 226593335, 8, 1440x900 
0x37CA2318, 38092271052074320, 226593393, 226593400, 7, 1440x900 
0x37CA2318, 38092271052745536, 226593462, 226593469, 7, 1440x900 
0x37CA2318, 38092271053405304, 226593527, 226593534, 7, 1440x900 
0x37CA2318, 38092271054066896, 226593598, 226593606, 8, 1440x900 
0x37CA2318, 38092271054721320, 226593659, 226593667, 8, 1440x900 
0x37CA2318, 38092271055300416, 226593717, 226593724, 7, 1440x900 
0x37CA2318, 38092271055849352, 226593772, 226593779, 7, 1440x900 
0x37CA2318, 38092271056705592, 226593862, 226593870, 8, 1440x900 
0x37CA2318, 38092271057368648, 226593928, 226593936, 8, 1440x900 
0x37CA2318, 38092271058027680, 226593992, 226594000, 8, 1440x900 
0x37CA2318, 38092271058695128, 226594058, 226594066, 8, 1440x900 
0x37CA2318, 38092271059347000, 226594127, 226594135, 8, 1440x900 
0x37CA2318, 38092271060006832, 226594188, 226594196, 8, 1440x900 
0x37CA2318, 38092271060671656, 226594258, 226594266, 8, 1440x900 
0x37CA2318, 38092271061332456, 226594323, 226594331, 8, 1440x900 
0x37CA2318, 38092271061993432, 226594388, 226594397, 9, 1440x900 
0x37CA2318, 38092271062645536, 226594453, 226594461, 8, 1440x900 
0x37CA2318, 38092271063316872, 226594518, 226594527, 9, 1440x900 
0x37CA2318, 38092271063971992, 226594588, 226594596, 8, 1440x900 
0x37CA2318, 38092271064642640, 226594653, 226594662, 9, 1440x900 
0x37CA2318, 38092271065297312, 226594717, 226594725, 8, 1440x900 
0x37CA2318, 38092271065971504, 226594787, 226594795, 8, 1440x900 
0x37CA2318, 38092271066632528, 226594853, 226594861, 8, 1440x900 
0x37CA2318, 38092271067292832, 226594918, 226594926, 8, 1440x900 
0x37CA2318, 38092271067954640, 226594983, 226594991, 8, 1440x900 
0x37CA2318, 38092271068606888, 226595048, 226595056, 8, 1440x900 
0x37CA2318, 38092271069285256, 226595117, 226595125, 8, 1440x900 
0x37CA2318, 38092271069943864, 226595183, 226595191, 8, 1440x900 
0x37CA2318, 38092271070598976, 226595247, 226595255, 8, 1440x900 
0x37CA2318, 38092271071259184, 226595312, 226595319, 7, 1440x900 
0x37CA2318, 38092271071918704, 226595382, 226595390, 8, 1440x900 
0x37CA2318, 38092271072579944, 226595447, 226595455, 8, 1440x900 
0x37CA2318, 38092271073229672, 226595512, 226595520, 8, 1440x900 
0x37CA2318, 38092271073895344, 226595578, 226595586, 8, 1440x900 
0x37CA2318, 38092271074556840, 226595647, 226595655, 8, 1440x900 
0x37CA2318, 38092271075220256, 226595709, 226595717, 8, 1440x900 
0x37CA2318, 38092271075882208, 226595777, 226595785, 8, 1440x900 
0x37CA2318, 38092271076532824, 226595843, 226595851, 8, 1440x900 
0x37CA2318, 38092271077204312, 226595907, 226595916, 9, 1440x900 
0x37CA2318, 38092271077865336, 226595978, 226595986, 8, 1440x900 
0x37CA2318, 38092271078533752, 226596043, 226596052, 9, 1440x900 
0x37CA2318, 38092271079182896, 226596108, 226596116, 8, 1440x900 
0x37CA2318, 38092271079846800, 226596173, 226596181, 8, 1440x900 
0x37CA2318, 38092271080506544, 226596242, 226596250, 8, 1440x900 
0x37CA2318, 38092271081168120, 226596303, 226596312, 9, 1440x900 
0x37CA2318, 38092271081828984, 226596373, 226596380, 7, 1440x900 
0x37CA2318, 38092271082490032, 226596438, 226596446, 8, 1440x900 
0x37CA2318, 38092271083151440, 226596507, 226596515, 8, 1440x900 
0x37CA2318, 38092271083821568, 226596573, 226596581, 8, 1440x900 
0x37CA2318, 38092271084481712, 226596637, 226596645, 8, 1440x900 
0x37CA2318, 38092271085132520, 226596702, 226596710, 8, 1440x900 
0x37CA2318, 38092271085786896, 226596767, 226596775, 8, 1440x900 
0x37CA2318, 38092271086456496, 226596837, 226596845, 8, 1440x900 
0x37CA2318, 38092271087108032, 226596898, 226596907, 9, 1440x900 
0x37CA2318, 38092271087778704, 226596968, 226596976, 8, 1440x900 
0x37CA2318, 38092271088440080, 226597032, 226597040, 8, 1440x900 
0x37CA2318, 38092271089101816, 226597102, 226597110, 8, 1440x900 
0x37CA2318, 38092271089762648, 226597163, 226597172, 9, 1440x900 
0x37CA2318, 38092271090431832, 226597232, 226597240, 8, 1440x900 
0x37CA2318, 38092271091082696, 226597298, 226597307, 9, 1440x900 
0x37CA2318, 38092271091743192, 226597363, 226597371, 8, 1440x900 
0x37CA2318, 38092271092403544, 226597429, 226597437, 8, 1440x900 
0x37CA2318, 38092271093723464, 226597562, 226597570, 8, 1440x900 
0x37CA2318, 38092271094378184, 226597628, 226597636, 8, 1440x900 
0x37CA2318, 38092271095044616, 226597693, 226597701, 8, 1440x900 
0x37CA2318, 38092271095709200, 226597758, 226597766, 8, 1440x900 
0x37CA2318, 38092271096375840, 226597828, 226597836, 8, 1440x900 
0x37CA2318, 38092271097026184, 226597893, 226597901, 8, 1440x900 
0x37CA2318, 38092271097689320, 226597958, 226597966, 8, 1440x900 
0x37CA2318, 38092271098342928, 226598023, 226598031, 8, 1440x900 
0x37CA2318, 38092271099016552, 226598089, 226598097, 8, 1440x900 
0x37CA2318, 38092271099676768, 226598158, 226598166, 8, 1440x900 
0x37CA2318, 38092271100330896, 226598223, 226598231, 8, 1440x900 
0x37CA2318, 38092271100991040, 226598287, 226598295, 8, 1440x900 
0x37CA2318, 38092271101652688, 226598352, 226598360, 8, 1440x900 
0x37CA2318, 38092271102313424, 226598423, 226598432, 9, 1440x900 
0x37CA2318, 38092271102968776, 226598488, 226598496, 8, 1440x900 
0x37CA2318, 38092271103636352, 226598553, 226598561, 8, 1440x900 
0x37CA2318, 38092271104305032, 226598617, 226598624, 7, 1440x900 
0x37CA2318, 38092271104957320, 226598683, 226598692, 9, 1440x900 
0x37CA2318, 38092271105617696, 226598753, 226598761, 8, 1440x900 
0x37CA2318, 38092271106282240, 226598818, 226598826, 8, 1440x900 
0x37CA2318, 38092271106934112, 226598884, 226598892, 8, 1440x900 
0x37CA2318, 38092271107607312, 226598948, 226598956, 8, 1440x900 
0x37CA2318, 38092271108257464, 226599013, 226599021, 8, 1440x900 
0x37CA2318, 38092271108928264, 226599082, 226599090, 8, 1440x900 
0x37CA2318, 38092271109581104, 226599148, 226599156, 8, 1440x900 
0x37CA2318, 38092271110233208, 226599213, 226599222, 9, 1440x900 
0x37CA2318, 38092271110903680, 226599277, 226599285, 8, 1440x900 
0x37CA2318, 38092271111561568, 226599343, 226599351, 8, 1440x900 
0x37CA2318, 38092271112225920, 226599413, 226599421, 8, 1440x900 
0x37CA2318, 38092271112885960, 226599476, 226599484, 8, 1440x900 
0x37CA2318, 38092271113546128, 226599542, 226599549, 7, 1440x900 
0x37CA2318, 38092271114202848, 226599607, 226599615, 8, 1440x900 
0x37CA2318, 38092271114870440, 226599673, 226599680, 7, 1440x900 
0x37CA2318, 38092271115531272, 226599738, 226599746, 8, 1440x900 
0x37CA2318, 38092271116182360, 226599803, 226599811, 8, 1440x900 
0x37CA2318, 38092271116853112, 226599872, 226599880, 8, 1440x900 
0x37CA2318, 38092271117514568, 226599938, 226599945, 7, 1440x900 
0x37CA2318, 38092271118175680, 226600006, 226600014, 8, 1440x900 
0x37CA2318, 38092271118828024, 226600068, 226600076, 8, 1440x900 
0x37CA2318, 38092271119498856, 226600137, 226600145, 8, 1440x900 
0x37CA2318, 38092271120163952, 226600202, 226600209, 7, 1440x900 
0x37CA2318, 38092271120824656, 226600273, 226600281, 8, 1440x900 
0x37CA2318, 38092271121488344, 226600338, 226600346, 8, 1440x900 
0x37CA2318, 38092271122141400, 226600402, 226600410, 8, 1440x900 
0x37CA2318, 38092271122819784, 226600471, 226600479, 8, 1440x900 
0x37CA2318, 38092271123471704, 226600537, 226600545, 8, 1440x900 
0x37CA2318, 38092271124132032, 226600602, 226600610, 8, 1440x900 
0x37CA2318, 38092271124796496, 226600668, 226600676, 8, 1440x900 
0x37CA2318, 38092271125452624, 226600732, 226600740, 8, 1440x900 
0x37CA2318, 38092271126113640, 226600798, 226600807, 9, 1440x900 
0x37CA2318, 38092271126775936, 226600868, 226600876, 8, 1440x900 
0x37CA2318, 38092271127436552, 226600933, 226600941, 8, 1440x900 
0x37CA2318, 38092271128097960, 226600997, 226601006, 9, 1440x900 
0x37CA2318, 38092271128751168, 226601063, 226601071, 8, 1440x900 
0x37CA2318, 38092271129420104, 226601133, 226601141, 8, 1440x900 
0x37CA2318, 38092271130081752, 226601198, 226601206, 8, 1440x900 
0x37CA2318, 38092271130743864, 226601262, 226601271, 9, 1440x900 
0x37CA2318, 38092271131401768, 226601328, 226601336, 8, 1440x900 
0x37CA2318, 38092271132060552, 226601398, 226601441, 43, 1440x900 
0x37CA2318, 38092271132819120, 226601467, 226601501, 34, 1440x900 
0x37CA2318, 38092271133379232, 226601522, 226601530, 8, 1440x900 
0x37CA2318, 38092271134044304, 226601592, 226601599, 7, 1440x900 
0x37CA2318, 38092271134705200, 226601659, 226601667, 8, 1440x900 
0x37CA2318, 38092271135359536, 226601723, 226601731, 8, 1440x900 
0x37CA2318, 38092271136018800, 226601788, 226601796, 8, 1440x900 
0x37CA2318, 38092271136680280, 226601853, 226601861, 8, 1440x900 
0x37CA2318, 38092271137343376, 226601918, 226601926, 8, 1440x900 
0x37CA2318, 38092271138003984, 226601987, 226601996, 9, 1440x900 
0x37CA2318, 38092271138663752, 226602057, 226602065, 8, 1440x900 
0x37CA2318, 38092271139323784, 226602119, 226602127, 8, 1440x900 
0x37CA2318, 38092271139984040, 226602188, 226602196, 8, 1440x900 
0x37CA2318, 38092271140636352, 226602253, 226602261, 8, 1440x900 
0x37CA2318, 38092271141308656, 226602318, 226602326, 8, 1440x900 
0x37CA2318, 38092271141969632, 226602387, 226602395, 8, 1440x900 
0x37CA2318, 38092271142623352, 226602452, 226602460, 8, 1440x900 
0x37CA2318, 38092271143283032, 226602513, 226602521, 8, 1440x900 
0x37CA2318, 38092271143946136, 226602582, 226602589, 7, 1440x900 
0x37CA2318, 38092271144605760, 226602648, 226602655, 7, 1440x900 
0x37CA2318, 38092271145268608, 226602718, 226602726, 8, 1440x900 
0x37CA2318, 38092271145925656, 226602783, 226602791, 8, 1440x900 
0x37CA2318, 38092271146585600, 226602848, 226602856, 8, 1440x900 
0x37CA2318, 38092271147245480, 226602912, 226602919, 7, 1440x900 
0x37CA2318, 38092271147915688, 226602982, 226602990, 8, 1440x900 
0x37CA2318, 38092271148566680, 226603048, 226603056, 8, 1440x900 
0x37CA2318, 38092271149227824, 226603112, 226603120, 8, 1440x900 
0x37CA2318, 38092271149895520, 226603179, 226603191, 12, 1440x900 
0x37CA2318, 38092271150551320, 226603241, 226603248, 7, 1440x900 
0x37CA2318, 38092271151219992, 226603307, 226603316, 9, 1440x900 
0x37CA2318, 38092271151879296, 226603373, 226603381, 8, 1440x900 
0x37CA2318, 38092271152532496, 226603438, 226603446, 8, 1440x900 
0x37CA2318, 38092271153193200, 226603508, 226603515, 7, 1440x900 
0x37CA2318, 38092271153857040, 226603572, 226603580, 8, 1440x900 
0x37CA2318, 38092271154516232, 226603637, 226603645, 8, 1440x900 
0x37CA2318, 38092271155236688, 226603707, 226603720, 13, 1440x900 
0x37CA2318, 38092271155828392, 226603768, 226603776, 8, 1440x900 
0x37CA2318, 38092271156499328, 226603838, 226603845, 7, 1440x900 
0x37CA2318, 38092271157151560, 226603902, 226603909, 7, 1440x900 
0x37CA2318, 38092271157826800, 226603972, 226603980, 8, 1440x900 
0x37CA2318, 38092271158482024, 226604033, 226604041, 8, 1440x900 
0x37CA2318, 38092271159134944, 226604098, 226604106, 8, 1440x900 
0x37CA2318, 38092271159795480, 226604167, 226604174, 7, 1440x900 
0x37CA2318, 38092271160466136, 226604232, 226604239, 7, 1440x900 
0x37CA2318, 38092271161127016, 226604303, 226604311, 8, 1440x900 
0x37CA2318, 38092271161791712, 226604367, 226604375, 8, 1440x900 
0x37CA2318, 38092271162443440, 226604433, 226604441, 8, 1440x900 
0x37CA2318, 38092271163115192, 226604503, 226604510, 7, 1440x900 
0x37CA2318, 38092271163776120, 226604563, 226604572, 9, 1440x900 
0x37CA2318, 38092271164445824, 226604632, 226604640, 8, 1440x900 
0x37CA2318, 38092271165098672, 226604703, 226604711, 8, 1440x900 
0x37CA2318, 38092271165751360, 226604762, 226604770, 8, 1440x900 
0x37CA2318, 38092271166430384, 226604833, 226604841, 8, 1440x900 
0x37CA2318, 38092271167081904, 226604897, 226604905, 8, 1440x900 
0x37CA2318, 38092271167742840, 226604962, 226604970, 8, 1440x900 
0x37CA2318, 38092271168407584, 226605033, 226605040, 7, 1440x900 
0x37CA2318, 38092271169726056, 226605163, 226605170, 7, 1440x900 
0x37CA2318, 38092271170392608, 226605227, 226605235, 8, 1440x900 
0x37CA2318, 38092271171044560, 226605294, 226605302, 8, 1440x900 
0x37CA2318, 38092271171706888, 226605362, 226605370, 8, 1440x900 
0x37CA2318, 38092271172366104, 226605427, 226605434, 7, 1440x900 
0x37CA2318, 38092271173035720, 226605493, 226605501, 8, 1440x900 
0x37CA2318, 38092271173695144, 226605557, 226605564, 7, 1440x900 
0x37CA2318, 38092271174342712, 226605618, 226605626, 8, 1440x900 
0x37CA2318, 38092271175010416, 226605687, 226605694, 7, 1440x900 
0x37CA2318, 38092271175670944, 226605753, 226605760, 7, 1440x900 
0x37CA2318, 38092271176324824, 226605822, 226605830, 8, 1440x900 
0x37CA2318, 38092271177002296, 226605888, 226605896, 8, 1440x900 
0x37CA2318, 38092271177655784, 226605957, 226605965, 8, 1440x900 
0x37CA2318, 38092271178317944, 226606018, 226606027, 9, 1440x900 
0x37CA2318, 38092271178969632, 226606088, 226606096, 8, 1440x900 
0x37CA2318, 38092271179632296, 226606152, 226606160, 8, 1440x900 
0x37CA2318, 38092271180297472, 226606217, 226606225, 8, 1440x900 
0x37CA2318, 38092271180960960, 226606288, 226606296, 8, 1440x900 
0x37CA2318, 38092271181613952, 226606348, 226606356, 8, 1440x900 
0x37CA2318, 38092271182284808, 226606418, 226606426, 8, 1440x900 
0x37CA2318, 38092271182936208, 226606482, 226606489, 7, 1440x900 
0x37CA2318, 38092271183598800, 226606547, 226606555, 8, 1440x900 
0x37CA2318, 38092271184259640, 226606612, 226606620, 8, 1440x900 
0x37CA2318, 38092271184925040, 226606678, 226606686, 8, 1440x900 
0x37CA2318, 38092271185584992, 226606747, 226606755, 8, 1440x900 
0x37CA2318, 38092271186243040, 226606813, 226606821, 8, 1440x900 
0x37CA2318, 38092271186909616, 226606878, 226606886, 8, 1440x900 
0x37CA2318, 38092271187575600, 226606948, 226606956, 8, 1440x900 
0x37CA2318, 38092271188236728, 226607012, 226607020, 8, 1440x900 
0x37CA2318, 38092271188898904, 226607077, 226607086, 9, 1440x900 
0x37CA2318, 38092271189555024, 226607144, 226607152, 8, 1440x900 
0x37CA2318, 38092271190219008, 226607213, 226607221, 8, 1440x900 
0x37CA2318, 38092271190888440, 226607273, 226607281, 8, 1440x900 
0x37CA2318, 38092271191538928, 226607342, 226607350, 8, 1440x900 
0x37CA2318, 38092271192203192, 226607407, 226607415, 8, 1440x900 
0x37CA2318, 38092271192863376, 226607473, 226607481, 8, 1440x900 
0x37CA2318, 38092271193525272, 226607543, 226607551, 8, 1440x900 
0x37CA2318, 38092271194187272, 226607607, 226607615, 8, 1440x900 
0x37CA2318, 38092271194839368, 226607673, 226607681, 8, 1440x900 
0x37CA2318, 38092271195504696, 226607739, 226607746, 7, 1440x900 
0x37CA2318, 38092271196165584, 226607808, 226607816, 8, 1440x900 
0x37CA2318, 38092271196836304, 226607872, 226607879, 7, 1440x900 
0x37CA2318, 38092271197491136, 226607938, 226607946, 8, 1440x900 
0x37CA2318, 38092271198151480, 226608002, 226608010, 8, 1440x900 
0x37CA2318, 38092271198815752, 226608069, 226608077, 8, 1440x900 
0x37CA2318, 38092271199469552, 226608137, 226608145, 8, 1440x900 
0x37CA2318, 38092271200131320, 226608202, 226608210, 8, 1440x900 
0x37CA2318, 38092271200792728, 226608267, 226608275, 8, 1440x900 
0x37CA2318, 38092271201448784, 226608338, 226608346, 8, 1440x900 
0x37CA2318, 38092271202110672, 226608397, 226608406, 9, 1440x900 
0x37CA2318, 38092271202780688, 226608468, 226608476, 8, 1440x900 
0x37CA2318, 38092271203441168, 226608533, 226608541, 8, 1440x900 
0x37CA2318, 38092271204094688, 226608598, 226608605, 7, 1440x900 
0x37CA2318, 38092271204744944, 226608663, 226608671, 8, 1440x900 
0x37CA2318, 38092271205417168, 226608728, 226608737, 9, 1440x900 
0x37CA2318, 38092271206075456, 226608797, 226608805, 8, 1440x900 
0x37CA2318, 38092271206739944, 226608863, 226608871, 8, 1440x900 
0x37CA2318, 38092271207401344, 226608928, 226608936, 8, 1440x900 
0x37CA2318, 38092271208052704, 226608992, 226609000, 8, 1440x900 
0x37CA2318, 38092271208715168, 226609063, 226609071, 8, 1440x900 
0x37CA2318, 38092271209369728, 226609128, 226609136, 8, 1440x900 
0x37CA2318, 38092271210041424, 226609193, 226609201, 8, 1440x900 
0x37CA2318, 38092271210702392, 226609258, 226609266, 8, 1440x900 
0x37CA2318, 38092271211354032, 226609324, 226609331, 7, 1440x900 
0x37CA2318, 38092271212014792, 226609388, 226609395, 7, 1440x900 
0x37CA2318, 38092271212675816, 226609453, 226609461, 8, 1440x900 
0x37CA2318, 38092271213337152, 226609522, 226609530, 8, 1440x900 
0x37CA2318, 38092271214000784, 226609592, 226609600, 8, 1440x900 
0x37CA2318, 38092271214661216, 226609653, 226609661, 8, 1440x900 
0x37CA2318, 38092271215322408, 226609718, 226609725, 7, 1440x900 
0x37CA2318, 38092271215977408, 226609787, 226609794, 7, 1440x900 
0x37CA2318, 38092271216640616, 226609852, 226609860, 8, 1440x900 
0x37CA2318, 38092271217300944, 226609917, 226609925, 8, 1440x900 
0x37CA2318, 38092271217963168, 226609982, 226609991, 9, 1440x900 
0x37CA2318, 38092271218626320, 226610053, 226610061, 8, 1440x900 
0x37CA2318, 38092271219282216, 226610117, 226610125, 8, 1440x900 
0x37CA2318, 38092271219955360, 226610183, 226610191, 8, 1440x900 
0x37CA2318, 38092271220609824, 226610253, 226610261, 8, 1440x900 
0x37CA2318, 38092271221272848, 226610312, 226610321, 9, 1440x900 
0x37CA2318, 38092271221928632, 226610378, 226610386, 8, 1440x900 
0x37CA2318, 38092271222606248, 226610447, 226610456, 9, 1440x900 
0x37CA2318, 38092271223265416, 226610517, 226610525, 8, 1440x900 
0x37CA2318, 38092271223925400, 226610583, 226610591, 8, 1440x900 
0x37CA2318, 38092271224578928, 226610648, 226610656, 8, 1440x900 
0x37CA2318, 38092271225239344, 226610712, 226610720, 8, 1440x900 
0x37CA2318, 38092271225893648, 226610777, 226610785, 8, 1440x900 
0x37CA2318, 38092271226572888, 226610847, 226610855, 8, 1440x900 
0x37CA2318, 38092271227224080, 226610913, 226610921, 8, 1440x900 
0x37CA2318, 38092271227895104, 226610977, 226610985, 8, 1440x900 
0x37CA2318, 38092271228548712, 226611042, 226611051, 9, 1440x900 
0x37CA2318, 38092271229226880, 226611112, 226611120, 8, 1440x900 
0x37CA2318, 38092271229877368, 226611177, 226611185, 8, 1440x900 
0x37CA2318, 38092271230541248, 226611243, 226611251, 8, 1440x900 
0x37CA2318, 38092271231193448, 226611307, 226611315, 8, 1440x900 
0x37CA2318, 38092271231873168, 226611378, 226611386, 8, 1440x900 
0x37CA2318, 38092271232526200, 226611442, 226611450, 8, 1440x900 
0x37CA2318, 38092271233179488, 226611508, 226611516, 8, 1440x900 
0x37CA2318, 38092271233847968, 226611573, 226611581, 8, 1440x900 
0x37CA2318, 38092271234509016, 226611637, 226611644, 7, 1440x900 
0x37CA2318, 38092271235170824, 226611708, 226611716, 8, 1440x900 
0x37CA2318, 38092271235834624, 226611774, 226611782, 8, 1440x900 
0x37CA2318, 38092271236486056, 226611838, 226611846, 8, 1440x900 
0x37CA2318, 38092271237158464, 226611908, 226611916, 8, 1440x900 
0x37CA2318, 38092271237819376, 226611968, 226611977, 9, 1440x900 
0x37CA2318, 38092271238480272, 226612037, 226612045, 8, 1440x900 
0x37CA2318, 38092271239140128, 226612103, 226612111, 8, 1440x900 
0x37CA2318, 38092271239802160, 226612168, 226612176, 8, 1440x900 
0x37CA2318, 38092271240460104, 226612233, 226612241, 8, 1440x900 
0x37CA2318, 38092271241115192, 226612302, 226612310, 8, 1440x900 
0x37CA2318, 38092271241785744, 226612367, 226612375, 8, 1440x900 
0x37CA2318, 38092271242439320, 226612432, 226612440, 8, 1440x900 
0x37CA2318, 38092271243103096, 226612498, 226612506, 8, 1440x900 
0x37CA2318, 38092271243758112, 226612563, 226612571, 8, 1440x900 
0x37CA2318, 38092271244421520, 226612633, 226612641, 8, 1440x900 
0x37CA2318, 38092271245081856, 226612697, 226612704, 7, 1440x900 
0x37CA2318, 38092271246398816, 226612828, 226612837, 9, 1440x900 
0x37CA2318, 38092271247071080, 226612899, 226612907, 8, 1440x900 
0x37CA2318, 38092271247731096, 226612963, 226612971, 8, 1440x900 
0x37CA2318, 38092271248392136, 226613028, 226613036, 8, 1440x900 
0x37CA2318, 38092271249048608, 226613092, 226613100, 8, 1440x900 
0x37CA2318, 38092271249710072, 226613163, 226613171, 8, 1440x900 
0x37CA2318, 38092271250381184, 226613227, 226613235, 8, 1440x900 
0x37CA2318, 38092271251023408, 226613293, 226613301, 8, 1440x900 
0x37CA2318, 38092271251692544, 226613363, 226613372, 9, 1440x900 
0x37CA2318, 38092271252346424, 226613423, 226613431, 8, 1440x900 
0x37CA2318, 38092271253007064, 226613488, 226613496, 8, 1440x900 
0x37CA2318, 38092271253670368, 226613557, 226613565, 8, 1440x900 
0x37CA2318, 38092271254340192, 226613627, 226613635, 8, 1440x900 
0x37CA2318, 38092271254992160, 226613687, 226613695, 8, 1440x900 
0x37CA2318, 38092271255654608, 226613753, 226613760, 7, 1440x900 
0x37CA2318, 38092271256315192, 226613822, 226613830, 8, 1440x900 
0x37CA2318, 38092271256975720, 226613887, 226613894, 7, 1440x900 
0x37CA2318, 38092271257625584, 226613951, 226613959, 8, 1440x900 
0x37CA2318, 38092271258295336, 226614018, 226614025, 7, 1440x900 
0x37CA2318, 38092271258953872, 226614082, 226614090, 8, 1440x900 
0x37CA2318, 38092271259614640, 226614148, 226614156, 8, 1440x900 
0x37CA2318, 38092271260270376, 226614213, 226614221, 8, 1440x900 
0x37CA2318, 38092271260944888, 226614283, 226614290, 7, 1440x900 
0x37CA2318, 38092271261607520, 226614348, 226614356, 8, 1440x900 
0x37CA2318, 38092271262270016, 226614418, 226614425, 7, 1440x900 
0x37CA2318, 38092271262939224, 226614483, 226614490, 7, 1440x900 
0x37CA2318, 38092271263599816, 226614548, 226614555, 7, 1440x900 
0x37CA2318, 38092271264261232, 226614613, 226614621, 8, 1440x900 
0x37CA2318, 38092271264921640, 226614682, 226614690, 8, 1440x900 
0x37CA2318, 38092271265581544, 226614748, 226614756, 8, 1440x900 
0x37CA2318, 38092271266244976, 226614814, 226614822, 8, 1440x900 
0x37CA2318, 38092271266905680, 226614878, 226614886, 8, 1440x900 
0x37CA2318, 38092271267574504, 226614943, 226614951, 8, 1440x900 
0x37CA2318, 38092271268227304, 226615012, 226615020, 8, 1440x900 
0x37CA2318, 38092271268886192, 226615078, 226615086, 8, 1440x900 
0x37CA2318, 38092271269547432, 226615144, 226615151, 7, 1440x900 
0x37CA2318, 38092271270199832, 226615208, 226615216, 8, 1440x900 
0x37CA2318, 38092271270860768, 226615273, 226615281, 8, 1440x900 
0x37CA2318, 38092271271522240, 226615338, 226615347, 9, 1440x900 
0x37CA2318, 38092271272192880, 226615408, 226615416, 8, 1440x900 
0x37CA2318, 38092271272856256, 226615477, 226615485, 8, 1440x900 
0x37CA2318, 38092271273510664, 226615542, 226615550, 8, 1440x900 
0x37CA2318, 38092271274187032, 226615607, 226615615, 8, 1440x900 
0x37CA2318, 38092271274839728, 226615671, 226615679, 8, 1440x900 
0x37CA2318, 38092271275491320, 226615737, 226615745, 8, 1440x900 
0x37CA2318, 38092271276152896, 226615801, 226615809, 8, 1440x900 
0x37CA2318, 38092271276818768, 226615872, 226615880, 8, 1440x900 
0x37CA2318, 38092271277479312, 226615937, 226615945, 8, 1440x900 
0x37CA2318, 38092271278142432, 226616002, 226616010, 8, 1440x900 
0x37CA2318, 38092271278803184, 226616073, 226616081, 8, 1440x900 
0x37CA2318, 38092271279464984, 226616138, 226616146, 8, 1440x900 
0x37CA2318, 38092271280118768, 226616202, 226616210, 8, 1440x900 
0x37CA2318, 38092271280785640, 226616268, 226616276, 8, 1440x900 
0x37CA2318, 38092271281446152, 226616333, 226616341, 8, 1440x900 
0x37CA2318, 38092271282107720, 226616398, 226616407, 9, 1440x900 
0x37CA2318, 38092271282767592, 226616467, 226616475, 8, 1440x900 
0x37CA2318, 38092271283429064, 226616533, 226616541, 8, 1440x900 
0x37CA2318, 38092271284091856, 226616598, 226616606, 8, 1440x900 
0x37CA2318, 38092271284747216, 226616667, 226616675, 8, 1440x900 
0x37CA2318, 38092271285410560, 226616733, 226616740, 7, 1440x900 
0x37CA2318, 38092271286060728, 226616793, 226616801, 8, 1440x900 
0x37CA2318, 38092271286726440, 226616858, 226616866, 8, 1440x900 
0x37CA2318, 38092271287397224, 226616927, 226616934, 7, 1440x900 
0x37CA2318, 38092271288051304, 226616991, 226616998, 7, 1440x900 
0x37CA2318, 38092271288702752, 226617058, 226617065, 7, 1440x900 
0x37CA2318, 38092271289369296, 226617123, 226617130, 7, 1440x900 
0x37CA2318, 38092271290031080, 226617192, 226617200, 8, 1440x900 
0x37CA2318, 38092271290698848, 226617258, 226617266, 8, 1440x900 
0x37CA2318, 38092271291352136, 226617327, 226617335, 8, 1440x900 
0x37CA2318, 38092271292004896, 226617388, 226617397, 9, 1440x900 
0x37CA2318, 38092271292676128, 226617457, 226617465, 8, 1440x900 
0x37CA2318, 38092271293338216, 226617523, 226617531, 8, 1440x900 
0x37CA2318, 38092271294006880, 226617588, 226617597, 9, 1440x900 
0x37CA2318, 38092271294651096, 226617652, 226617661, 9, 1440x900 
0x37CA2318, 38092271295321280, 226617722, 226617730, 8, 1440x900 
0x37CA2318, 38092271295982640, 226617788, 226617796, 8, 1440x900 
0x37CA2318, 38092271296642152, 226617852, 226617860, 8, 1440x900 
0x37CA2318, 38092271297301848, 226617917, 226617925, 8, 1440x900 
0x37CA2318, 38092271297963936, 226617987, 226617996, 9, 1440x900 
0x37CA2318, 38092271298624984, 226618053, 226618061, 8, 1440x900 
0x37CA2318, 38092271299276320, 226618118, 226618125, 7, 1440x900 
0x37CA2318, 38092271299940840, 226618182, 226618190, 8, 1440x900 
0x37CA2318, 38092271300616280, 226618248, 226618255, 7, 1440x900 
0x37CA2318, 38092271301277464, 226618317, 226618325, 8, 1440x900 
0x37CA2318, 38092271301937176, 226618382, 226618390, 8, 1440x900 
0x37CA2318, 38092271302588360, 226618447, 226618455, 8, 1440x900 
0x37CA2318, 38092271303250376, 226618518, 226618526, 8, 1440x900 
0x37CA2318, 38092271303919096, 226618582, 226618590, 8, 1440x900 
0x37CA2318, 38092271304571680, 226618644, 226618652, 8, 1440x900 
0x37CA2318, 38092271305232032, 226618713, 226618721, 8, 1440x900 
0x37CA2318, 38092271305900632, 226618778, 226618786, 8, 1440x900 
0x37CA2318, 38092271306546944, 226618843, 226618850, 7, 1440x900 
0x37CA2318, 38092271307210056, 226618907, 226618915, 8, 1440x900 
0x37CA2318, 38092271307880784, 226618978, 226618986, 8, 1440x900 
0x37CA2318, 38092271308525712, 226619043, 226619051, 8, 1440x900 
0x37CA2318, 38092271309197624, 226619107, 226619115, 8, 1440x900 
0x37CA2318, 38092271309849016, 226619173, 226619181, 8, 1440x900 
0x37CA2318, 38092271310528744, 226619243, 226619251, 8, 1440x900 
0x37CA2318, 38092271311180680, 226619303, 226619311, 8, 1440x900 
0x37CA2318, 38092271311841440, 226619373, 226619381, 8, 1440x900 
0x37CA2318, 38092271312496400, 226619437, 226619445, 8, 1440x900 
0x37CA2318, 38092271313172648, 226619507, 226619515, 8, 1440x900 
0x37CA2318, 38092271313823192, 226619568, 226619577, 9, 1440x900 
0x37CA2318, 38092271314484064, 226619638, 226619646, 8, 1440x900 
0x37CA2318, 38092271315153120, 226619703, 226619711, 8, 1440x900 
0x37CA2318, 38092271315808992, 226619768, 226619776, 8, 1440x900 
0x37CA2318, 38092271316465128, 226619838, 226619846, 8, 1440x900 
0x37CA2318, 38092271317126504, 226619898, 226619906, 8, 1440x900 
0x37CA2318, 38092271317787232, 226619967, 226619975, 8, 1440x900 
0x37CA2318, 38092271318440736, 226620032, 226620040, 8, 1440x900 
0x37CA2318, 38092271319112616, 226620102, 226620110, 8, 1440x900 
0x37CA2318, 38092271319772920, 226620168, 226620176, 8, 1440x900 
0x37CA2318, 38092271320442752, 226620233, 226620241, 8, 1440x900 
0x37CA2318, 38092271321095632, 226620298, 226620306, 8, 1440x900 
0x37CA2318, 38092271321757272, 226620368, 226620376, 8, 1440x900 
0x37CA2318, 38092271322416592, 226620428, 226620436, 8, 1440x900 
0x37CA2318, 38092271323736008, 226620567, 226620575, 8, 1440x900 
0x37CA2318, 38092271324397480, 226620627, 226620635, 8, 1440x900 
0x37CA2318, 38092271325058472, 226620693, 226620701, 8, 1440x900 
0x37CA2318, 38092271325720840, 226620762, 226620770, 8, 1440x900 
0x37CA2318, 38092271326379848, 226620827, 226620835, 8, 1440x900 
0x37CA2318, 38092271327035504, 226620891, 226620898, 7, 1440x900 
0x37CA2318, 38092271327698624, 226620962, 226620970, 8, 1440x900 
0x37CA2318, 38092271328359432, 226621022, 226621030, 8, 1440x900 
0x37CA2318, 38092271329027792, 226621092, 226621100, 8, 1440x900 
0x37CA2318, 38092271329690000, 226621157, 226621165, 8, 1440x900 
0x37CA2318, 38092271330340272, 226621222, 226621230, 8, 1440x900 
0x37CA2318, 38092271330999592, 226621287, 226621295, 8, 1440x900 
0x37CA2318, 38092271331665696, 226621358, 226621366, 8, 1440x900 
0x37CA2318, 38092271332325424, 226621421, 226621428, 7, 1440x900 
0x37CA2318, 38092271332993040, 226621488, 226621496, 8, 1440x900 
0x37CA2318, 38092271333654768, 226621553, 226621561, 8, 1440x900 
0x37CA2318, 38092271334313568, 226621623, 226621631, 8, 1440x900 
0x37CA2318, 38092271334965504, 226621683, 226621692, 9, 1440x900 
0x37CA2318, 38092271335624680, 226621753, 226621761, 8, 1440x900 
0x37CA2318, 38092271336283648, 226621817, 226621824, 7, 1440x900 
0x37CA2318, 38092271336951024, 226621887, 226621895, 8, 1440x900 
0x37CA2318, 38092271337603000, 226621947, 226621955, 8, 1440x900 
0x37CA2318, 38092271338265480, 226622019, 226622027, 8, 1440x900 
0x37CA2318, 38092271338930008, 226622083, 226622091, 8, 1440x900 
0x37CA2318, 38092271339590472, 226622147, 226622155, 8, 1440x900 
0x37CA2318, 38092271340252800, 226622212, 226622220, 8, 1440x900 
0x37CA2318, 38092271340909656, 226622283, 226622291, 8, 1440x900 
0x37CA2318, 38092271341599936, 226622347, 226622354, 7, 1440x900 
0x37CA2318, 38092271342246960, 226622412, 226622419, 7, 1440x900 
0x37CA2318, 38092271342713504, 226622457, 226622464, 7, 1440x900 
0x37CA2318, 38092271343569432, 226622542, 226622549, 7, 1440x900 
0x37CA2318, 38092271344222608, 226622608, 226622615, 7, 1440x900 
0x37CA2318, 38092271344894192, 226622677, 226622686, 9, 1440x900 
0x37CA2318, 38092271345549128, 226622742, 226622750, 8, 1440x900 
0x37CA2318, 38092271346221912, 226622807, 226622815, 8, 1440x900 
0x37CA2318, 38092271346872728, 226622873, 226622880, 7, 1440x900 
0x37CA2318, 38092271347541896, 226622943, 226622951, 8, 1440x900 
0x37CA2318, 38092271348197424, 226623007, 226623015, 8, 1440x900 
0x37CA2318, 38092271348859792, 226623076, 226623084, 8, 1440x900 
0x37CA2318, 38092271349327872, 226623117, 226623125, 8, 1440x900 
0x37CA2318, 38092271350188296, 226623206, 226623213, 7, 1440x900 
0x37CA2318, 38092271350858152, 226623272, 226623279, 7, 1440x900 
0x37CA2318, 38092271351509232, 226623337, 226623344, 7, 1440x900 
0x37CA2318, 38092271352172304, 226623408, 226623416, 8, 1440x900 
0x37CA2318, 38092271352831880, 226623472, 226623480, 8, 1440x900 
0x37CA2318, 38092271353482616, 226623537, 226623545, 8, 1440x900 
0x37CA2318, 38092271354151848, 226623602, 226623610, 8, 1440x900 
0x37CA2318, 38092271354813032, 226623674, 226623683, 9, 1440x900 
0x37CA2318, 38092271355309856, 226623718, 226623725, 7, 1440x900 
0x37CA2318, 38092271355947808, 226623783, 226623791, 8, 1440x900 
0x37CA2318, 38092271356785368, 226623868, 226623876, 8, 1440x900 
0x37CA2318, 38092271357454872, 226623938, 226623946, 8, 1440x900 
0x37CA2318, 38092271358109768, 226623997, 226624004, 7, 1440x900 
0x37CA2318, 38092271358779168, 226624063, 226624070, 7, 1440x900 
0x37CA2318, 38092271359432520, 226624132, 226624140, 8, 1440x900 
0x37CA2318, 38092271360101096, 226624198, 226624206, 8, 1440x900 
0x37CA2318, 38092271360770912, 226624267, 226624275, 8, 1440x900 
0x37CA2318, 38092271361431440, 226624333, 226624341, 8, 1440x900 
0x37CA2318, 38092271362081464, 226624397, 226624405, 8, 1440x900 
0x37CA2318, 38092271362741360, 226624468, 226624476, 8, 1440x900 
0x37CA2318, 38092271363403160, 226624527, 226624536, 9, 1440x900 
0x37CA2318, 38092271364072048, 226624598, 226624606, 8, 1440x900 
0x37CA2318, 38092271364722904, 226624662, 226624670, 8, 1440x900 
0x37CA2318, 38092271365383640, 226624726, 226624733, 7, 1440x900 
0x37CA2318, 38092271366053312, 226624793, 226624801, 8, 1440x900 
0x37CA2318, 38092271366714920, 226624864, 226624871, 7, 1440x900 
0x37CA2318, 38092271367365688, 226624927, 226624935, 8, 1440x900 
0x37CA2318, 38092271368026616, 226624988, 226624996, 8, 1440x900 
0x37CA2318, 38092271368688608, 226625062, 226625070, 8, 1440x900 
0x37CA2318, 38092271369342608, 226625122, 226625130, 8, 1440x900 
0x37CA2318, 38092271370012144, 226625188, 226625196, 8, 1440x900 
0x37CA2318, 38092271370664160, 226625253, 226625262, 9, 1440x900 
0x37CA2318, 38092271371335232, 226625322, 226625330, 8, 1440x900 
0x37CA2318, 38092271371987624, 226625388, 226625396, 8, 1440x900 
0x37CA2318, 38092271372653680, 226625453, 226625461, 8, 1440x900 
0x37CA2318, 38092271373316504, 226625523, 226625531, 8, 1440x900 
0x37CA2318, 38092271373982384, 226625588, 226625596, 8, 1440x900 
0x37CA2318, 38092271374628944, 226625652, 226625660, 8, 1440x900 
0x37CA2318, 38092271375296992, 226625718, 226625726, 8, 1440x900 
0x37CA2318, 38092271375958336, 226625788, 226625796, 8, 1440x900 
0x37CA2318, 38092271376628112, 226625851, 226625859, 8, 1440x900 
0x37CA2318, 38092271377272976, 226625917, 226625925, 8, 1440x900 
0x37CA2318, 38092271377951768, 226625983, 226625990, 7, 1440x900 
0x37CA2318, 38092271378602200, 226626046, 226626054, 8, 1440x900 
0x37CA2318, 38092271379265656, 226626113, 226626120, 7, 1440x900 
0x37CA2318, 38092271379918912, 226626183, 226626191, 8, 1440x900 
0x37CA2318, 38092271380597192, 226626248, 226626256, 8, 1440x900 
0x37CA2318, 38092271381251624, 226626313, 226626321, 8, 1440x900 
0x37CA2318, 38092271381912560, 226626382, 226626390, 8, 1440x900 
0x37CA2318, 38092271382574096, 226626448, 226626456, 8, 1440x900 
0x37CA2318, 38092271383234696, 226626513, 226626522, 9, 1440x900 
0x37CA2318, 38092271383894568, 226626583, 226626591, 8, 1440x900 
0x37CA2318, 38092271384557376, 226626648, 226626656, 8, 1440x900 
0x37CA2318, 38092271385226760, 226626712, 226626720, 8, 1440x900 
0x37CA2318, 38092271385880064, 226626778, 226626786, 8, 1440x900 
0x37CA2318, 38092271386539672, 226626848, 226626856, 8, 1440x900 
0x37CA2318, 38092271387200576, 226626907, 226626915, 8, 1440x900 
0x37CA2318, 38092271387861536, 226626973, 226626981, 8, 1440x900 
0x37CA2318, 38092271388522184, 226627042, 226627050, 8, 1440x900 
0x37CA2318, 38092271389192256, 226627108, 226627116, 8, 1440x900 
0x37CA2318, 38092271389852624, 226627178, 226627186, 8, 1440x900 
0x37CA2318, 38092271390504656, 226627239, 226627247, 8, 1440x900 
0x37CA2318, 38092271391165320, 226627303, 226627312, 9, 1440x900 
0x37CA2318, 38092271391828696, 226627373, 226627381, 8, 1440x900 
0x37CA2318, 38092271392482784, 226627437, 226627445, 8, 1440x900 
0x37CA2318, 38092271393142752, 226627503, 226627511, 8, 1440x900 
0x37CA2318, 38092271393802104, 226627567, 226627575, 8, 1440x900 
0x37CA2318, 38092271394481984, 226627638, 226627646, 8, 1440x900 
0x37CA2318, 38092271395134568, 226627704, 226627712, 8, 1440x900 
0x37CA2318, 38092271395793824, 226627767, 226627775, 8, 1440x900 
0x37CA2318, 38092271396446440, 226627832, 226627841, 9, 1440x900 
0x37CA2318, 38092271397117000, 226627901, 226627908, 7, 1440x900 
0x37CA2318, 38092271397784800, 226627967, 226627975, 8, 1440x900 
0x37CA2318, 38092271398445552, 226628033, 226628041, 8, 1440x900 
0x37CA2318, 38092271399097544, 226628099, 226628107, 8, 1440x900 
0x37CA2318, 38092271399766384, 226628167, 226628175, 8, 1440x900 
0x37CA2318, 38092271400418208, 226628229, 226628237, 8, 1440x900 
0x37CA2318, 38092271401080632, 226628297, 226628305, 8, 1440x900 
0x37CA2318, 38092271401750176, 226628363, 226628371, 8, 1440x900 
0x37CA2318, 38092271403060848, 226628492, 226628501, 9, 1440x900 
0x37CA2318, 38092271403727336, 226628562, 226628570, 8, 1440x900 
0x37CA2318, 38092271404379376, 226628628, 226628636, 8, 1440x900 
0x37CA2318, 38092271405047872, 226628693, 226628701, 8, 1440x900 
0x37CA2318, 38092271405708600, 226628757, 226628766, 9, 1440x900 
0x37CA2318, 38092271406378648, 226628827, 226628835, 8, 1440x900 
0x37CA2318, 38092271407026376, 226628893, 226628901, 8, 1440x900 
0x37CA2318, 38092271407695464, 226628957, 226628964, 7, 1440x900 
0x37CA2318, 38092271408364240, 226629022, 226629030, 8, 1440x900 
0x37CA2318, 38092271409034072, 226629089, 226629097, 8, 1440x900 
0x37CA2318, 38092271409703640, 226629158, 226629165, 7, 1440x900 
0x37CA2318, 38092271410363248, 226629223, 226629230, 7, 1440x900 
0x37CA2318, 38092271411034016, 226629287, 226629294, 7, 1440x900 
0x37CA2318, 38092271411676040, 226629357, 226629364, 7, 1440x900 
0x37CA2318, 38092271412345464, 226629422, 226629429, 7, 1440x900 
0x37CA2318, 38092271413001784, 226629488, 226629495, 7, 1440x900 
0x37CA2318, 38092271413670240, 226629557, 226629565, 8, 1440x900 
0x37CA2318, 38092271414331304, 226629622, 226629630, 8, 1440x900 
0x37CA2318, 38092271414985048, 226629689, 226629696, 7, 1440x900 
0x37CA2318, 38092271415656136, 226629757, 226629764, 7, 1440x900 
0x37CA2318, 38092271416314232, 226629823, 226629832, 9, 1440x900 
0x37CA2318, 38092271416974808, 226629888, 226629896, 8, 1440x900 
0x37CA2318, 38092271417644600, 226629953, 226629961, 8, 1440x900 
0x37CA2318, 38092271418293624, 226630017, 226630024, 7, 1440x900 
0x37CA2318, 38092271418955360, 226630082, 226630089, 7, 1440x900 
0x37CA2318, 38092271419617408, 226630148, 226630155, 7, 1440x900 
0x37CA2318, 38092271420277736, 226630213, 226630222, 9, 1440x900 
0x37CA2318, 38092271420939432, 226630283, 226630291, 8, 1440x900 
0x37CA2318, 38092271421594608, 226630348, 226630357, 9, 1440x900 
0x37CA2318, 38092271422260296, 226630417, 226630425, 8, 1440x900 
0x37CA2318, 38092271422922240, 226630478, 226630487, 9, 1440x900 
0x37CA2318, 38092271423576616, 226630547, 226630555, 8, 1440x900 
0x37CA2318, 38092271424256312, 226630613, 226630621, 8, 1440x900 
0x37CA2318, 38092271424907216, 226630683, 226630691, 8, 1440x900 
0x37CA2318, 38092271425570744, 226630743, 226630752, 9, 1440x900 
0x37CA2318, 38092271426232528, 226630813, 226630821, 8, 1440x900 
0x37CA2318, 38092271426892968, 226630878, 226630886, 8, 1440x900 
0x37CA2318, 38092271427543592, 226630943, 226630951, 8, 1440x900 
0x37CA2318, 38092271428206424, 226631012, 226631020, 8, 1440x900 
0x37CA2318, 38092271428868152, 226631076, 226631084, 8, 1440x900 
0x37CA2318, 38092271429531072, 226631143, 226631151, 8, 1440x900 
0x37CA2318, 38092271430192040, 226631207, 226631215, 8, 1440x900 
0x37CA2318, 38092271430846808, 226631273, 226631281, 8, 1440x900 
0x37CA2318, 38092271431511208, 226631342, 226631350, 8, 1440x900 
0x37CA2318, 38092271432178832, 226631408, 226631416, 8, 1440x900 
0x37CA2318, 38092271432830400, 226631473, 226631481, 8, 1440x900 
0x37CA2318, 38092271433491096, 226631538, 226631546, 8, 1440x900 
0x37CA2318, 38092271434151072, 226631602, 226631611, 9, 1440x900 
0x37CA2318, 38092271434809280, 226631672, 226631680, 8, 1440x900 
0x37CA2318, 38092271435480888, 226631737, 226631745, 8, 1440x900 
0x37CA2318, 38092271436131864, 226631803, 226631811, 8, 1440x900 
0x37CA2318, 38092271436791592, 226631867, 226631875, 8, 1440x900 
0x37CA2318, 38092271437452736, 226631933, 226631941, 8, 1440x900 
0x37CA2318, 38092271438112816, 226632002, 226632010, 8, 1440x900 
0x37CA2318, 38092271438772752, 226632067, 226632075, 8, 1440x900 
0x37CA2318, 38092271439442256, 226632136, 226632143, 7, 1440x900 
0x37CA2318, 38092271440093536, 226632197, 226632205, 8, 1440x900 
0x37CA2318, 38092271440757384, 226632263, 226632271, 8, 1440x900 
0x37CA2318, 38092271441418024, 226632333, 226632341, 8, 1440x900 
0x37CA2318, 38092271442073368, 226632398, 226632406, 8, 1440x900 
0x37CA2318, 38092271442733432, 226632463, 226632471, 8, 1440x900 
0x37CA2318, 38092271443404968, 226632528, 226632536, 8, 1440x900 
0x37CA2318, 38092271444055824, 226632592, 226632601, 9, 1440x900 
0x37CA2318, 38092271444711024, 226632663, 226632671, 8, 1440x900 
0x37CA2318, 38092271445390504, 226632727, 226632735, 8, 1440x900 
0x37CA2318, 38092271446051624, 226632792, 226632800, 8, 1440x900 
0x37CA2318, 38092271446702704, 226632862, 226632870, 8, 1440x900 
0x37CA2318, 38092271447355832, 226632927, 226632935, 8, 1440x900 
0x37CA2318, 38092271448018792, 226632988, 226632997, 9, 1440x900 
0x37CA2318, 38092271448696720, 226633057, 226633065, 8, 1440x900 
0x37CA2318, 38092271449347336, 226633123, 226633132, 9, 1440x900 
0x37CA2318, 38092271450007864, 226633187, 226633195, 8, 1440x900 
0x37CA2318, 38092271450678656, 226633257, 226633265, 8, 1440x900 
0x37CA2318, 38092271451329352, 226633322, 226633330, 8, 1440x900 
0x37CA2318, 38092271451990560, 226633388, 226633396, 8, 1440x900 
0x37CA2318, 38092271452659912, 226633453, 226633462, 9, 1440x900 
0x37CA2318, 38092271453311408, 226633522, 226633530, 8, 1440x900 
0x37CA2318, 38092271453962984, 226633583, 226633592, 9, 1440x900 
0x37CA2318, 38092271454642840, 226633652, 226633660, 8, 1440x900 
0x37CA2318, 38092271455293584, 226633718, 226633726, 8, 1440x900 
0x37CA2318, 38092271455954816, 226633783, 226633792, 9, 1440x900 
0x37CA2318, 38092271456622672, 226633852, 226633860, 8, 1440x900 
0x37CA2318, 38092271457274656, 226633918, 226633926, 8, 1440x900 
0x37CA2318, 38092271457933464, 226633982, 226633989, 7, 1440x900 
0x37CA2318, 38092271458594648, 226634048, 226634056, 8, 1440x900 
0x37CA2318, 38092271459246384, 226634113, 226634120, 7, 1440x900 
0x37CA2318, 38092271459909664, 226634178, 226634185, 7, 1440x900 
0x37CA2318, 38092271460580352, 226634247, 226634255, 8, 1440x900 
0x37CA2318, 38092271461244936, 226634312, 226634319, 7, 1440x900 
0x37CA2318, 38092271461902544, 226634377, 226634384, 7, 1440x900 
0x37CA2318, 38092271462562608, 226634442, 226634449, 7, 1440x900 
0x37CA2318, 38092271463221760, 226634508, 226634515, 7, 1440x900 
0x37CA2318, 38092271463875344, 226634573, 226634581, 8, 1440x900 
0x37CA2318, 38092271464547304, 226634642, 226634650, 8, 1440x900 
0x37CA2318, 38092271465212488, 226634713, 226634721, 8, 1440x900 
0x37CA2318, 38092271465873600, 226634777, 226634785, 8, 1440x900 
0x37CA2318, 38092271466525984, 226634843, 226634852, 9, 1440x900 
0x37CA2318, 38092271467184208, 226634904, 226634912, 8, 1440x900 
0x37CA2318, 38092271467847128, 226634972, 226634981, 9, 1440x900 
0x37CA2318, 38092271468503600, 226635038, 226635046, 8, 1440x900 
0x37CA2318, 38092271469174704, 226635108, 226635116, 8, 1440x900 
0x37CA2318, 38092271469834976, 226635173, 226635181, 8, 1440x900 
0x37CA2318, 38092271470505160, 226635238, 226635246, 8, 1440x900 
0x37CA2318, 38092271471154848, 226635304, 226635312, 8, 1440x900 
0x37CA2318, 38092271471816224, 226635373, 226635381, 8, 1440x900 
0x37CA2318, 38092271472477616, 226635438, 226635446, 8, 1440x900 
0x37CA2318, 38092271473147640, 226635503, 226635511, 8, 1440x900 
0x37CA2318, 38092271473804592, 226635567, 226635576, 9, 1440x900 
0x37CA2318, 38092271474466512, 226635638, 226635646, 8, 1440x900 
0x37CA2318, 38092271475118712, 226635703, 226635711, 8, 1440x900 
0x37CA2318, 38092271475782328, 226635767, 226635775, 8, 1440x900 
0x37CA2318, 38092271476446328, 226635832, 226635841, 9, 1440x900 
0x37CA2318, 38092271477098656, 226635902, 226635910, 8, 1440x900 
0x37CA2318, 38092271477760448, 226635963, 226635971, 8, 1440x900 
0x37CA2318, 38092271478431648, 226636032, 226636040, 8, 1440x900 
0x37CA2318, 38092271479093336, 226636097, 226636105, 8, 1440x900 
0x37CA2318, 38092271479753824, 226636169, 226636177, 8, 1440x900 
0x37CA2318, 38092271480415648, 226636228, 226636237, 9, 1440x900 
0x37CA2318, 38092271481735440, 226636367, 226636374, 7, 1440x900 
0x37CA2318, 38092271482386768, 226636426, 226636434, 8, 1440x900 
0x37CA2318, 38092271483064248, 226636492, 226636500, 8, 1440x900 
0x37CA2318, 38092271483721024, 226636563, 226636571, 8, 1440x900 
0x37CA2318, 38092271484376144, 226636628, 226636636, 8, 1440x900 
0x37CA2318, 38092271485038336, 226636692, 226636700, 8, 1440x900 
0x37CA2318, 38092271485696016, 226636762, 226636769, 7, 1440x900 
0x37CA2318, 38092271486365024, 226636828, 226636836, 8, 1440x900 
0x37CA2318, 38092271487017952, 226636892, 226636900, 8, 1440x900 
0x37CA2318, 38092271487686536, 226636958, 226636966, 8, 1440x900 
0x37CA2318, 38092271488344080, 226637024, 226637032, 8, 1440x900 
0x37CA2318, 38092271489005984, 226637088, 226637097, 9, 1440x900 
0x37CA2318, 38092271489668832, 226637153, 226637162, 9, 1440x900 
0x37CA2318, 38092271490326928, 226637223, 226637231, 8, 1440x900 
0x37CA2318, 38092271490983696, 226637288, 226637296, 8, 1440x900 
0x37CA2318, 38092271491663184, 226637352, 226637361, 9, 1440x900 
0x37CA2318, 38092271492315208, 226637418, 226637427, 9, 1440x900 
0x37CA2318, 38092271492976048, 226637487, 226637495, 8, 1440x900 
0x37CA2318, 38092271493639240, 226637552, 226637560, 8, 1440x900 
0x37CA2318, 38092271494309072, 226637622, 226637630, 8, 1440x900 
0x37CA2318, 38092271494958336, 226637688, 226637696, 8, 1440x900 
0x37CA2318, 38092271495618976, 226637747, 226637754, 7, 1440x900 
0x37CA2318, 38092271496279688, 226637818, 226637826, 8, 1440x900 
0x37CA2318, 38092271496942192, 226637882, 226637890, 8, 1440x900 
0x37CA2318, 38092271497602760, 226637948, 226637956, 8, 1440x900 
0x37CA2318, 38092271498256488, 226638013, 226638021, 8, 1440x900 
0x37CA2318, 38092271498925552, 226638082, 226638090, 8, 1440x900 
0x37CA2318, 38092271499579840, 226638147, 226638155, 8, 1440x900 
0x37CA2318, 38092271500243696, 226638213, 226638222, 9, 1440x900 
0x37CA2318, 38092271500904992, 226638278, 226638286, 8, 1440x900 
0x37CA2318, 38092271501573856, 226638348, 226638356, 8, 1440x900 
0x37CA2318, 38092271502227968, 226638411, 226638419, 8, 1440x900 
0x37CA2318, 38092271502888472, 226638478, 226638486, 8, 1440x900 
0x37CA2318, 38092271503547352, 226638543, 226638551, 8, 1440x900 
0x37CA2318, 38092271504213496, 226638607, 226638614, 7, 1440x900 
0x37CA2318, 38092271504871816, 226638673, 226638681, 8, 1440x900 
0x37CA2318, 38092271505523928, 226638738, 226638747, 9, 1440x900 
0x37CA2318, 38092271506193000, 226638807, 226638815, 8, 1440x900 
0x37CA2318, 38092271506853632, 226638872, 226638880, 8, 1440x900 
0x37CA2318, 38092271507506592, 226638937, 226638946, 9, 1440x900 
0x37CA2318, 38092271508177000, 226639007, 226639015, 8, 1440x900 
0x37CA2318, 38092271508828696, 226639072, 226639080, 8, 1440x900 
0x37CA2318, 38092271509489480, 226639138, 226639146, 8, 1440x900 
0x37CA2318, 38092271510161424, 226639207, 226639215, 8, 1440x900 
0x37CA2318, 38092271510812448, 226639268, 226639276, 8, 1440x900 
0x37CA2318, 38092271511481552, 226639338, 226639346, 8, 1440x900 
0x37CA2318, 38092271512132608, 226639402, 226639410, 8, 1440x900 
0x37CA2318, 38092271512795632, 226639467, 226639475, 8, 1440x900 
0x37CA2318, 38092271513454528, 226639532, 226639541, 9, 1440x900 
0x37CA2318, 38092271514114128, 226639598, 226639606, 8, 1440x900 
0x37CA2318, 38092271514781384, 226639666, 226639673, 7, 1440x900 
0x37CA2318, 38092271515443304, 226639733, 226639741, 8, 1440x900 
0x37CA2318, 38092271516095408, 226639798, 226639806, 8, 1440x900 
0x37CA2318, 38092271516759144, 226639863, 226639872, 9, 1440x900 
0x37CA2318, 38092271517417824, 226639933, 226639941, 8, 1440x900 
0x37CA2318, 38092271518080040, 226639998, 226640006, 8, 1440x900 
0x37CA2318, 38092271518742480, 226640062, 226640070, 8, 1440x900 
0x37CA2318, 38092271519401688, 226640128, 226640136, 8, 1440x900 
0x37CA2318, 38092271520063440, 226640197, 226640205, 8, 1440x900 
0x37CA2318, 38092271520722784, 226640263, 226640271, 8, 1440x900 
0x37CA2318, 38092271521385448, 226640328, 226640336, 8, 1440x900 
0x37CA2318, 38092271522054464, 226640393, 226640402, 9, 1440x900 
0x37CA2318, 38092271522707376, 226640462, 226640470, 8, 1440x900 
0x37CA2318, 38092271523360440, 226640527, 226640535, 8, 1440x900 
0x37CA2318, 38092271524024096, 226640593, 226640601, 8, 1440x900 
0x37CA2318, 38092271524694488, 226640657, 226640667, 10, 1440x900 
0x37CA2318, 38092271525357592, 226640723, 226640732, 9, 1440x900 
0x37CA2318, 38092271526026968, 226640788, 226640796, 8, 1440x900 
0x37CA2318, 38092271526678416, 226640857, 226640865, 8, 1440x900 
0x37CA2318, 38092271527336824, 226640923, 226640931, 8, 1440x900 
0x37CA2318, 38092271527998000, 226640988, 226640996, 8, 1440x900 
0x37CA2318, 38092271528659712, 226641053, 226641061, 8, 1440x900 
0x37CA2318, 38092271529322240, 226641122, 226641130, 8, 1440x900 
0x37CA2318, 38092271529992112, 226641187, 226641195, 8, 1440x900 
0x37CA2318, 38092271530642976, 226641253, 226641261, 8, 1440x900 
0x37CA2318, 38092271531307144, 226641318, 226641326, 8, 1440x900 
0x37CA2318, 38092271531965448, 226641387, 226641395, 8, 1440x900 
0x37CA2318, 38092271532626920, 226641453, 226641461, 8, 1440x900 
0x37CA2318, 38092271533288944, 226641517, 226641525, 8, 1440x900 
0x37CA2318, 38092271533950776, 226641583, 226641591, 8, 1440x900 
0x37CA2318, 38092271534620416, 226641653, 226641661, 8, 1440x900 
0x37CA2318, 38092271535272672, 226641718, 226641726, 8, 1440x900 
0x37CA2318, 38092271535940480, 226641782, 226641791, 9, 1440x900 
0x37CA2318, 38092271536601624, 226641848, 226641856, 8, 1440x900 
0x37CA2318, 38092271537271584, 226641918, 226641926, 8, 1440x900 
0x37CA2318, 38092271537923208, 226641983, 226641991, 8, 1440x900 
0x37CA2318, 38092271538584624, 226642047, 226642055, 8, 1440x900 
0x37CA2318, 38092271539245248, 226642113, 226642121, 8, 1440x900 
0x37CA2318, 38092271539906920, 226642182, 226642190, 8, 1440x900 
0x37CA2318, 38092271540560464, 226642243, 226642251, 8, 1440x900 
0x37CA2318, 38092271541230536, 226642313, 226642321, 8, 1440x900 
0x37CA2318, 38092271541885048, 226642377, 226642385, 8, 1440x900 
0x37CA2318, 38092271542546136, 226642441, 226642449, 8, 1440x900 
0x37CA2318, 38092271543214496, 226642508, 226642515, 7, 1440x900 
0x37CA2318, 38092271543876664, 226642578, 226642586, 8, 1440x900 
0x37CA2318, 38092271544546064, 226642642, 226642650, 8, 1440x900 
0x37CA2318, 38092271545207088, 226642708, 226642717, 9, 1440x900 
0x37CA2318, 38092271545860944, 226642773, 226642781, 8, 1440x900 
0x37CA2318, 38092271546513008, 226642838, 226642847, 9, 1440x900 
0x37CA2318, 38092271547191472, 226642908, 226642916, 8, 1440x900 
0x37CA2318, 38092271547839280, 226642973, 226642981, 8, 1440x900 
0x37CA2318, 38092271548510656, 226643038, 226643046, 8, 1440x900 
0x37CA2318, 38092271549172496, 226643107, 226643115, 8, 1440x900 
0x37CA2318, 38092271549824320, 226643173, 226643180, 7, 1440x900 
0x37CA2318, 38092271550492552, 226643237, 226643245, 8, 1440x900 
0x37CA2318, 38092271551141856, 226643302, 226643310, 8, 1440x900 
0x37CA2318, 38092271551803680, 226643367, 226643374, 7, 1440x900 
0x37CA2318, 38092271552464928, 226643434, 226643442, 8, 1440x900 
0x37CA2318, 38092271553126752, 226643503, 226643511, 8, 1440x900 
0x37CA2318, 38092271553796304, 226643567, 226643575, 8, 1440x900 
0x37CA2318, 38092271554449488, 226643632, 226643640, 8, 1440x900 
0x37CA2318, 38092271555107536, 226643698, 226643706, 8, 1440x900 
0x37CA2318, 38092271555770056, 226643763, 226643772, 9, 1440x900 
0x37CA2318, 38092271556440264, 226643833, 226643841, 8, 1440x900 
0x37CA2318, 38092271557093344, 226643897, 226643905, 8, 1440x900 
0x37CA2318, 38092271557754024, 226643963, 226643971, 8, 1440x900 
0x37CA2318, 38092271558411472, 226644033, 226644041, 8, 1440x900 
0x37CA2318, 38092271559077848, 226644098, 226644106, 8, 1440x900 
0x37CA2318, 38092271560393256, 226644228, 226644236, 8, 1440x900 
0x37CA2318, 38092271561055408, 226644298, 226644306, 8, 1440x900 
0x37CA2318, 38092271561709808, 226644362, 226644370, 8, 1440x900 
0x37CA2318, 38092271562371704, 226644428, 226644436, 8, 1440x900 
0x37CA2318, 38092271563040304, 226644492, 226644500, 8, 1440x900 
0x37CA2318, 38092271563699656, 226644557, 226644565, 8, 1440x900 
0x37CA2318, 38092271564366616, 226644627, 226644635, 8, 1440x900 
0x37CA2318, 38092271565028392, 226644693, 226644701, 8, 1440x900 
0x37CA2318, 38092271565681448, 226644758, 226644766, 8, 1440x900 
0x37CA2318, 38092271566344904, 226644822, 226644831, 9, 1440x900 
0x37CA2318, 38092271567017560, 226644888, 226644897, 9, 1440x900 
0x37CA2318, 38092271567677800, 226644957, 226644965, 8, 1440x900 
0x37CA2318, 38092271568338736, 226645022, 226645030, 8, 1440x900 
0x37CA2318, 38092271569007096, 226645087, 226645094, 7, 1440x900 
0x37CA2318, 38092271569659872, 226645153, 226645161, 8, 1440x900 
0x37CA2318, 38092271570324360, 226645218, 226645227, 9, 1440x900 
0x37CA2318, 38092271570982384, 226645288, 226645296, 8, 1440x900 
0x37CA2318, 38092271571634856, 226645352, 226645360, 8, 1440x900 
0x37CA2318, 38092271572297288, 226645416, 226645424, 8, 1440x900 
0x37CA2318, 38092271572975488, 226645488, 226645496, 8, 1440x900 
0x37CA2318, 38092271573634696, 226645553, 226645561, 8, 1440x900 
0x37CA2318, 38092271574286016, 226645617, 226645625, 8, 1440x900 
0x37CA2318, 38092271574947488, 226645683, 226645691, 8, 1440x900 
0x37CA2318, 38092271575616256, 226645753, 226645761, 8, 1440x900 
0x37CA2318, 38092271576268840, 226645818, 226645826, 8, 1440x900 
0x37CA2318, 38092271576933072, 226645882, 226645890, 8, 1440x900 
0x37CA2318, 38092271577594024, 226645947, 226645955, 8, 1440x900 
0x37CA2318, 38092271578251496, 226646013, 226646021, 8, 1440x900 
0x37CA2318, 38092271578904688, 226646084, 226646091, 7, 1440x900 
0x37CA2318, 38092271579567536, 226646143, 226646152, 9, 1440x900 
0x37CA2318, 38092271580228576, 226646213, 226646221, 8, 1440x900 
0x37CA2318, 38092271580898536, 226646278, 226646286, 8, 1440x900 
0x37CA2318, 38092271581556384, 226646343, 226646351, 8, 1440x900 
0x37CA2318, 38092271582217048, 226646413, 226646421, 8, 1440x900 
0x37CA2318, 38092271582871392, 226646477, 226646485, 8, 1440x900 
0x37CA2318, 38092271583529544, 226646543, 226646551, 8, 1440x900 
0x37CA2318, 38092271584201744, 226646607, 226646614, 7, 1440x900 
0x37CA2318, 38092271584868400, 226646677, 226646685, 8, 1440x900 
0x37CA2318, 38092271585522952, 226646738, 226646747, 9, 1440x900 
0x37CA2318, 38092271586182040, 226646807, 226646815, 8, 1440x900 
0x37CA2318, 38092271586844624, 226646872, 226646880, 8, 1440x900 
0x37CA2318, 38092271587506752, 226646938, 226646946, 8, 1440x900 
0x37CA2318, 38092271588167792, 226647007, 226647015, 8, 1440x900 
0x37CA2318, 38092271588823328, 226647073, 226647081, 8, 1440x900 
0x37CA2318, 38092271589494744, 226647139, 226647147, 8, 1440x900 
0x37CA2318, 38092271590157648, 226647203, 226647211, 8, 1440x900 
0x37CA2318, 38092271590808880, 226647268, 226647276, 8, 1440x900 
0x37CA2318, 38092271591479064, 226647338, 226647346, 8, 1440x900 
0x37CA2318, 38092271592140896, 226647402, 226647410, 8, 1440x900 
0x37CA2318, 38092271592792272, 226647468, 226647476, 8, 1440x900 
0x37CA2318, 38092271593457312, 226647537, 226647545, 8, 1440x900 
0x37CA2318, 38092271594117800, 226647603, 226647611, 8, 1440x900 
0x37CA2318, 38092271594779392, 226647668, 226647676, 8, 1440x900 
0x37CA2318, 38092271595440712, 226647737, 226647745, 8, 1440x900 
0x37CA2318, 38092271596104336, 226647798, 226647807, 9, 1440x900 
0x37CA2318, 38092271596767424, 226647868, 226647876, 8, 1440x900 
0x37CA2318, 38092271597427472, 226647933, 226647941, 8, 1440x900 
0x37CA2318, 38092271598088456, 226647997, 226648004, 7, 1440x900 
0x37CA2318, 38092271598740456, 226648062, 226648070, 8, 1440x900 
0x37CA2318, 38092271599392976, 226648128, 226648136, 8, 1440x900 
0x37CA2318, 38092271600057912, 226648193, 226648201, 8, 1440x900 
0x37CA2318, 38092271600734464, 226648264, 226648272, 8, 1440x900 
0x37CA2318, 38092271601386256, 226648328, 226648335, 7, 1440x900 
0x37CA2318, 38092271602038624, 226648392, 226648400, 8, 1440x900 
0x37CA2318, 38092271602711344, 226648462, 226648470, 8, 1440x900 
0x37CA2318, 38092271603363088, 226648523, 226648531, 8, 1440x900 
0x37CA2318, 38092271604025048, 226648592, 226648600, 8, 1440x900 
0x37CA2318, 38092271604695496, 226648658, 226648666, 8, 1440x900 
0x37CA2318, 38092271605346024, 226648723, 226648731, 8, 1440x900 
0x37CA2318, 38092271606009264, 226648793, 226648801, 8, 1440x900 
0x37CA2318, 38092271606664424, 226648857, 226648865, 8, 1440x900 
0x37CA2318, 38092271607332984, 226648922, 226648931, 9, 1440x900 
0x37CA2318, 38092271607995208, 226648988, 226648996, 8, 1440x900 
0x37CA2318, 38092271608656992, 226649057, 226649065, 8, 1440x900 
0x37CA2318, 38092271609318816, 226649123, 226649131, 8, 1440x900 
0x37CA2318, 38092271609979656, 226649187, 226649195, 8, 1440x900 
0x37CA2318, 38092271610649472, 226649253, 226649261, 8, 1440x900 
0x37CA2318, 38092271611303608, 226649318, 226649326, 8, 1440x900 
0x37CA2318, 38092271611964096, 226649384, 226649391, 7, 1440x900 
0x37CA2318, 38092271612622392, 226649453, 226649461, 8, 1440x900 
0x37CA2318, 38092271613290808, 226649516, 226649524, 8, 1440x900 
0x37CA2318, 38092271613953032, 226649583, 226649591, 8, 1440x900 
0x37CA2318, 38092271614616808, 226649652, 226649660, 8, 1440x900 
0x37CA2318, 38092271615277048, 226649718, 226649726, 8, 1440x900 
0x37CA2318, 38092271615930256, 226649782, 226649790, 8, 1440x900 
0x37CA2318, 38092271616606472, 226649848, 226649857, 9, 1440x900 
0x37CA2318, 38092271617274384, 226649917, 226649925, 8, 1440x900 
0x37CA2318, 38092271617918544, 226649982, 226649990, 8, 1440x900 
0x37CA2318, 38092271618589720, 226650047, 226650055, 8, 1440x900 
0x37CA2318, 38092271619248104, 226650113, 226650121, 8, 1440x900 
0x37CA2318, 38092271619913168, 226650182, 226650190, 8, 1440x900 
0x37CA2318, 38092271620583896, 226650248, 226650256, 8, 1440x900 
0x37CA2318, 38092271621242472, 226650313, 226650321, 8, 1440x900 
0x37CA2318, 38092271621893016, 226650377, 226650385, 8, 1440x900 
0x37CA2318, 38092271622555528, 226650442, 226650449, 7, 1440x900 
0x37CA2318, 38092271623215264, 226650512, 226650520, 8, 1440x900 
0x37CA2318, 38092271623887144, 226650577, 226650586, 9, 1440x900 
0x37CA2318, 38092271624541088, 226650639, 226650647, 8, 1440x900 
0x37CA2318, 38092271625207096, 226650708, 226650716, 8, 1440x900 
0x37CA2318, 38092271625865624, 226650778, 226650786, 8, 1440x900 
0x37CA2318, 38092271626526576, 226650849, 226650857, 8, 1440x900 
0x37CA2318, 38092271627177392, 226650908, 226650916, 8, 1440x900 
0x37CA2318, 38092271627840392, 226650972, 226650980, 8, 1440x900 
0x37CA2318, 38092271628508528, 226651039, 226651046, 7, 1440x900 
0x37CA2318, 38092271629161776, 226651103, 226651112, 9, 1440x900 
0x37CA2318, 38092271629822856, 226651168, 226651175, 7, 1440x900 
0x37CA2318, 38092271630481072, 226651233, 226651241, 8, 1440x900 
0x37CA2318, 38092271631141912, 226651303, 226651311, 8, 1440x900 
0x37CA2318, 38092271631795896, 226651372, 226651385, 13, 1440x900 
0x37CA2318, 38092271632467352, 226651433, 226651442, 9, 1440x900 
0x37CA2318, 38092271633124056, 226651498, 226651505, 7, 1440x900 
0x37CA2318, 38092271633797392, 226651571, 226651580, 9, 1440x900 
0x37CA2318, 38092271634447104, 226651632, 226651640, 8, 1440x900 
0x37CA2318, 38092271635114528, 226651698, 226651707, 9, 1440x900 
0x37CA2318, 38092271635779936, 226651767, 226651775, 8, 1440x900 
0x37CA2318, 38092271636426592, 226651832, 226651840, 8, 1440x900 
0x37CA2318, 38092271637089832, 226651896, 226651904, 8, 1440x900 
0x37CA2318, 38092271637760264, 226651968, 226651976, 8, 1440x900 
0x37CA2318, 38092271638430304, 226652032, 226652040, 8, 1440x900 
0x37CA2318, 38092271639091680, 226652098, 226652106, 8, 1440x900 
0x37CA2318, 38092271640412144, 226652228, 226652236, 8, 1440x900 
0x37CA2318, 38092271641078464, 226652298, 226652306, 8, 1440x900 
0x37CA2318, 38092271641734104, 226652363, 226652371, 8, 1440x900 
0x37CA2318, 38092271642392480, 226652428, 226652436, 8, 1440x900 
0x37CA2318, 38092271643055568, 226652497, 226652505, 8, 1440x900 
0x37CA2318, 38092271643718152, 226652563, 226652571, 8, 1440x900 
0x37CA2318, 38092271644380256, 226652628, 226652636, 8, 1440x900 
0x37CA2318, 38092271645033696, 226652692, 226652700, 8, 1440x900 
0x37CA2318, 38092271645704984, 226652759, 226652767, 8, 1440x900 
0x37CA2318, 38092271646365048, 226652827, 226652835, 8, 1440x900 
0x37CA2318, 38092271647034568, 226652894, 226652902, 8, 1440x900 
0x37CA2318, 38092271647695376, 226652958, 226652966, 8, 1440x900 
0x37CA2318, 38092271648346656, 226653027, 226653035, 8, 1440x900 
0x37CA2318, 38092271649011312, 226653092, 226653100, 8, 1440x900 
0x37CA2318, 38092271649664464, 226653157, 226653166, 9, 1440x900 
0x37CA2318, 38092271650338024, 226653222, 226653230, 8, 1440x900 
0x37CA2318, 38092271650992048, 226653287, 226653295, 8, 1440x900 
0x37CA2318, 38092271651653912, 226653359, 226653366, 7, 1440x900 
0x37CA2318, 38092271652313216, 226653422, 226653431, 9, 1440x900 
0x37CA2318, 38092271652973936, 226653487, 226653495, 8, 1440x900 
0x37CA2318, 38092271653642800, 226653557, 226653565, 8, 1440x900 
0x37CA2318, 38092271654294192, 226653618, 226653626, 8, 1440x900 
0x37CA2318, 38092271654965712, 226653698, 226653707, 9, 1440x900 
0x37CA2318, 38092271655472216, 226653732, 226653739, 7, 1440x900 
0x37CA2318, 38092271656082736, 226653793, 226653802, 9, 1440x900 
0x37CA2318, 38092271656944264, 226653883, 226653891, 8, 1440x900 
0x37CA2318, 38092271657603128, 226653948, 226653957, 9, 1440x900 
0x37CA2318, 38092271658265136, 226654018, 226654026, 8, 1440x900 
0x37CA2318, 38092271658921824, 226654082, 226654090, 8, 1440x900 
0x37CA2318, 38092271659576960, 226654147, 226654155, 8, 1440x900 
0x37CA2318, 38092271660245192, 226654213, 226654220, 7, 1440x900 
0x37CA2318, 38092271660906152, 226654283, 226654291, 8, 1440x900 
0x37CA2318, 38092271661558032, 226654347, 226654355, 8, 1440x900 
0x37CA2318, 38092271662209760, 226654409, 226654417, 8, 1440x900 
0x37CA2318, 38092271662881712, 226654477, 226654485, 8, 1440x900 
0x37CA2318, 38092271663542992, 226654543, 226654551, 8, 1440x900 
0x37CA2318, 38092271664212512, 226654612, 226654620, 8, 1440x900 
0x37CA2318, 38092271664870616, 226654672, 226654681, 9, 1440x900 
0x37CA2318, 38092271665528712, 226654743, 226654751, 8, 1440x900 
0x37CA2318, 38092271666191472, 226654807, 226654815, 8, 1440x900 
0x37CA2318, 38092271666861512, 226654878, 226654886, 8, 1440x900 
0x37CA2318, 38092271667513168, 226654938, 226654946, 8, 1440x900 
0x37CA2318, 38092271668167712, 226655003, 226655010, 7, 1440x900 
0x37CA2318, 38092271668836192, 226655073, 226655088, 15, 1440x900 
0x37CA2318, 38092271669495816, 226655137, 226655145, 8, 1440x900 
0x37CA2318, 38092271670146968, 226655202, 226655210, 8, 1440x900 
0x37CA2318, 38092271670816640, 226655272, 226655280, 8, 1440x900 
0x37CA2318, 38092271671486720, 226655337, 226655344, 7, 1440x900 
0x37CA2318, 38092271672136032, 226655402, 226655410, 8, 1440x900 
0x37CA2318, 38092271672789080, 226655468, 226655476, 8, 1440x900 
0x37CA2318, 38092271673464744, 226655538, 226655545, 7, 1440x900 
0x37CA2318, 38092271674126760, 226655603, 226655610, 7, 1440x900 
0x37CA2318, 38092271674773360, 226655667, 226655675, 8, 1440x900 
0x37CA2318, 38092271675441192, 226655732, 226655740, 8, 1440x900 
0x37CA2318, 38092271676099208, 226655797, 226655805, 8, 1440x900 
0x37CA2318, 38092271676769088, 226655868, 226655876, 8, 1440x900 
0x37CA2318, 38092271677420456, 226655932, 226655940, 8, 1440x900 
0x37CA2318, 38092271678090056, 226655997, 226656005, 8, 1440x900 
0x37CA2318, 38092271678750528, 226656062, 226656070, 8, 1440x900 
0x37CA2318, 38092271679403296, 226656128, 226656136, 8, 1440x900 
0x37CA2318, 38092271680063184, 226656192, 226656202, 10, 1440x900 
0x37CA2318, 38092271680717832, 226656259, 226656267, 8, 1440x900 
0x37CA2318, 38092271681385416, 226656327, 226656335, 8, 1440x900 
0x37CA2318, 38092271682047656, 226656397, 226656405, 8, 1440x900 
0x37CA2318, 38092271682707536, 226656457, 226656466, 9, 1440x900 
0x37CA2318, 38092271683361160, 226656527, 226656535, 8, 1440x900 
0x37CA2318, 38092271684041088, 226656592, 226656600, 8, 1440x900 
0x37CA2318, 38092271684692272, 226656657, 226656665, 8, 1440x900 
0x37CA2318, 38092271685349816, 226656722, 226656730, 8, 1440x900 
0x37CA2318, 38092271686019640, 226656788, 226656796, 8, 1440x900 
0x37CA2318, 38092271686689864, 226656857, 226656865, 8, 1440x900 
0x37CA2318, 38092271687339544, 226656922, 226656930, 8, 1440x900 
0x37CA2318, 38092271687998536, 226656988, 226656996, 8, 1440x900 
0x37CA2318, 38092271688662960, 226657058, 226657066, 8, 1440x900 
0x37CA2318, 38092271689325072, 226657123, 226657131, 8, 1440x900 
0x37CA2318, 38092271689986816, 226657187, 226657195, 8, 1440x900 
0x37CA2318, 38092271690645048, 226657252, 226657260, 8, 1440x900 
0x37CA2318, 38092271691304536, 226657322, 226657330, 8, 1440x900 
0x37CA2318, 38092271691957456, 226657382, 226657389, 7, 1440x900 
0x37CA2318, 38092271692626384, 226657448, 226657456, 8, 1440x900 
0x37CA2318, 38092271693289304, 226657517, 226657524, 7, 1440x900 
0x37CA2318, 38092271693951344, 226657582, 226657589, 7, 1440x900 
0x37CA2318, 38092271694613400, 226657652, 226657660, 8, 1440x900 
0x37CA2318, 38092271695264880, 226657718, 226657726, 8, 1440x900 
0x37CA2318, 38092271695927168, 226657778, 226657786, 8, 1440x900 
0x37CA2318, 38092271696596304, 226657847, 226657855, 8, 1440x900 
0x37CA2318, 38092271697240328, 226657913, 226657921, 8, 1440x900 
0x37CA2318, 38092271697907920, 226657978, 226657987, 9, 1440x900 
0x37CA2318, 38092271698561128, 226658047, 226658055, 8, 1440x900 
0x37CA2318, 38092271699230600, 226658113, 226658121, 8, 1440x900 
0x37CA2318, 38092271699899416, 226658177, 226658186, 9, 1440x900 
0x37CA2318, 38092271700553288, 226658243, 226658251, 8, 1440x900 
0x37CA2318, 38092271701223352, 226658308, 226658317, 9, 1440x900 
0x37CA2318, 38092271701874136, 226658377, 226658386, 9, 1440x900 
0x37CA2318, 38092271702536432, 226658442, 226658450, 8, 1440x900 
0x37CA2318, 38092271703187152, 226658508, 226658516, 8, 1440x900 
0x37CA2318, 38092271703851928, 226658573, 226658581, 8, 1440x900 
0x37CA2318, 38092271704523384, 226658639, 226658647, 8, 1440x900 
0x37CA2318, 38092271705184096, 226658707, 226658715, 8, 1440x900 
0x37CA2318, 38092271705847360, 226658772, 226658779, 7, 1440x900 
0x37CA2318, 38092271706502328, 226658838, 226658845, 7, 1440x900 
0x37CA2318, 38092271707162376, 226658902, 226658910, 8, 1440x900 
0x37CA2318, 38092271707839504, 226658971, 226658979, 8, 1440x900 
0x37CA2318, 38092271708505088, 226659042, 226659050, 8, 1440x900 
0x37CA2318, 38092271709153824, 226659107, 226659115, 8, 1440x900 
0x37CA2318, 38092271709817216, 226659173, 226659181, 8, 1440x900 
0x37CA2318, 38092271710476880, 226659238, 226659246, 8, 1440x900 
0x37CA2318, 38092271711154896, 226659303, 226659311, 8, 1440x900 
0x37CA2318, 38092271711806200, 226659368, 226659377, 9, 1440x900 
0x37CA2318, 38092271712470656, 226659437, 226659445, 8, 1440x900 
0x37CA2318, 38092271713131888, 226659503, 226659511, 8, 1440x900 
0x37CA2318, 38092271713792296, 226659567, 226659576, 9, 1440x900 
0x37CA2318, 38092271714444640, 226659633, 226659640, 7, 1440x900 
0x37CA2318, 38092271715116400, 226659702, 226659710, 8, 1440x900 
0x37CA2318, 38092271715784016, 226659767, 226659776, 9, 1440x900 
0x37CA2318, 38092271716436592, 226659833, 226659841, 8, 1440x900 
0x37CA2318, 38092271717090448, 226659897, 226659905, 8, 1440x900 
0x37CA2318, 38092271717761696, 226659963, 226659972, 9, 1440x900 
0x37CA2318, 38092271718422096, 226660033, 226660041, 8, 1440x900 
0x37CA2318, 38092271719091352, 226660098, 226660106, 8, 1440x900 
0x37CA2318, 38092271720411880, 226660227, 226660236, 9, 1440x900 
0x37CA2318, 38092271721062864, 226660293, 226660302, 9, 1440x900 
0x37CA2318, 38092271721723472, 226660358, 226660368, 10, 1440x900 
0x37CA2318, 38092271722377200, 226660427, 226660435, 8, 1440x900 
0x37CA2318, 38092271723037760, 226660493, 226660501, 8, 1440x900 
0x37CA2318, 38092271723699472, 226660562, 226660570, 8, 1440x900 
0x37CA2318, 38092271724364160, 226660623, 226660631, 8, 1440x900 
0x37CA2318, 38092271725024328, 226660693, 226660701, 8, 1440x900 
0x37CA2318, 38092271725694120, 226660758, 226660766, 8, 1440x900 
0x37CA2318, 38092271726355464, 226660823, 226660831, 8, 1440x900 
0x37CA2318, 38092271727007112, 226660892, 226660900, 8, 1440x900 
0x37CA2318, 38092271727672464, 226660958, 226660966, 8, 1440x900 
0x37CA2318, 38092271728336072, 226661023, 226661030, 7, 1440x900 
0x37CA2318, 38092271728995752, 226661087, 226661094, 7, 1440x900 
0x37CA2318, 38092271729652480, 226661152, 226661161, 9, 1440x900 
0x37CA2318, 38092271730313176, 226661222, 226661230, 8, 1440x900 
0x37CA2318, 38092271730982600, 226661288, 226661295, 7, 1440x900 
0x37CA2318, 38092271731643240, 226661353, 226661361, 8, 1440x900 
0x37CA2318, 38092271732297064, 226661418, 226661426, 8, 1440x900 
0x37CA2318, 38092271732964656, 226661484, 226661492, 8, 1440x900 
0x37CA2318, 38092271733617904, 226661553, 226661561, 8, 1440x900 
0x37CA2318, 38092271734279032, 226661617, 226661625, 8, 1440x900 
0x37CA2318, 38092271734931600, 226661683, 226661691, 8, 1440x900 
0x37CA2318, 38092271735599592, 226661747, 226661755, 8, 1440x900 
0x37CA2318, 38092271736252088, 226661812, 226661820, 8, 1440x900 
0x37CA2318, 38092271736914240, 226661878, 226661886, 8, 1440x900 
0x37CA2318, 38092271737585112, 226661948, 226661955, 7, 1440x900 
0x37CA2318, 38092271738251856, 226662013, 226662021, 8, 1440x900 
0x37CA2318, 38092271738910712, 226662077, 226662086, 9, 1440x900 
0x37CA2318, 38092271739572072, 226662142, 226662150, 8, 1440x900 
0x37CA2318, 38092271740225680, 226662212, 226662219, 7, 1440x900 
0x37CA2318, 38092271740894504, 226662279, 226662287, 8, 1440x900 
0x37CA2318, 38092271741558480, 226662343, 226662351, 8, 1440x900 
0x37CA2318, 38092271742217384, 226662413, 226662421, 8, 1440x900 
0x37CA2318, 38092271742879120, 226662477, 226662485, 8, 1440x900 
0x37CA2318, 38092271743534512, 226662542, 226662550, 8, 1440x900 
0x37CA2318, 38092271744207656, 226662609, 226662617, 8, 1440x900 
0x37CA2318, 38092271744851048, 226662673, 226662681, 8, 1440x900 
0x37CA2318, 38092271745515160, 226662743, 226662751, 8, 1440x900 
0x37CA2318, 38092271746178464, 226662803, 226662811, 8, 1440x900 
0x37CA2318, 38092271746847776, 226662872, 226662879, 7, 1440x900 
0x37CA2318, 38092271747498992, 226662938, 226662945, 7, 1440x900 
0x37CA2318, 38092271748159752, 226663003, 226663011, 8, 1440x900 
0x37CA2318, 38092271748819784, 226663068, 226663075, 7, 1440x900 
0x37CA2318, 38092271749480680, 226663137, 226663144, 7, 1440x900 
0x37CA2318, 38092271750143472, 226663203, 226663212, 9, 1440x900 
0x37CA2318, 38092271750794792, 226663268, 226663276, 8, 1440x900 
0x37CA2318, 38092271751466256, 226663333, 226663342, 9, 1440x900 
0x37CA2318, 38092271752119712, 226663403, 226663411, 8, 1440x900 
0x37CA2318, 38092271752788608, 226663467, 226663475, 8, 1440x900 
0x37CA2318, 38092271753457600, 226663537, 226663545, 8, 1440x900 
0x37CA2318, 38092271754115984, 226663603, 226663611, 8, 1440x900 
0x37CA2318, 38092271754776600, 226663668, 226663676, 8, 1440x900 
0x37CA2318, 38092271755445840, 226663733, 226663741, 8, 1440x900 
0x37CA2318, 38092271756097392, 226663797, 226663805, 8, 1440x900 
0x37CA2318, 38092271756767680, 226663863, 226663872, 9, 1440x900 
0x37CA2318, 38092271757419648, 226663928, 226663937, 9, 1440x900 
0x37CA2318, 38092271758082656, 226663998, 226664006, 8, 1440x900 
0x37CA2318, 38092271758742784, 226664063, 226664071, 8, 1440x900 
0x37CA2318, 38092271759404984, 226664128, 226664136, 8, 1440x900 
0x37CA2318, 38092271760065328, 226664198, 226664206, 8, 1440x900 
0x37CA2318, 38092271760718776, 226664262, 226664270, 8, 1440x900 
0x37CA2318, 38092271761387760, 226664328, 226664336, 8, 1440x900 
0x37CA2318, 38092271762042184, 226664392, 226664400, 8, 1440x900 
0x37CA2318, 38092271762705040, 226664458, 226664466, 8, 1440x900 
0x37CA2318, 38092271763360064, 226664523, 226664531, 8, 1440x900 
0x37CA2318, 38092271764029816, 226664592, 226664600, 8, 1440x900 
0x37CA2318, 38092271764684208, 226664659, 226664667, 8, 1440x900 
0x37CA2318, 38092271765349608, 226664727, 226664735, 8, 1440x900 
0x37CA2318, 38092271766009608, 226664793, 226664801, 8, 1440x900 
0x37CA2318, 38092271766671208, 226664853, 226664860, 7, 1440x900 
0x37CA2318, 38092271767332416, 226664918, 226664926, 8, 1440x900 
0x37CA2318, 38092271767994288, 226664984, 226664992, 8, 1440x900 
0x37CA2318, 38092271768648360, 226665057, 226665065, 8, 1440x900 
0x37CA2318, 38092271769309072, 226665122, 226665130, 8, 1440x900 
0x37CA2318, 38092271769971080, 226665183, 226665192, 9, 1440x900 
0x37CA2318, 38092271770624448, 226665250, 226665257, 7, 1440x900 
0x37CA2318, 38092271771291056, 226665317, 226665326, 9, 1440x900 
0x37CA2318, 38092271771947312, 226665382, 226665391, 9, 1440x900 
0x37CA2318, 38092271772619264, 226665448, 226665457, 9, 1440x900 
0x37CA2318, 38092271773271552, 226665513, 226665522, 9, 1440x900 
0x37CA2318, 38092271773932760, 226665583, 226665591, 8, 1440x900 
0x37CA2318, 38092271774602992, 226665652, 226665660, 8, 1440x900 
0x37CA2318, 38092271775254536, 226665714, 226665722, 8, 1440x900 
0x37CA2318, 38092271775918416, 226665782, 226665790, 8, 1440x900 
0x37CA2318, 38092271776581784, 226665847, 226665855, 8, 1440x900 
0x37CA2318, 38092271777243016, 226665913, 226665921, 8, 1440x900 
0x37CA2318, 38092271777919864, 226665978, 226665986, 8, 1440x900 
0x37CA2318, 38092271778556272, 226666043, 226666051, 8, 1440x900 
0x37CA2318, 38092271779216568, 226666108, 226666119, 11, 1440x900 
0x37CA2318, 38092271779878136, 226666177, 226666185, 8, 1440x900 
0x37CA2318, 38092271780545848, 226666243, 226666251, 8, 1440x900 
0x37CA2318, 38092271781206864, 226666312, 226666320, 8, 1440x900 
0x37CA2318, 38092271781868048, 226666373, 226666380, 7, 1440x900 
0x37CA2318, 38092271782538088, 226666442, 226666450, 8, 1440x900 
0x37CA2318, 38092271783190912, 226666508, 226666516, 8, 1440x900 
0x37CA2318, 38092271783859864, 226666577, 226666585, 8, 1440x900 
0x37CA2318, 38092271784521656, 226666638, 226666647, 9, 1440x900 
0x37CA2318, 38092271785170464, 226666703, 226666712, 9, 1440x900 
0x37CA2318, 38092271785832032, 226666773, 226666781, 8, 1440x900 
0x37CA2318, 38092271786494832, 226666839, 226666848, 9, 1440x900 
0x37CA2318, 38092271787151912, 226666907, 226666915, 8, 1440x900 
0x37CA2318, 38092271787816976, 226666973, 226666980, 7, 1440x900 
0x37CA2318, 38092271788477512, 226667037, 226667045, 8, 1440x900 
0x37CA2318, 38092271789137360, 226667102, 226667113, 11, 1440x900 
0x37CA2318, 38092271789787744, 226667168, 226667176, 8, 1440x900 
0x37CA2318, 38092271790456904, 226667237, 226667245, 8, 1440x900 
0x37CA2318, 38092271791114464, 226667298, 226667307, 9, 1440x900 
0x37CA2318, 38092271791774608, 226667368, 226667376, 8, 1440x900 
0x37CA2318, 38092271792442544, 226667432, 226667440, 8, 1440x900 
0x37CA2318, 38092271793097232, 226667497, 226667504, 7, 1440x900 
0x37CA2318, 38092271793760048, 226667562, 226667569, 7, 1440x900 
0x37CA2318, 38092271794413240, 226667628, 226667637, 9, 1440x900 
0x37CA2318, 38092271795746208, 226667763, 226667771, 8, 1440x900 
0x37CA2318, 38092271796399872, 226667832, 226667840, 8, 1440x900 
0x37CA2318, 38092271797067888, 226667897, 226667905, 8, 1440x900 
0x37CA2318, 38092271797726384, 226667963, 226667971, 8, 1440x900 
0x37CA2318, 38092271798388720, 226668028, 226668036, 8, 1440x900 
0x37CA2318, 38092271799040616, 226668092, 226668100, 8, 1440x900 
0x37CA2318, 38092271799712888, 226668162, 226668170, 8, 1440x900 
0x37CA2318, 38092271800381808, 226668227, 226668235, 8, 1440x900 
0x37CA2318, 38092271801034336, 226668293, 226668301, 8, 1440x900 
0x37CA2318, 38092271801694648, 226668359, 226668366, 7, 1440x900 
0x37CA2318, 38092271802354632, 226668423, 226668431, 8, 1440x900 
0x37CA2318, 38092271803014440, 226668493, 226668500, 7, 1440x900 
0x37CA2318, 38092271803675976, 226668553, 226668561, 8, 1440x900 
0x37CA2318, 38092271804335640, 226668621, 226668628, 7, 1440x900 
0x37CA2318, 38092271804987728, 226668687, 226668695, 8, 1440x900 
0x37CA2318, 38092271805658424, 226668757, 226668765, 8, 1440x900 
0x37CA2318, 38092271806319472, 226668819, 226668827, 8, 1440x900 
0x37CA2318, 38092271806971400, 226668888, 226668896, 8, 1440x900 
0x37CA2318, 38092271807643112, 226668953, 226668961, 8, 1440x900 
0x37CA2318, 38092271808303928, 226669018, 226669026, 8, 1440x900 
0x37CA2318, 38092271808963464, 226669087, 226669095, 8, 1440x900 
0x37CA2318, 38092271809624152, 226669148, 226669157, 9, 1440x900 
0x37CA2318, 38092271810278224, 226669217, 226669225, 8, 1440x900 
0x37CA2318, 38092271810946280, 226669283, 226669291, 8, 1440x900 
0x37CA2318, 38092271811601968, 226669347, 226669355, 8, 1440x900 
0x37CA2318, 38092271812272264, 226669422, 226669429, 7, 1440x900 
0x37CA2318, 38092271812932752, 226669482, 226669490, 8, 1440x900 
0x37CA2318, 38092271813589136, 226669547, 226669556, 9, 1440x900 
0x37CA2318, 38092271814259464, 226669617, 226669625, 8, 1440x900 
0x37CA2318, 38092271814917744, 226669683, 226669691, 8, 1440x900 
0x37CA2318, 38092271815573072, 226669747, 226669755, 8, 1440x900 
0x37CA2318, 38092271816232920, 226669812, 226669820, 8, 1440x900 
0x37CA2318, 38092271816894816, 226669879, 226669887, 8, 1440x900 
0x37CA2318, 38092271817554424, 226669944, 226669952, 8, 1440x900 
0x37CA2318, 38092271818217848, 226670009, 226670017, 8, 1440x900 
0x37CA2318, 38092271818872408, 226670078, 226670086, 8, 1440x900 
0x37CA2318, 38092271819533720, 226670143, 226670151, 8, 1440x900 
0x37CA2318, 38092271820196960, 226670212, 226670220, 8, 1440x900 
0x37CA2318, 38092271820849456, 226670277, 226670285, 8, 1440x900 
0x37CA2318, 38092271821521456, 226670338, 226670347, 9, 1440x900 
0x37CA2318, 38092271822189008, 226670407, 226670415, 8, 1440x900 
0x37CA2318, 38092271822843328, 226670473, 226670481, 8, 1440x900 
0x37CA2318, 38092271823507592, 226670542, 226670550, 8, 1440x900 
0x37CA2318, 38092271824168984, 226670603, 226670612, 9, 1440x900 
0x37CA2318, 38092271824826184, 226670673, 226670681, 8, 1440x900 
0x37CA2318, 38092271825485416, 226670736, 226670744, 8, 1440x900 
0x37CA2318, 38092271826157496, 226670802, 226670811, 9, 1440x900 
0x37CA2318, 38092271826809016, 226670872, 226670880, 8, 1440x900 
0x37CA2318, 38092271827478272, 226670938, 226670947, 9, 1440x900 
0x37CA2318, 38092271828138560, 226670998, 226671006, 8, 1440x900 
0x37CA2318, 38092271828790592, 226671063, 226671071, 8, 1440x900 
0x37CA2318, 38092271829445000, 226671132, 226671139, 7, 1440x900 
0x37CA2318, 38092271830105864, 226671197, 226671204, 7, 1440x900 
0x37CA2318, 38092271830771184, 226671267, 226671275, 8, 1440x900 
0x37CA2318, 38092271831436464, 226671332, 226671339, 7, 1440x900 
0x37CA2318, 38092271832097200, 226671402, 226671410, 8, 1440x900 
0x37CA2318, 38092271832748208, 226671467, 226671475, 8, 1440x900 
0x37CA2318, 38092271833408992, 226671527, 226671536, 9, 1440x900 
0x37CA2318, 38092271834077952, 226671598, 226671606, 8, 1440x900 
0x37CA2318, 38092271834743096, 226671662, 226671670, 8, 1440x900 
0x37CA2318, 38092271835399864, 226671731, 226671739, 8, 1440x900 
0x37CA2318, 38092271836062952, 226671793, 226671801, 8, 1440x900 
0x37CA2318, 38092271836720648, 226671863, 226671871, 8, 1440x900 
0x37CA2318, 38092271837381864, 226671927, 226671935, 8, 1440x900 
0x37CA2318, 38092271838042144, 226671991, 226671999, 8, 1440x900 
0x37CA2318, 38092271838700000, 226672057, 226672064, 7, 1440x900 
0x37CA2318, 38092271839361112, 226672127, 226672134, 7, 1440x900 
0x37CA2318, 38092271840022496, 226672192, 226672200, 8, 1440x900 
0x37CA2318, 38092271840682312, 226672258, 226672266, 8, 1440x900 
0x37CA2318, 38092271841345728, 226672322, 226672330, 8, 1440x900 
0x37CA2318, 38092271842006240, 226672387, 226672396, 9, 1440x900 
0x37CA2318, 38092271842661200, 226672453, 226672461, 8, 1440x900 
0x37CA2318, 38092271843340680, 226672522, 226672530, 8, 1440x900 
0x37CA2318, 38092271843991088, 226672587, 226672595, 8, 1440x900 
0x37CA2318, 38092271844653872, 226672652, 226672660, 8, 1440x900 
0x37CA2318, 38092271845315184, 226672724, 226672733, 9, 1440x900 
0x37CA2318, 38092271845974912, 226672783, 226672791, 8, 1440x900 
0x37CA2318, 38092271846644208, 226672852, 226672860, 8, 1440x900 
0x37CA2318, 38092271847294720, 226672917, 226672924, 7, 1440x900 
0x37CA2318, 38092271847950880, 226672988, 226672996, 8, 1440x900 
0x37CA2318, 38092271848620880, 226673048, 226673056, 8, 1440x900 
0x37CA2318, 38092271849272504, 226673113, 226673120, 7, 1440x900 
0x37CA2318, 38092271849937720, 226673182, 226673190, 8, 1440x900 
0x37CA2318, 38092271850602696, 226673247, 226673255, 8, 1440x900 
0x37CA2318, 38092271851256656, 226673318, 226673326, 8, 1440x900 
0x37CA2318, 38092271851921696, 226673378, 226673387, 9, 1440x900 
0x37CA2318, 38092271852589584, 226673448, 226673456, 8, 1440x900 
0x37CA2318, 38092271853244672, 226673513, 226673521, 8, 1440x900 
0x37CA2318, 38092271853897872, 226673582, 226673590, 8, 1440x900 
0x37CA2318, 38092271854559912, 226673642, 226673651, 9, 1440x900 
0x37CA2318, 38092271855232048, 226673712, 226673721, 9, 1440x900 
0x37CA2318, 38092271855884328, 226673779, 226673786, 7, 1440x900 
0x37CA2318, 38092271856551296, 226673848, 226673856, 8, 1440x900 
0x37CA2318, 38092271857202320, 226673908, 226673916, 8, 1440x900 
0x37CA2318, 38092271857871720, 226673978, 226673986, 8, 1440x900 
0x37CA2318, 38092271858533464, 226674043, 226674051, 8, 1440x900 
0x37CA2318, 38092271859193248, 226674108, 226674116, 8, 1440x900 
0x37CA2318, 38092271859853872, 226674173, 226674181, 8, 1440x900 
0x37CA2318, 38092271860516016, 226674239, 226674246, 7, 1440x900 
0x37CA2318, 38092271861177144, 226674307, 226674315, 8, 1440x900 
0x37CA2318, 38092271861834464, 226674372, 226674379, 7, 1440x900 
0x37CA2318, 38092271862509240, 226674437, 226674446, 9, 1440x900 
0x37CA2318, 38092271863159504, 226674503, 226674511, 8, 1440x900 
0x37CA2318, 38092271863823048, 226674573, 226674581, 8, 1440x900 
0x37CA2318, 38092271864476072, 226674637, 226674645, 8, 1440x900 
0x37CA2318, 38092271865139456, 226674703, 226674711, 8, 1440x900 
0x37CA2318, 38092271865795936, 226674768, 226674776, 8, 1440x900 
0x37CA2318, 38092271866461648, 226674833, 226674841, 8, 1440x900 
0x37CA2318, 38092271867128920, 226674903, 226674911, 8, 1440x900 
0x37CA2318, 38092271867788896, 226674968, 226674976, 8, 1440x900 
0x37CA2318, 38092271868441048, 226675032, 226675041, 9, 1440x900 
0x37CA2318, 38092271869096736, 226675097, 226675105, 8, 1440x900 
0x37CA2318, 38092271869766928, 226675168, 226675176, 8, 1440x900 
0x37CA2318, 38092271870434056, 226675233, 226675241, 8, 1440x900 
0x37CA2318, 38092271871095576, 226675297, 226675305, 8, 1440x900 
0x37CA2318, 38092271871759360, 226675363, 226675372, 9, 1440x900 
0x37CA2318, 38092271873071560, 226675493, 226675502, 9, 1440x900 
0x37CA2318, 38092271873731560, 226675562, 226675569, 7, 1440x900 
0x37CA2318, 38092271874393216, 226675628, 226675636, 8, 1440x900 
0x37CA2318, 38092271875054656, 226675697, 226675705, 8, 1440x900 
0x37CA2318, 38092271875716136, 226675762, 226675770, 8, 1440x900 
0x37CA2318, 38092271876378824, 226675827, 226675835, 8, 1440x900 
0x37CA2318, 38092271877039480, 226675893, 226675901, 8, 1440x900 
0x37CA2318, 38092271877698056, 226675958, 226675966, 8, 1440x900 
0x37CA2318, 38092271878361784, 226676023, 226676031, 8, 1440x900 
0x37CA2318, 38092271879026736, 226676088, 226676096, 8, 1440x900 
0x37CA2318, 38092271879695648, 226676156, 226676163, 7, 1440x900 
0x37CA2318, 38092271880348128, 226676221, 226676228, 7, 1440x900 
0x37CA2318, 38092271881009392, 226676287, 226676294, 7, 1440x900 
0x37CA2318, 38092271881662368, 226676357, 226676365, 8, 1440x900 
0x37CA2318, 38092271882333032, 226676423, 226676431, 8, 1440x900 
0x37CA2318, 38092271882991872, 226676487, 226676496, 9, 1440x900 
0x37CA2318, 38092271883653112, 226676552, 226676561, 9, 1440x900 
0x37CA2318, 38092271884317176, 226676623, 226676631, 8, 1440x900 
0x37CA2318, 38092271884980168, 226676688, 226676696, 8, 1440x900 
0x37CA2318, 38092271885635808, 226676752, 226676760, 8, 1440x900 
0x37CA2318, 38092271886290672, 226676818, 226676826, 8, 1440x900 
0x37CA2318, 38092271886952088, 226676883, 226676891, 8, 1440x900 
0x37CA2318, 38092271887623528, 226676948, 226676957, 9, 1440x900 
0x37CA2318, 38092271888283656, 226677017, 226677025, 8, 1440x900 
0x37CA2318, 38092271888944520, 226677084, 226677092, 8, 1440x900 
0x37CA2318, 38092271889613960, 226677148, 226677157, 9, 1440x900 
0x37CA2318, 38092271890264808, 226677213, 226677220, 7, 1440x900 
0x37CA2318, 38092271890920352, 226677282, 226677290, 8, 1440x900 
0x37CA2318, 38092271891583832, 226677349, 226677357, 8, 1440x900 
0x37CA2318, 38092271892245296, 226677412, 226677420, 8, 1440x900 
0x37CA2318, 38092271892906936, 226677478, 226677487, 9, 1440x900 
0x37CA2318, 38092271893566416, 226677548, 226677556, 8, 1440x900 
0x37CA2318, 38092271894227984, 226677613, 226677621, 8, 1440x900 
0x37CA2318, 38092271894888784, 226677677, 226677685, 8, 1440x900 
0x37CA2318, 38092271895544344, 226677743, 226677752, 9, 1440x900 
0x37CA2318, 38092271896205720, 226677812, 226677820, 8, 1440x900 
0x37CA2318, 38092271896867080, 226677874, 226677882, 8, 1440x900 
0x37CA2318, 38092271897527648, 226677943, 226677951, 8, 1440x900 
0x37CA2318, 38092271898188976, 226678007, 226678015, 8, 1440x900 
0x37CA2318, 38092271898840000, 226678072, 226678080, 8, 1440x900 
0x37CA2318, 38092271899508360, 226678137, 226678144, 7, 1440x900 
0x37CA2318, 38092271900170472, 226678207, 226678215, 8, 1440x900 
0x37CA2318, 38092271900839440, 226678272, 226678279, 7, 1440x900 
0x37CA2318, 38092271901491848, 226678337, 226678345, 8, 1440x900 
0x37CA2318, 38092271902154640, 226678403, 226678411, 8, 1440x900 
0x37CA2318, 38092271902814032, 226678472, 226678480, 8, 1440x900 
0x37CA2318, 38092271903468064, 226678538, 226678546, 8, 1440x900 
0x37CA2318, 38092271904145760, 226678607, 226678615, 8, 1440x900 
0x37CA2318, 38092271904797136, 226678667, 226678675, 8, 1440x900 
0x37CA2318, 38092271905464696, 226678733, 226678742, 9, 1440x900 
0x37CA2318, 38092271906127512, 226678803, 226678811, 8, 1440x900 
0x37CA2318, 38092271906779960, 226678867, 226678875, 8, 1440x900 
0x37CA2318, 38092271907448256, 226678937, 226678945, 8, 1440x900 
0x37CA2318, 38092271908101256, 226678997, 226679005, 8, 1440x900 
0x37CA2318, 38092271908753288, 226679063, 226679071, 8, 1440x900 
0x37CA2318, 38092271909415728, 226679133, 226679141, 8, 1440x900 
0x37CA2318, 38092271910084744, 226679193, 226679201, 8, 1440x900 
0x37CA2318, 38092271910747936, 226679263, 226679271, 8, 1440x900 
0x37CA2318, 38092271911398512, 226679328, 226679336, 8, 1440x900 
0x37CA2318, 38092271912067552, 226679397, 226679405, 8, 1440x900 
0x37CA2318, 38092271912736752, 226679462, 226679470, 8, 1440x900 
0x37CA2318, 38092271913390688, 226679528, 226679536, 8, 1440x900 
0x37CA2318, 38092271914049880, 226679592, 226679600, 8, 1440x900 
0x37CA2318, 38092271914704152, 226679657, 226679667, 10, 1440x900 
0x37CA2318, 38092271915376768, 226679727, 226679735, 8, 1440x900 
0x37CA2318, 38092271916035096, 226679793, 226679801, 8, 1440x900 
0x37CA2318, 38092271916685800, 226679857, 226679865, 8, 1440x900 
0x37CA2318, 38092271917358112, 226679927, 226679935, 8, 1440x900 
0x37CA2318, 38092271918011328, 226679992, 226680000, 8, 1440x900 
0x37CA2318, 38092271918669688, 226680058, 226680066, 8, 1440x900 
0x37CA2318, 38092271919323696, 226680118, 226680127, 9, 1440x900 
0x37CA2318, 38092271919993336, 226680187, 226680195, 8, 1440x900 
0x37CA2318, 38092271920646728, 226680257, 226680265, 8, 1440x900 
0x37CA2318, 38092271921324816, 226680323, 226680331, 8, 1440x900 
0x37CA2318, 38092271921984328, 226680389, 226680397, 8, 1440x900 
0x37CA2318, 38092271922628640, 226680448, 226680456, 8, 1440x900 
0x37CA2318, 38092271923297336, 226680517, 226680525, 8, 1440x900 
0x37CA2318, 38092271923960016, 226680583, 226680591, 8, 1440x900 
0x37CA2318, 38092271924620768, 226680653, 226680661, 8, 1440x900 
0x37CA2318, 38092271925281856, 226680718, 226680726, 8, 1440x900 
0x37CA2318, 38092271925936576, 226680783, 226680791, 8, 1440x900 
0x37CA2318, 38092271926598320, 226680848, 226680857, 9, 1440x900 
0x37CA2318, 38092271927260304, 226680913, 226680922, 9, 1440x900 
0x37CA2318, 38092271927923952, 226680982, 226680990, 8, 1440x900 
0x37CA2318, 38092271928591416, 226681048, 226681056, 8, 1440x900 
0x37CA2318, 38092271929252464, 226681112, 226681120, 8, 1440x900 
0x37CA2318, 38092271929907680, 226681182, 226681190, 8, 1440x900 
0x37CA2318, 38092271930560656, 226681243, 226681250, 7, 1440x900 
0x37CA2318, 38092271931224512, 226681308, 226681316, 8, 1440x900 
0x37CA2318, 38092271931876288, 226681373, 226681381, 8, 1440x900 
0x37CA2318, 38092271932538872, 226681441, 226681449, 8, 1440x900 
0x37CA2318, 38092271933201672, 226681508, 226681516, 8, 1440x900 
0x37CA2318, 38092271933863496, 226681577, 226681585, 8, 1440x900 
0x37CA2318, 38092271934517904, 226681642, 226681650, 8, 1440x900 
0x37CA2318, 38092271935181888, 226681707, 226681716, 9, 1440x900 
0x37CA2318, 38092271935850912, 226681772, 226681779, 7, 1440x900 
0x37CA2318, 38092271936502480, 226681838, 226681845, 7, 1440x900 
0x37CA2318, 38092271937168088, 226681903, 226681912, 9, 1440x900 
0x37CA2318, 38092271937824432, 226681969, 226681978, 9, 1440x900 
0x37CA2318, 38092271938478384, 226682038, 226682046, 8, 1440x900 
0x37CA2318, 38092271939153776, 226682108, 226682117, 9, 1440x900 
0x37CA2318, 38092271939810240, 226682168, 226682176, 8, 1440x900 
0x37CA2318, 38092271940470832, 226682233, 226682240, 7, 1440x900 
0x37CA2318, 38092271941125896, 226682303, 226682311, 8, 1440x900 
0x37CA2318, 38092271941785384, 226682368, 226682376, 8, 1440x900 
0x37CA2318, 38092271942450760, 226682433, 226682442, 9, 1440x900 
0x37CA2318, 38092271943771776, 226682562, 226682571, 9, 1440x900 
0x37CA2318, 38092271944280256, 226682613, 226682621, 8, 1440x900 
0x37CA2318, 38092271945099088, 226682697, 226682704, 7, 1440x900 
0x37CA2318, 38092271945765776, 226682763, 226682770, 7, 1440x900 
0x37CA2318, 38092271946409648, 226682827, 226682834, 7, 1440x900 
0x37CA2318, 38092271947074688, 226682898, 226682905, 7, 1440x900 
0x37CA2318, 38092271947736280, 226682963, 226682970, 7, 1440x900 
0x37CA2318, 38092271948399408, 226683027, 226683034, 7, 1440x900 
0x37CA2318, 38092271949067600, 226683093, 226683101, 8, 1440x900 
0x37CA2318, 38092271949719664, 226683158, 226683166, 8, 1440x900 
0x37CA2318, 38092271950372008, 226683226, 226683234, 8, 1440x900 
0x37CA2318, 38092271951041272, 226683292, 226683300, 8, 1440x900 
0x37CA2318, 38092271951709960, 226683357, 226683364, 7, 1440x900 
0x37CA2318, 38092271952167936, 226683403, 226683410, 7, 1440x900 
0x37CA2318, 38092271953029032, 226683488, 226683495, 7, 1440x900 
0x37CA2318, 38092271953689008, 226683553, 226683560, 7, 1440x900 
0x37CA2318, 38092271954351336, 226683622, 226683630, 8, 1440x900 
0x37CA2318, 38092271955011456, 226683692, 226683701, 9, 1440x900 
0x37CA2318, 38092271955477504, 226683733, 226683740, 7, 1440x900 
0x37CA2318, 38092271956331944, 226683822, 226683829, 7, 1440x900 
0x37CA2318, 38092271957001736, 226683887, 226683896, 9, 1440x900 
0x37CA2318, 38092271957646312, 226683957, 226683965, 8, 1440x900 
0x37CA2318, 38092271958308744, 226684017, 226684026, 9, 1440x900 
0x37CA2318, 38092271958978176, 226684088, 226684096, 8, 1440x900 
0x37CA2318, 38092271959630464, 226684152, 226684160, 8, 1440x900 
0x37CA2318, 38092271960293392, 226684217, 226684225, 8, 1440x900 
0x37CA2318, 38092271960944304, 226684282, 226684290, 8, 1440x900 
0x37CA2318, 38092271961605336, 226684346, 226684353, 7, 1440x900 
0x37CA2318, 38092271962275472, 226684412, 226684420, 8, 1440x900 
0x37CA2318, 38092271962940224, 226684482, 226684490, 8, 1440x900 
0x37CA2318, 38092271963600720, 226684547, 226684555, 8, 1440x900 
0x37CA2318, 38092271964254856, 226684613, 226684620, 7, 1440x900 
0x37CA2318, 38092271964910984, 226684678, 226684685, 7, 1440x900 
0x37CA2318, 38092271965588496, 226684746, 226684753, 7, 1440x900 
0x37CA2318, 38092271966241688, 226684812, 226684820, 8, 1440x900 
0x37CA2318, 38092271966911776, 226684882, 226684890, 8, 1440x900 
0x37CA2318, 38092271967565248, 226684948, 226684956, 8, 1440x900 
0x37CA2318, 38092271968223600, 226685012, 226685020, 8, 1440x900 
0x37CA2318, 38092271968885712, 226685078, 226685086, 8, 1440x900 
0x37CA2318, 38092271969554768, 226685144, 226685152, 8, 1440x900 
0x37CA2318, 38092271970209088, 226685209, 226685217, 8, 1440x900 
0x37CA2318, 38092271970868360, 226685273, 226685280, 7, 1440x900 
0x37CA2318, 38092271971528920, 226685338, 226685346, 8, 1440x900 
0x37CA2318, 38092271972189656, 226685407, 226685415, 8, 1440x900 
0x37CA2318, 38092271972856328, 226685478, 226685486, 8, 1440x900 
0x37CA2318, 38092271973510536, 226685542, 226685550, 8, 1440x900 
0x37CA2318, 38092271974170048, 226685603, 226685612, 9, 1440x900 
0x37CA2318, 38092271974830312, 226685673, 226685681, 8, 1440x900 
0x37CA2318, 38092271975491648, 226685742, 226685750, 8, 1440x900 
0x37CA2318, 38092271976160744, 226685803, 226685810, 7, 1440x900 
0x37CA2318, 38092271976821368, 226685868, 226685876, 8, 1440x900 
0x37CA2318, 38092271977472456, 226685933, 226685940, 7, 1440x900 
0x37CA2318, 38092271978135760, 226686002, 226686010, 8, 1440x900 
0x37CA2318, 38092271978808136, 226686072, 226686080, 8, 1440x900 
0x37CA2318, 38092271979468224, 226686138, 226686146, 8, 1440x900 
0x37CA2318, 38092271980131448, 226686202, 226686210, 8, 1440x900 
0x37CA2318, 38092271980792496, 226686267, 226686275, 8, 1440x900 
0x37CA2318, 38092271981452728, 226686332, 226686339, 7, 1440x900 
0x37CA2318, 38092271982112896, 226686398, 226686405, 7, 1440x900 
0x37CA2318, 38092271982782736, 226686463, 226686471, 8, 1440x900 
0x37CA2318, 38092271983436952, 226686533, 226686540, 7, 1440x900 
0x37CA2318, 38092271984095784, 226686597, 226686606, 9, 1440x900 
0x37CA2318, 38092271984759280, 226686663, 226686672, 9, 1440x900 
0x37CA2318, 38092271985415408, 226686733, 226686741, 8, 1440x900 
0x37CA2318, 38092271986075936, 226686798, 226686806, 8, 1440x900 
0x37CA2318, 38092271986732720, 226686863, 226686870, 7, 1440x900 
0x37CA2318, 38092271987403912, 226686928, 226686937, 9, 1440x900 
0x37CA2318, 38092271988054200, 226686993, 226687000, 7, 1440x900 
0x37CA2318, 38092271988725992, 226687058, 226687065, 7, 1440x900 
0x37CA2318, 38092271989378216, 226687123, 226687131, 8, 1440x900 
0x37CA2318, 38092271990047768, 226687193, 226687201, 8, 1440x900 
0x37CA2318, 38092271990708912, 226687258, 226687266, 8, 1440x900 
0x37CA2318, 38092271991369272, 226687324, 226687332, 8, 1440x900 
0x37CA2318, 38092271992032328, 226687397, 226687405, 8, 1440x900 
0x37CA2318, 38092271992691512, 226687457, 226687465, 8, 1440x900 
0x37CA2318, 38092271993352448, 226687523, 226687531, 8, 1440x900 
0x37CA2318, 38092271994014408, 226687588, 226687597, 9, 1440x900 
0x37CA2318, 38092271994676440, 226687658, 226687666, 8, 1440x900 
0x37CA2318, 38092271995337488, 226687723, 226687731, 8, 1440x900 
0x37CA2318, 38092271996009728, 226687792, 226687800, 8, 1440x900 
0x37CA2318, 38092271996659792, 226687857, 226687865, 8, 1440x900 
0x37CA2318, 38092271997319984, 226687922, 226687929, 7, 1440x900 
0x37CA2318, 38092271997980928, 226687988, 226687996, 8, 1440x900 
0x37CA2318, 38092271998648456, 226688052, 226688060, 8, 1440x900 
0x37CA2318, 38092271999301752, 226688117, 226688125, 8, 1440x900 
0x37CA2318, 38092271999954152, 226688183, 226688192, 9, 1440x900 
0x37CA2318, 38092272000633056, 226688253, 226688261, 8, 1440x900 
0x37CA2318, 38092272001294624, 226688317, 226688326, 9, 1440x900 
0x37CA2318, 38092272001945648, 226688387, 226688395, 8, 1440x900 
0x37CA2318, 38092272002600064, 226688448, 226688456, 8, 1440x900 
0x37CA2318, 38092272003273976, 226688517, 226688525, 8, 1440x900 
0x37CA2318, 38092272003927464, 226688583, 226688591, 8, 1440x900 
0x37CA2318, 38092272004588808, 226688648, 226688656, 8, 1440x900 
0x37CA2318, 38092272005264704, 226688718, 226688726, 8, 1440x900 
0x37CA2318, 38092272005924440, 226688779, 226688788, 9, 1440x900 
0x37CA2318, 38092272006579440, 226688848, 226688856, 8, 1440x900 
0x37CA2318, 38092272007248888, 226688918, 226688926, 8, 1440x900 
0x37CA2318, 38092272007907776, 226688977, 226688984, 7, 1440x900 
0x37CA2318, 38092272008567440, 226689043, 226689050, 7, 1440x900 
0x37CA2318, 38092272009237008, 226689108, 226689116, 8, 1440x900 
0x37CA2318, 38092272009906584, 226689177, 226689184, 7, 1440x900 
0x37CA2318, 38092272010556232, 226689242, 226689249, 7, 1440x900 
0x37CA2318, 38092272011219104, 226689307, 226689314, 7, 1440x900 
0x37CA2318, 38092272011877312, 226689378, 226689386, 8, 1440x900 
0x37CA2318, 38092272012537168, 226689443, 226689451, 8, 1440x900 
0x37CA2318, 38092272013209592, 226689508, 226689516, 8, 1440x900 
0x37CA2318, 38092272013872640, 226689577, 226689585, 8, 1440x900 
0x37CA2318, 38092272014526280, 226689643, 226689651, 8, 1440x900 
0x37CA2318, 38092272015188040, 226689708, 226689716, 8, 1440x900 
0x37CA2318, 38092272015855728, 226689772, 226689781, 9, 1440x900 
0x37CA2318, 38092272016520896, 226689843, 226689851, 8, 1440x900 
0x37CA2318, 38092272017180184, 226689907, 226689915, 8, 1440x900 
0x37CA2318, 38092272017849056, 226689972, 226689981, 9, 1440x900 
0x37CA2318, 38092272018508136, 226690042, 226690050, 8, 1440x900 
0x37CA2318, 38092272019169304, 226690108, 226690116, 8, 1440x900 
0x37CA2318, 38092272019829472, 226690172, 226690180, 8, 1440x900 
0x37CA2318, 38092272020480864, 226690238, 226690246, 8, 1440x900 
0x37CA2318, 38092272021133080, 226690303, 226690311, 8, 1440x900 
0x37CA2318, 38092272021810584, 226690368, 226690375, 7, 1440x900 
0x37CA2318, 38092272022471760, 226690433, 226690441, 8, 1440x900 
0x37CA2318, 38092272023121424, 226690498, 226690505, 7, 1440x900 
0x37CA2318, 38092272023792088, 226690567, 226690575, 8, 1440x900 
0x37CA2318, 38092272024444216, 226690633, 226690641, 8, 1440x900 
0x37CA2318, 38092272025761944, 226690762, 226690771, 9, 1440x900 
0x37CA2318, 38092272026423224, 226690828, 226690837, 9, 1440x900 
0x37CA2318, 38092272027092840, 226690897, 226690905, 8, 1440x900 
0x37CA2318, 38092272027748464, 226690968, 226690976, 8, 1440x900 
0x37CA2318, 38092272028400560, 226691027, 226691035, 8, 1440x900 
0x37CA2318, 38092272029070848, 226691093, 226691102, 9, 1440x900 
0x37CA2318, 38092272029732552, 226691163, 226691171, 8, 1440x900 
0x37CA2318, 38092272030392200, 226691228, 226691236, 8, 1440x900 
0x37CA2318, 38092272031054048, 226691294, 226691302, 8, 1440x900 
0x37CA2318, 38092272031723920, 226691362, 226691370, 8, 1440x900 
0x37CA2318, 38092272032373848, 226691423, 226691433, 10, 1440x900 
0x37CA2318, 38092272033031792, 226691492, 226691500, 8, 1440x900 
0x37CA2318, 38092272033695584, 226691562, 226691570, 8, 1440x900 
0x37CA2318, 38092272034357752, 226691623, 226691631, 8, 1440x900 
0x37CA2318, 38092272035020256, 226691693, 226691701, 8, 1440x900 
0x37CA2318, 38092272035671872, 226691757, 226691765, 8, 1440x900 
0x37CA2318, 38092272036343280, 226691823, 226691831, 8, 1440x900 
0x37CA2318, 38092272037005568, 226691888, 226691897, 9, 1440x900 
0x37CA2318, 38092272037659088, 226691953, 226691962, 9, 1440x900 
0x37CA2318, 38092272038323256, 226692022, 226692030, 8, 1440x900 
0x37CA2318, 38092272038982216, 226692088, 226692096, 8, 1440x900 
0x37CA2318, 38092272039633176, 226692152, 226692160, 8, 1440x900 
0x37CA2318, 38092272040304096, 226692218, 226692227, 9, 1440x900 
0x37CA2318, 38092272040962064, 226692282, 226692291, 9, 1440x900 
0x37CA2318, 38092272041631552, 226692352, 226692360, 8, 1440x900 
0x37CA2318, 38092272042301352, 226692418, 226692427, 9, 1440x900 
0x37CA2318, 38092272042963192, 226692483, 226692491, 8, 1440x900 
0x37CA2318, 38092272043624000, 226692552, 226692560, 8, 1440x900 
0x37CA2318, 38092272044277152, 226692618, 226692625, 7, 1440x900 
0x37CA2318, 38092272044941160, 226692682, 226692690, 8, 1440x900 
0x37CA2318, 38092272045601504, 226692747, 226692755, 8, 1440x900 
0x37CA2318, 38092272046263008, 226692812, 226692821, 9, 1440x900 
0x37CA2318, 38092272046915400, 226692883, 226692891, 8, 1440x900 
0x37CA2318, 38092272047585768, 226692948, 226692956, 8, 1440x900 
0x37CA2318, 38092272048246600, 226693017, 226693025, 8, 1440x900 
0x37CA2318, 38092272048908224, 226693078, 226693086, 8, 1440x900 
0x37CA2318, 38092272049567648, 226693147, 226693155, 8, 1440x900 
0x37CA2318, 38092272050229304, 226693212, 226693220, 8, 1440x900 
0x37CA2318, 38092272050884472, 226693278, 226693286, 8, 1440x900 
0x37CA2318, 38092272051547392, 226693342, 226693350, 8, 1440x900 
0x37CA2318, 38092272052212624, 226693412, 226693420, 8, 1440x900 
0x37CA2318, 38092272052865232, 226693478, 226693486, 8, 1440x900 
0x37CA2318, 38092272053533856, 226693543, 226693552, 9, 1440x900 
0x37CA2318, 38092272054192816, 226693606, 226693613, 7, 1440x900 
0x37CA2318, 38092272054863024, 226693677, 226693685, 8, 1440x900 
0x37CA2318, 38092272055515968, 226693742, 226693750, 8, 1440x900 
0x37CA2318, 38092272056178344, 226693808, 226693816, 8, 1440x900 
0x37CA2318, 38092272056829224, 226693873, 226693881, 8, 1440x900 
0x37CA2318, 38092272057491672, 226693937, 226693945, 8, 1440x900 
0x37CA2318, 38092272058157392, 226694003, 226694011, 8, 1440x900 
0x37CA2318, 38092272058821120, 226694068, 226694077, 9, 1440x900 
0x37CA2318, 38092272059474216, 226694138, 226694147, 9, 1440x900 
0x37CA2318, 38092272060135040, 226694202, 226694210, 8, 1440x900 
0x37CA2318, 38092272060797792, 226694268, 226694276, 8, 1440x900 
0x37CA2318, 38092272061466576, 226694338, 226694346, 8, 1440x900 
0x37CA2318, 38092272062119088, 226694398, 226694407, 9, 1440x900 
0x37CA2318, 38092272062778536, 226694463, 226694471, 8, 1440x900 
0x37CA2318, 38092272063448928, 226694533, 226694541, 8, 1440x900 
0x37CA2318, 38092272064101840, 226694602, 226694610, 8, 1440x900 
0x37CA2318, 38092272064758392, 226694663, 226694671, 8, 1440x900 
0x37CA2318, 38092272065420320, 226694728, 226694737, 9, 1440x900 
0x37CA2318, 38092272066076520, 226694798, 226694806, 8, 1440x900 
0x37CA2318, 38092272066743232, 226694863, 226694871, 8, 1440x900 
0x37CA2318, 38092272067406976, 226694932, 226694940, 8, 1440x900 
0x37CA2318, 38092272068069864, 226694998, 226695006, 8, 1440x900 
0x37CA2318, 38092272068722992, 226695058, 226695066, 8, 1440x900 
0x37CA2318, 38092272069392792, 226695127, 226695134, 7, 1440x900 
0x37CA2318, 38092272070051640, 226695193, 226695200, 7, 1440x900 
0x37CA2318, 38092272070712736, 226695257, 226695265, 8, 1440x900 
0x37CA2318, 38092272071366416, 226695323, 226695331, 8, 1440x900 
0x37CA2318, 38092272072040200, 226695392, 226695400, 8, 1440x900 
0x37CA2318, 38092272072698952, 226695458, 226695466, 8, 1440x900 
0x37CA2318, 38092272073360360, 226695522, 226695530, 8, 1440x900 
0x37CA2318, 38092272074016512, 226695593, 226695601, 8, 1440x900 
0x37CA2318, 38092272074687304, 226695657, 226695665, 8, 1440x900 
0x37CA2318, 38092272075355136, 226695723, 226695732, 9, 1440x900 
0x37CA2318, 38092272076015584, 226695792, 226695800, 8, 1440x900 
0x37CA2318, 38092272076668152, 226695857, 226695865, 8, 1440x900 
0x37CA2318, 38092272077328064, 226695923, 226695931, 8, 1440x900 
0x37CA2318, 38092272077997880, 226695988, 226695997, 9, 1440x900 
0x37CA2318, 38092272078650368, 226696052, 226696060, 8, 1440x900 
0x37CA2318, 38092272079309728, 226696123, 226696131, 8, 1440x900 
0x37CA2318, 38092272079973008, 226696183, 226696192, 9, 1440x900 
0x37CA2318, 38092272080640072, 226696252, 226696260, 8, 1440x900 
0x37CA2318, 38092272081292248, 226696317, 226696325, 8, 1440x900 
0x37CA2318, 38092272081953616, 226696387, 226696395, 8, 1440x900 
0x37CA2318, 38092272082615312, 226696453, 226696461, 8, 1440x900 
0x37CA2318, 38092272083267896, 226696513, 226696521, 8, 1440x900 
0x37CA2318, 38092272083939640, 226696582, 226696590, 8, 1440x900 
0x37CA2318, 38092272084595288, 226696647, 226696654, 7, 1440x900 
0x37CA2318, 38092272085267352, 226696716, 226696724, 8, 1440x900 
0x37CA2318, 38092272085917072, 226696777, 226696785, 8, 1440x900 
0x37CA2318, 38092272086588312, 226696847, 226696855, 8, 1440x900 
0x37CA2318, 38092272087239448, 226696912, 226696920, 8, 1440x900 
0x37CA2318, 38092272087910456, 226696982, 226696990, 8, 1440x900 
0x37CA2318, 38092272088560112, 226697047, 226697055, 8, 1440x900 
0x37CA2318, 38092272089223936, 226697113, 226697121, 8, 1440x900 
0x37CA2318, 38092272089883320, 226697177, 226697185, 8, 1440x900 
0x37CA2318, 38092272090535752, 226697242, 226697250, 8, 1440x900 
0x37CA2318, 38092272091204624, 226697309, 226697317, 8, 1440x900 
0x37CA2318, 38092272091866384, 226697374, 226697382, 8, 1440x900 
0x37CA2318, 38092272092520456, 226697443, 226697451, 8, 1440x900 
0x37CA2318, 38092272093189032, 226697508, 226697516, 8, 1440x900 
0x37CA2318, 38092272093850464, 226697571, 226697578, 7, 1440x900 
0x37CA2318, 38092272094509688, 226697637, 226697646, 9, 1440x900 
0x37CA2318, 38092272095162240, 226697708, 226697717, 9, 1440x900 
0x37CA2318, 38092272095829352, 226697768, 226697776, 8, 1440x900 
0x37CA2318, 38092272096484392, 226697838, 226697846, 8, 1440x900 
0x37CA2318, 38092272097146496, 226697907, 226697915, 8, 1440x900 
0x37CA2318, 38092272097807648, 226697972, 226697980, 8, 1440x900 
0x37CA2318, 38092272098486904, 226698037, 226698045, 8, 1440x900 
0x37CA2318, 38092272099137736, 226698103, 226698111, 8, 1440x900 
0x37CA2318, 38092272099798176, 226698167, 226698175, 8, 1440x900 
0x37CA2318, 38092272100463232, 226698233, 226698241, 8, 1440x900 
0x37CA2318, 38092272101120272, 226698302, 226698310, 8, 1440x900 
0x37CA2318, 38092272101782336, 226698368, 226698376, 8, 1440x900 
0x37CA2318, 38092272102438328, 226698432, 226698440, 8, 1440x900 
0x37CA2318, 38092272103107128, 226698498, 226698506, 8, 1440x900 
0x37CA2318, 38092272104420408, 226698632, 226698640, 8, 1440x900 
0x37CA2318, 38092272105083160, 226698698, 226698706, 8, 1440x900 
0x37CA2318, 38092272105740440, 226698762, 226698770, 8, 1440x900 
0x37CA2318, 38092272106393376, 226698827, 226698834, 7, 1440x900 
0x37CA2318, 38092272107063976, 226698893, 226698902, 9, 1440x900 
0x37CA2318, 38092272107716712, 226698963, 226698971, 8, 1440x900 
0x37CA2318, 38092272108381776, 226699027, 226699035, 8, 1440x900 
0x37CA2318, 38092272109044080, 226699093, 226699101, 8, 1440x900 
0x37CA2318, 38092272109695384, 226699158, 226699166, 8, 1440x900 
0x37CA2318, 38092272110361104, 226699223, 226699231, 8, 1440x900 
0x37CA2318, 38092272111024360, 226699293, 226699300, 7, 1440x900 
0x37CA2318, 38092272111675808, 226699358, 226699366, 8, 1440x900 
0x37CA2318, 38092272112340320, 226699423, 226699431, 8, 1440x900 
0x37CA2318, 38092272113002976, 226699487, 226699495, 8, 1440x900 
0x37CA2318, 38092272113664008, 226699553, 226699562, 9, 1440x900 
0x37CA2318, 38092272114325584, 226699623, 226699631, 8, 1440x900 
0x37CA2318, 38092272114984408, 226699688, 226699695, 7, 1440x900 
0x37CA2318, 38092272115640064, 226699753, 226699761, 8, 1440x900 
0x37CA2318, 38092272116305992, 226699818, 226699826, 8, 1440x900 
0x37CA2318, 38092272116966000, 226699886, 226699894, 8, 1440x900 
0x37CA2318, 38092272117625728, 226699953, 226699961, 8, 1440x900 
0x37CA2318, 38092272118289840, 226700017, 226700025, 8, 1440x900 
0x37CA2318, 38092272118954920, 226700082, 226700091, 9, 1440x900 
0x37CA2318, 38092272119614368, 226700153, 226700161, 8, 1440x900 
0x37CA2318, 38092272120264432, 226700218, 226700225, 7, 1440x900 
0x37CA2318, 38092272120933424, 226700282, 226700290, 8, 1440x900 
0x37CA2318, 38092272121595424, 226700349, 226700357, 8, 1440x900 
0x37CA2318, 38092272122246616, 226700412, 226700420, 8, 1440x900 
0x37CA2318, 38092272122911208, 226700478, 226700486, 8, 1440x900 
0x37CA2318, 38092272123574224, 226700543, 226700552, 9, 1440x900 
0x37CA2318, 38092272124227688, 226700612, 226700619, 7, 1440x900 
0x37CA2318, 38092272124906864, 226700679, 226700687, 8, 1440x900 
0x37CA2318, 38092272125560600, 226700743, 226700752, 9, 1440x900 
0x37CA2318, 38092272126222896, 226700813, 226700821, 8, 1440x900 
0x37CA2318, 38092272126889688, 226700878, 226700885, 7, 1440x900 
0x37CA2318, 38092272127541200, 226700942, 226700950, 8, 1440x900 
0x37CA2318, 38092272128200064, 226701007, 226701015, 8, 1440x900 
0x37CA2318, 38092272128870072, 226701076, 226701084, 8, 1440x900 
0x37CA2318, 38092272129523784, 226701138, 226701147, 9, 1440x900 
0x37CA2318, 38092272130177784, 226701208, 226701216, 8, 1440x900 
0x37CA2318, 38092272130839944, 226701273, 226701281, 8, 1440x900 
0x37CA2318, 38092272131502664, 226701342, 226701350, 8, 1440x900 
0x37CA2318, 38092272132165064, 226701408, 226701416, 8, 1440x900 
0x37CA2318, 38092272132815960, 226701472, 226701480, 8, 1440x900 
0x37CA2318, 38092272133479456, 226701538, 226701546, 8, 1440x900 
0x37CA2318, 38092272134157264, 226701608, 226701616, 8, 1440x900 
0x37CA2318, 38092272134816592, 226701668, 226701675, 7, 1440x900 
0x37CA2318, 38092272135481576, 226701738, 226701746, 8, 1440x900 
0x37CA2318, 38092272136139112, 226701802, 226701810, 8, 1440x900 
0x37CA2318, 38092272136798704, 226701872, 226701880, 8, 1440x900 
0x37CA2318, 38092272137468392, 226701933, 226701942, 9, 1440x900 
0x37CA2318, 38092272138119424, 226702003, 226702011, 8, 1440x900 
0x37CA2318, 38092272138779936, 226702067, 226702075, 8, 1440x900 
0x37CA2318, 38092272139442448, 226702132, 226702140, 8, 1440x900 
0x37CA2318, 38092272140094296, 226702198, 226702207, 9, 1440x900 
0x37CA2318, 38092272140766448, 226702263, 226702270, 7, 1440x900 
0x37CA2318, 38092272141426896, 226702333, 226702341, 8, 1440x900 
0x37CA2318, 38092272142089664, 226702397, 226702405, 8, 1440x900 
0x37CA2318, 38092272142757344, 226702463, 226702471, 8, 1440x900 
0x37CA2318, 38092272143420328, 226702528, 226702537, 9, 1440x900 
0x37CA2318, 38092272144070520, 226702598, 226702606, 8, 1440x900 
0x37CA2318, 38092272144748416, 226702666, 226702674, 8, 1440x900 
0x37CA2318, 38092272145399648, 226702732, 226702740, 8, 1440x900 
0x37CA2318, 38092272146060696, 226702793, 226702801, 8, 1440x900 
0x37CA2318, 38092272146729752, 226702863, 226702871, 8, 1440x900 
0x37CA2318, 38092272147391104, 226702928, 226702936, 8, 1440x900 
0x37CA2318, 38092272148050496, 226702992, 226703000, 8, 1440x900 
0x37CA2318, 38092272148703512, 226703063, 226703071, 8, 1440x900 
0x37CA2318, 38092272149371904, 226703128, 226703136, 8, 1440x900 
0x37CA2318, 38092272150025952, 226703193, 226703201, 8, 1440x900 
0x37CA2318, 38092272150687472, 226703258, 226703266, 8, 1440x900 
0x37CA2318, 38092272151346920, 226703327, 226703335, 8, 1440x900 
0x37CA2318, 38092272152007208, 226703389, 226703396, 7, 1440x900 
0x37CA2318, 38092272152668728, 226703457, 226703465, 8, 1440x900 
0x37CA2318, 38092272153328656, 226703518, 226703526, 8, 1440x900 
0x37CA2318, 38092272153979704, 226703583, 226703591, 8, 1440x900 
0x37CA2318, 38092272154648472, 226703652, 226703659, 7, 1440x900 
0x37CA2318, 38092272155301920, 226703717, 226703725, 8, 1440x900 
0x37CA2318, 38092272156040424, 226703791, 226703798, 7, 1440x900 
0x37CA2318, 38092272156641816, 226703848, 226703856, 8, 1440x900 
0x37CA2318, 38092272157302376, 226703917, 226703924, 7, 1440x900 
0x37CA2318, 38092272157954264, 226703983, 226703990, 7, 1440x900 
0x37CA2318, 38092272158614200, 226704048, 226704054, 6, 1440x900 
0x37CA2318, 38092272159268968, 226704113, 226704121, 8, 1440x900 
0x37CA2318, 38092272159931256, 226704182, 226704189, 7, 1440x900 
0x37CA2318, 38092272160609896, 226704248, 226704256, 8, 1440x900 
0x37CA2318, 38092272161264816, 226704318, 226704326, 8, 1440x900 
0x37CA2318, 38092272161922072, 226704383, 226704391, 8, 1440x900 
0x37CA2318, 38092272162574256, 226704443, 226704450, 7, 1440x900 
0x37CA2318, 38092272163244400, 226704512, 226704519, 7, 1440x900 
0x37CA2318, 38092272163907096, 226704582, 226704590, 8, 1440x900 
0x37CA2318, 38092272164568088, 226704643, 226704652, 9, 1440x900 
0x37CA2318, 38092272165228848, 226704713, 226704721, 8, 1440x900 
0x37CA2318, 38092272165888800, 226704778, 226704786, 8, 1440x900 
0x37CA2318, 38092272166550184, 226704848, 226704856, 8, 1440x900 
0x37CA2318, 38092272167201104, 226704908, 226704916, 8, 1440x900 
0x37CA2318, 38092272167871512, 226704977, 226704985, 8, 1440x900 
0x37CA2318, 38092272168533168, 226705043, 226705051, 8, 1440x900 
0x37CA2318, 38092272169194400, 226705108, 226705116, 8, 1440x900 
0x37CA2318, 38092272169852000, 226705173, 226705181, 8, 1440x900 
0x37CA2318, 38092272170514544, 226705239, 226705247, 8, 1440x900 
0x37CA2318, 38092272171174736, 226705308, 226705316, 8, 1440x900 
0x37CA2318, 38092272171827456, 226705373, 226705381, 8, 1440x900 
0x37CA2318, 38092272172505856, 226705443, 226705451, 8, 1440x900 
0x37CA2318, 38092272173156600, 226705502, 226705509, 7, 1440x900 
0x37CA2318, 38092272173819608, 226705572, 226705580, 8, 1440x900 
0x37CA2318, 38092272174472656, 226705637, 226705645, 8, 1440x900 
0x37CA2318, 38092272175143152, 226705702, 226705710, 8, 1440x900 
0x37CA2318, 38092272175803848, 226705767, 226705775, 8, 1440x900 
0x37CA2318, 38092272176465440, 226705837, 226705846, 9, 1440x900 
0x37CA2318, 38092272177133576, 226705898, 226705906, 8, 1440x900 
0x37CA2318, 38092272177787808, 226705968, 226705976, 8, 1440x900 
0x37CA2318, 38092272178440824, 226706033, 226706041, 8, 1440x900 
0x37CA2318, 38092272179110456, 226706102, 226706110, 8, 1440x900 
0x37CA2318, 38092272179771816, 226706168, 226706176, 8, 1440x900 
0x37CA2318, 38092272181094496, 226706299, 226706307, 8, 1440x900 
0x37CA2318, 38092272181746080, 226706363, 226706371, 8, 1440x900 
0x37CA2318, 38092272182408976, 226706428, 226706437, 9, 1440x900 
0x37CA2318, 38092272183070888, 226706492, 226706500, 8, 1440x900 
0x37CA2318, 38092272183732296, 226706558, 226706565, 7, 1440x900 
0x37CA2318, 38092272184398976, 226706627, 226706635, 8, 1440x900 
0x37CA2318, 38092272185061016, 226706692, 226706701, 9, 1440x900 
0x37CA2318, 38092272185713632, 226706762, 226706770, 8, 1440x900 
0x37CA2318, 38092272186386680, 226706828, 226706836, 8, 1440x900 
0x37CA2318, 38092272187049592, 226706892, 226706901, 9, 1440x900 
0x37CA2318, 38092272187710880, 226706958, 226706967, 9, 1440x900 
0x37CA2318, 38092272188363296, 226707023, 226707031, 8, 1440x900 
0x37CA2318, 38092272189018704, 226707093, 226707101, 8, 1440x900 
0x37CA2318, 38092272189689712, 226707158, 226707166, 8, 1440x900 
0x37CA2318, 38092272190343960, 226707223, 226707231, 8, 1440x900 
0x37CA2318, 38092272191006408, 226707292, 226707299, 7, 1440x900 
0x37CA2318, 38092272191666712, 226707357, 226707365, 8, 1440x900 
0x37CA2318, 38092272192323624, 226707418, 226707427, 9, 1440x900 
0x37CA2318, 38092272192998720, 226707487, 226707495, 8, 1440x900 
0x37CA2318, 38092272193656232, 226707553, 226707561, 8, 1440x900 
0x37CA2318, 38092272194317344, 226707618, 226707625, 7, 1440x900 
0x37CA2318, 38092272194973600, 226707683, 226707692, 9, 1440x900 
0x37CA2318, 38092272195647176, 226707753, 226707761, 8, 1440x900 
0x37CA2318, 38092272196298600, 226707816, 226707823, 7, 1440x900 
0x37CA2318, 38092272196952088, 226707883, 226707891, 8, 1440x900 
0x37CA2318, 38092272197622000, 226707948, 226707957, 9, 1440x900 
0x37CA2318, 38092272198285208, 226708018, 226708026, 8, 1440x900 
0x37CA2318, 38092272198938960, 226708083, 226708091, 8, 1440x900 
0x37CA2318, 38092272199605456, 226708148, 226708157, 9, 1440x900 
0x37CA2318, 38092272200268336, 226708217, 226708225, 8, 1440x900 
0x37CA2318, 38092272200927664, 226708283, 226708291, 8, 1440x900 
0x37CA2318, 38092272201590104, 226708347, 226708355, 8, 1440x900 
0x37CA2318, 38092272202250680, 226708413, 226708421, 8, 1440x900 
0x37CA2318, 38092272202910792, 226708482, 226708490, 8, 1440x900 
0x37CA2318, 38092272203571440, 226708543, 226708552, 9, 1440x900 
0x37CA2318, 38092272204233552, 226708612, 226708619, 7, 1440x900 
0x37CA2318, 38092272204892912, 226708677, 226708685, 8, 1440x900 
0x37CA2318, 38092272205552536, 226708743, 226708751, 8, 1440x900 
0x37CA2318, 38092272206222000, 226708808, 226708816, 8, 1440x900 
0x37CA2318, 38092272206883264, 226708878, 226708886, 8, 1440x900 
0x37CA2318, 38092272207535304, 226708942, 226708950, 8, 1440x900 
0x37CA2318, 38092272208207744, 226709012, 226709020, 8, 1440x900 
0x37CA2318, 38092272208870272, 226709078, 226709086, 8, 1440x900 
0x37CA2318, 38092272209523120, 226709143, 226709151, 8, 1440x900 
0x37CA2318, 38092272210186648, 226709207, 226709214, 7, 1440x900 
0x37CA2318, 38092272210853392, 226709272, 226709280, 8, 1440x900 
0x37CA2318, 38092272211515768, 226709342, 226709350, 8, 1440x900 
0x37CA2318, 38092272212176976, 226709408, 226709416, 8, 1440x900 
0x37CA2318, 38092272212837616, 226709473, 226709481, 8, 1440x900 
0x37CA2318, 38092272213492616, 226709538, 226709546, 8, 1440x900 
0x37CA2318, 38092272214161392, 226709607, 226709615, 8, 1440x900 
0x37CA2318, 38092272214825432, 226709672, 226709679, 7, 1440x900 
0x37CA2318, 38092272215483880, 226709739, 226709747, 8, 1440x900 
0x37CA2318, 38092272216144640, 226709802, 226709809, 7, 1440x900 
0x37CA2318, 38092272216798072, 226709868, 226709876, 8, 1440x900 
0x37CA2318, 38092272217467800, 226709933, 226709942, 9, 1440x900 
0x37CA2318, 38092272218119384, 226710002, 226710010, 8, 1440x900 
0x37CA2318, 38092272218789064, 226710068, 226710075, 7, 1440x900 
0x37CA2318, 38092272219444512, 226710133, 226710141, 8, 1440x900 
0x37CA2318, 38092272220105656, 226710197, 226710206, 9, 1440x900 
0x37CA2318, 38092272220768600, 226710267, 226710275, 8, 1440x900 
0x37CA2318, 38092272221424528, 226710333, 226710341, 8, 1440x900 
0x37CA2318, 38092272222104152, 226710397, 226710406, 9, 1440x900 
0x37CA2318, 38092272222755568, 226710467, 226710475, 8, 1440x900 
0x37CA2318, 38092272223410408, 226710528, 226710536, 8, 1440x900 
0x37CA2318, 38092272224074320, 226710598, 226710606, 8, 1440x900 
0x37CA2318, 38092272224728704, 226710658, 226710666, 8, 1440x900 
0x37CA2318, 38092272225398568, 226710727, 226710735, 8, 1440x900 
0x37CA2318, 38092272226058216, 226710793, 226710800, 7, 1440x900 
0x37CA2318, 38092272226710808, 226710857, 226710864, 7, 1440x900 
0x37CA2318, 38092272227373208, 226710927, 226710935, 8, 1440x900 
0x37CA2318, 38092272228043136, 226710992, 226711000, 8, 1440x900 
0x37CA2318, 38092272228695936, 226711057, 226711065, 8, 1440x900 
0x37CA2318, 38092272229355904, 226711128, 226711136, 8, 1440x900 
0x37CA2318, 38092272230012480, 226711188, 226711196, 8, 1440x900 
0x37CA2318, 38092272230691776, 226711258, 226711266, 8, 1440x900 
0x37CA2318, 38092272231350888, 226711323, 226711332, 9, 1440x900 
0x37CA2318, 38092272232002344, 226711392, 226711400, 8, 1440x900 
0x37CA2318, 38092272232668040, 226711458, 226711466, 8, 1440x900 
0x37CA2318, 38092272233322904, 226711523, 226711531, 8, 1440x900 
0x37CA2318, 38092272233988632, 226711588, 226711596, 8, 1440x900 
0x37CA2318, 38092272234646424, 226711653, 226711661, 8, 1440x900 
0x37CA2318, 38092272235304752, 226711719, 226711727, 8, 1440x900 
0x37CA2318, 38092272235975680, 226711787, 226711795, 8, 1440x900 
0x37CA2318, 38092272236625280, 226711854, 226711862, 8, 1440x900 
0x37CA2318, 38092272237285304, 226711919, 226711927, 8, 1440x900 
0x37CA2318, 38092272237947168, 226711983, 226711991, 8, 1440x900 
0x37CA2318, 38092272238614880, 226712048, 226712055, 7, 1440x900 
0x37CA2318, 38092272239270552, 226712113, 226712122, 9, 1440x900 
0x37CA2318, 38092272239924408, 226712183, 226712190, 7, 1440x900 
0x37CA2318, 38092272240599504, 226712247, 226712255, 8, 1440x900 
0x37CA2318, 38092272241251816, 226712313, 226712321, 8, 1440x900 
0x37CA2318, 38092272241914344, 226712383, 226712391, 8, 1440x900 
0x37CA2318, 38092272242575584, 226712448, 226712456, 8, 1440x900 
0x37CA2318, 38092272243242848, 226712512, 226712520, 8, 1440x900 
0x37CA2318, 38092272243896944, 226712582, 226712590, 8, 1440x900 
0x37CA2318, 38092272244555760, 226712643, 226712651, 8, 1440x900 
0x37CA2318, 38092272245216632, 226712712, 226712720, 8, 1440x900 
0x37CA2318, 38092272245876616, 226712778, 226712786, 8, 1440x900 
0x37CA2318, 38092272246537624, 226712847, 226712855, 8, 1440x900 
0x37CA2318, 38092272247189872, 226712908, 226712916, 8, 1440x900 
0x37CA2318, 38092272247865776, 226712978, 226712986, 8, 1440x900 
0x37CA2318, 38092272248526328, 226713043, 226713051, 8, 1440x900 
0x37CA2318, 38092272249187376, 226713107, 226713115, 8, 1440x900 
0x37CA2318, 38092272249847352, 226713172, 226713181, 9, 1440x900 
0x37CA2318, 38092272250508704, 226713238, 226713246, 8, 1440x900 
0x37CA2318, 38092272251169184, 226713303, 226713312, 9, 1440x900 
0x37CA2318, 38092272251820496, 226713372, 226713380, 8, 1440x900 
0x37CA2318, 38092272252484432, 226713438, 226713447, 9, 1440x900 
0x37CA2318, 38092272253153304, 226713503, 226713512, 9, 1440x900 
0x37CA2318, 38092272253808904, 226713573, 226713580, 7, 1440x900 
0x37CA2318, 38092272254475568, 226713638, 226713646, 8, 1440x900 
0x37CA2318, 38092272255170728, 226713708, 226713717, 9, 1440x900 
0x37CA2318, 38092272256479512, 226713838, 226713846, 8, 1440x900 
0x37CA2318, 38092272257148080, 226713901, 226713909, 8, 1440x900 
0x37CA2318, 38092272257815472, 226713968, 226713975, 7, 1440x900 
0x37CA2318, 38092272258468992, 226714034, 226714042, 8, 1440x900 
0x37CA2318, 38092272259130904, 226714103, 226714111, 8, 1440x900 
0x37CA2318, 38092272259800352, 226714167, 226714175, 8, 1440x900 
0x37CA2318, 38092272260460744, 226714233, 226714241, 8, 1440x900 
0x37CA2318, 38092272261105592, 226714298, 226714306, 8, 1440x900 
0x37CA2318, 38092272261776104, 226714367, 226714374, 7, 1440x900 
0x37CA2318, 38092272262435872, 226714432, 226714440, 8, 1440x900 
0x37CA2318, 38092272263096304, 226714498, 226714506, 8, 1440x900 
0x37CA2318, 38092272263758256, 226714567, 226714575, 8, 1440x900 
0x37CA2318, 38092272264410832, 226714628, 226714636, 8, 1440x900 
0x37CA2318, 38092272265081352, 226714698, 226714706, 8, 1440x900 
0x37CA2318, 38092272265733272, 226714763, 226714771, 8, 1440x900 
0x37CA2318, 38092272266413136, 226714827, 226714835, 8, 1440x900 
0x37CA2318, 38092272267065208, 226714893, 226714900, 7, 1440x900 
0x37CA2318, 38092272267724624, 226714959, 226714966, 7, 1440x900 
0x37CA2318, 38092272268386776, 226715027, 226715035, 8, 1440x900 
0x37CA2318, 38092272269039592, 226715093, 226715101, 8, 1440x900 
0x37CA2318, 38092272269709456, 226715163, 226715171, 8, 1440x900 
0x37CA2318, 38092272270371392, 226715223, 226715230, 7, 1440x900 
0x37CA2318, 38092272271032416, 226715288, 226715296, 8, 1440x900 
0x37CA2318, 38092272271687896, 226715358, 226715365, 7, 1440x900 
0x37CA2318, 38092272272356472, 226715422, 226715429, 7, 1440x900 
0x37CA2318, 38092272273015192, 226715488, 226715495, 7, 1440x900 
0x37CA2318, 38092272273675208, 226715553, 226715561, 8, 1440x900 
0x37CA2318, 38092272274329112, 226715618, 226715626, 8, 1440x900 
0x37CA2318, 38092272274990240, 226715687, 226715695, 8, 1440x900 
0x37CA2318, 38092272275658272, 226715752, 226715760, 8, 1440x900 
0x37CA2318, 38092272276326696, 226715823, 226715831, 8, 1440x900 
0x37CA2318, 38092272276986584, 226715888, 226715896, 8, 1440x900 
0x37CA2318, 38092272277657664, 226715953, 226715961, 8, 1440x900 
0x37CA2318, 38092272278309568, 226716022, 226716030, 8, 1440x900 
0x37CA2318, 38092272278962584, 226716083, 226716091, 8, 1440x900 
0x37CA2318, 38092272279633032, 226716153, 226716161, 8, 1440x900 
0x37CA2318, 38092272280284480, 226716217, 226716224, 7, 1440x900 
0x37CA2318, 38092272280947040, 226716284, 226716292, 8, 1440x900 
0x37CA2318, 38092272281619040, 226716353, 226716361, 8, 1440x900 
0x37CA2318, 38092272282274576, 226716417, 226716425, 8, 1440x900 
0x37CA2318, 38092272282945856, 226716482, 226716490, 8, 1440x900 
0x37CA2318, 38092272283616888, 226716553, 226716561, 8, 1440x900 
0x37CA2318, 38092272284267624, 226716617, 226716625, 8, 1440x900 
0x37CA2318, 38092272284932240, 226716682, 226716690, 8, 1440x900 
0x37CA2318, 38092272285594600, 226716748, 226716756, 8, 1440x900 
0x37CA2318, 38092272286254840, 226716813, 226716821, 8, 1440x900 
0x37CA2318, 38092272286906296, 226716878, 226716886, 8, 1440x900 
0x37CA2318, 38092272287567728, 226716944, 226716952, 8, 1440x900 
0x37CA2318, 38092272288238192, 226717013, 226717021, 8, 1440x900 
0x37CA2318, 38092272288899352, 226717077, 226717085, 8, 1440x900 
0x37CA2318, 38092272289551904, 226717142, 226717151, 9, 1440x900 
0x37CA2318, 38092272290223120, 226717212, 226717220, 8, 1440x900 
0x37CA2318, 38092272290888984, 226717277, 226717285, 8, 1440x900 
0x37CA2318, 38092272291549416, 226717343, 226717351, 8, 1440x900 
0x37CA2318, 38092272292210016, 226717407, 226717415, 8, 1440x900 
0x37CA2318, 38092272292863072, 226717477, 226717485, 8, 1440x900 
0x37CA2318, 38092272293535832, 226717544, 226717552, 8, 1440x900 
0x37CA2318, 38092272294195496, 226717608, 226717616, 8, 1440x900 
0x37CA2318, 38092272294856288, 226717677, 226717685, 8, 1440x900 
0x37CA2318, 38092272295514376, 226717742, 226717750, 8, 1440x900 
0x37CA2318, 38092272296177144, 226717807, 226717815, 8, 1440x900 
0x37CA2318, 38092272296839424, 226717873, 226717881, 8, 1440x900 
0x37CA2318, 38092272297499104, 226717937, 226717945, 8, 1440x900 
0x37CA2318, 38092272298152592, 226718002, 226718009, 7, 1440x900 
0x37CA2318, 38092272298817216, 226718068, 226718077, 9, 1440x900 
0x37CA2318, 38092272299478016, 226718138, 226718146, 8, 1440x900 
0x37CA2318, 38092272300138424, 226718203, 226718211, 8, 1440x900 
0x37CA2318, 38092272300792680, 226718267, 226718275, 8, 1440x900 
0x37CA2318, 38092272301462864, 226718337, 226718345, 8, 1440x900 
0x37CA2318, 38092272302123584, 226718402, 226718410, 8, 1440x900 
0x37CA2318, 38092272302784592, 226718463, 226718470, 7, 1440x900 
0x37CA2318, 38092272303451344, 226718532, 226718539, 7, 1440x900 
0x37CA2318, 38092272304115808, 226718598, 226718605, 7, 1440x900 
0x37CA2318, 38092272304777432, 226718668, 226718676, 8, 1440x900 
0x37CA2318, 38092272305426784, 226718733, 226718741, 8, 1440x900 
0x37CA2318, 38092272306081304, 226718797, 226718805, 8, 1440x900 
0x37CA2318, 38092272306742792, 226718862, 226718871, 9, 1440x900 
0x37CA2318, 38092272307413664, 226718932, 226718940, 8, 1440x900 
0x37CA2318, 38092272308073352, 226718993, 226719001, 8, 1440x900 
0x37CA2318, 38092272308734760, 226719062, 226719071, 9, 1440x900 
0x37CA2318, 38092272309394400, 226719128, 226719136, 8, 1440x900 
0x37CA2318, 38092272310055872, 226719197, 226719205, 8, 1440x900 
0x37CA2318, 38092272310707968, 226719258, 226719266, 8, 1440x900 
0x37CA2318, 38092272311370552, 226719328, 226719336, 8, 1440x900 
0x37CA2318, 38092272312034176, 226719393, 226719402, 9, 1440x900 
0x37CA2318, 38092272312695840, 226719461, 226719468, 7, 1440x900 
0x37CA2318, 38092272313358608, 226719522, 226719529, 7, 1440x900 
0x37CA2318, 38092272314021304, 226719587, 226719595, 8, 1440x900 
0x37CA2318, 38092272314681768, 226719653, 226719661, 8, 1440x900 
0x37CA2318, 38092272315335160, 226719723, 226719731, 8, 1440x900 
0x37CA2318, 38092272316009832, 226719793, 226719801, 8, 1440x900 
0x37CA2318, 38092272316662208, 226719854, 226719862, 8, 1440x900 
0x37CA2318, 38092272317331760, 226719922, 226719930, 8, 1440x900 
0x37CA2318, 38092272317992616, 226719988, 226719996, 8, 1440x900 
0x37CA2318, 38092272318644816, 226720052, 226720060, 8, 1440x900 
0x37CA2318, 38092272319297104, 226720117, 226720125, 8, 1440x900 
0x37CA2318, 38092272319957920, 226720183, 226720193, 10, 1440x900 
0x37CA2318, 38092272320628280, 226720253, 226720261, 8, 1440x900 
0x37CA2318, 38092272321280864, 226720318, 226720326, 8, 1440x900 
0x37CA2318, 38092272321945840, 226720383, 226720391, 8, 1440x900 
0x37CA2318, 38092272322597056, 226720448, 226720456, 8, 1440x900 
0x37CA2318, 38092272323266208, 226720513, 226720522, 9, 1440x900 
0x37CA2318, 38092272323928408, 226720583, 226720591, 8, 1440x900 
0x37CA2318, 38092272324587968, 226720647, 226720654, 7, 1440x900 
0x37CA2318, 38092272325248480, 226720712, 226720719, 7, 1440x900 
0x37CA2318, 38092272325906904, 226720777, 226720785, 8, 1440x900 
0x37CA2318, 38092272326564736, 226720848, 226720857, 9, 1440x900 
0x37CA2318, 38092272327234264, 226720914, 226720922, 8, 1440x900 
0x37CA2318, 38092272327895424, 226720977, 226720986, 9, 1440x900 
0x37CA2318, 38092272328546184, 226721042, 226721051, 9, 1440x900 
0x37CA2318, 38092272329209792, 226721108, 226721117, 9, 1440x900 
0x37CA2318, 38092272329866416, 226721174, 226721182, 8, 1440x900 
0x37CA2318, 38092272330530696, 226721243, 226721251, 8, 1440x900 
0x37CA2318, 38092272331191584, 226721307, 226721315, 8, 1440x900 
0x37CA2318, 38092272331852832, 226721372, 226721380, 8, 1440x900 
0x37CA2318, 38092272332514544, 226721438, 226721448, 10, 1440x900 
0x37CA2318, 38092272333177168, 226721508, 226721516, 8, 1440x900 
0x37CA2318, 38092272333842360, 226721572, 226721580, 8, 1440x900 
0x37CA2318, 38092272334494280, 226721637, 226721645, 8, 1440x900 
0x37CA2318, 38092272335164336, 226721703, 226721711, 8, 1440x900 
0x37CA2318, 38092272335829656, 226721773, 226721781, 8, 1440x900 
0x37CA2318, 38092272336488928, 226721838, 226721846, 8, 1440x900 
0x37CA2318, 38092272337151016, 226721903, 226721911, 8, 1440x900 
0x37CA2318, 38092272338467000, 226722038, 226722047, 9, 1440x900 
0x37CA2318, 38092272339137000, 226722103, 226722110, 7, 1440x900 
0x37CA2318, 38092272339796768, 226722168, 226722176, 8, 1440x900 
0x37CA2318, 38092272340450296, 226722237, 226722245, 8, 1440x900 
0x37CA2318, 38092272341112048, 226722303, 226722311, 8, 1440x900 
0x37CA2318, 38092272341764192, 226722363, 226722372, 9, 1440x900 
0x37CA2318, 38092272342435592, 226722433, 226722441, 8, 1440x900 
0x37CA2318, 38092272343095776, 226722497, 226722505, 8, 1440x900 
0x37CA2318, 38092272343756544, 226722568, 226722576, 8, 1440x900 
0x37CA2318, 38092272344408392, 226722627, 226722636, 9, 1440x900 
0x37CA2318, 38092272345077048, 226722698, 226722705, 7, 1440x900 
0x37CA2318, 38092272345728520, 226722762, 226722770, 8, 1440x900 
0x37CA2318, 38092272346396352, 226722832, 226722840, 8, 1440x900 
0x37CA2318, 38092272347056176, 226722892, 226722899, 7, 1440x900 
0x37CA2318, 38092272347725904, 226722958, 226722966, 8, 1440x900 
0x37CA2318, 38092272348376960, 226723023, 226723031, 8, 1440x900 
0x37CA2318, 38092272349038920, 226723093, 226723101, 8, 1440x900 
0x37CA2318, 38092272349691040, 226723157, 226723165, 8, 1440x900 
0x37CA2318, 38092272350352728, 226723227, 226723235, 8, 1440x900 
0x37CA2318, 38092272351025680, 226723293, 226723301, 8, 1440x900 
0x37CA2318, 38092272351694792, 226723358, 226723366, 8, 1440x900 
0x37CA2318, 38092272352356568, 226723427, 226723435, 8, 1440x900 
0x37CA2318, 38092272353007360, 226723492, 226723500, 8, 1440x900 
0x37CA2318, 38092272353675600, 226723558, 226723566, 8, 1440x900 
0x37CA2318, 38092272354327840, 226723623, 226723631, 8, 1440x900 
0x37CA2318, 38092272354989592, 226723687, 226723695, 8, 1440x900 
0x37CA2318, 38092272355651608, 226723757, 226723765, 8, 1440x900 
0x37CA2318, 38092272356312944, 226723822, 226723830, 8, 1440x900 
0x37CA2318, 38092272356963928, 226723882, 226723891, 9, 1440x900 
0x37CA2318, 38092272357635016, 226723954, 226723962, 8, 1440x900 
0x37CA2318, 38092272358300576, 226724018, 226724026, 8, 1440x900 
0x37CA2318, 38092272358946928, 226724083, 226724091, 8, 1440x900 
0x37CA2318, 38092272359624128, 226724149, 226724157, 8, 1440x900 
0x37CA2318, 38092272360285384, 226724217, 226724225, 8, 1440x900 
0x37CA2318, 38092272360936384, 226724282, 226724290, 8, 1440x900 
0x37CA2318, 38092272361597248, 226724347, 226724356, 9, 1440x900 
0x37CA2318, 38092272362267144, 226724417, 226724425, 8, 1440x900 
0x37CA2318, 38092272362917864, 226724483, 226724491, 8, 1440x900 
0x37CA2318, 38092272363577272, 226724548, 226724556, 8, 1440x900 
0x37CA2318, 38092272364240640, 226724613, 226724621, 8, 1440x900 
0x37CA2318, 38092272364897248, 226724677, 226724685, 8, 1440x900 
0x37CA2318, 38092272365551952, 226724742, 226724750, 8, 1440x900 
0x37CA2318, 38092272366221328, 226724812, 226724820, 8, 1440x900 
0x37CA2318, 38092272366874280, 226724877, 226724885, 8, 1440x900 
0x37CA2318, 38092272367544512, 226724942, 226724950, 8, 1440x900 
0x37CA2318, 38092272368202824, 226725007, 226725015, 8, 1440x900 
0x37CA2318, 38092272368863408, 226725072, 226725080, 8, 1440x900 
0x37CA2318, 38092272369533024, 226725143, 226725151, 8, 1440x900 
0x37CA2318, 38092272370202736, 226725207, 226725215, 8, 1440x900 
0x37CA2318, 38092272370848128, 226725273, 226725281, 8, 1440x900 
0x37CA2318, 38092272371521656, 226725342, 226725349, 7, 1440x900 
0x37CA2318, 38092272372182184, 226725403, 226725410, 7, 1440x900 
0x37CA2318, 38092272372838840, 226725473, 226725481, 8, 1440x900 
0x37CA2318, 38092272373504320, 226725538, 226725546, 8, 1440x900 
0x37CA2318, 38092272374164064, 226725603, 226725612, 9, 1440x900 
0x37CA2318, 38092272374833800, 226725673, 226725681, 8, 1440x900 
0x37CA2318, 38092272375485776, 226725737, 226725745, 8, 1440x900 
0x37CA2318, 38092272376139744, 226725802, 226725810, 8, 1440x900 
0x37CA2318, 38092272376810096, 226725868, 226725876, 8, 1440x900 
0x37CA2318, 38092272377469760, 226725933, 226725942, 9, 1440x900 
0x37CA2318, 38092272378140064, 226726002, 226726010, 8, 1440x900 
0x37CA2318, 38092272378791680, 226726068, 226726076, 8, 1440x900 
0x37CA2318, 38092272379450088, 226726133, 226726140, 7, 1440x900 
0x37CA2318, 38092272380110296, 226726197, 226726205, 8, 1440x900 
0x37CA2318, 38092272380778736, 226726268, 226726276, 8, 1440x900 
0x37CA2318, 38092272381433880, 226726332, 226726340, 8, 1440x900 
0x37CA2318, 38092272382094008, 226726398, 226726406, 8, 1440x900 
0x37CA2318, 38092272382756048, 226726463, 226726471, 8, 1440x900 
0x37CA2318, 38092272383423944, 226726528, 226726537, 9, 1440x900 
0x37CA2318, 38092272384074520, 226726599, 226726607, 8, 1440x900 
0x37CA2318, 38092272384744136, 226726662, 226726671, 9, 1440x900 
0x37CA2318, 38092272385398432, 226726727, 226726735, 8, 1440x900 
0x37CA2318, 38092272386053240, 226726793, 226726801, 8, 1440x900 
0x37CA2318, 38092272386716592, 226726862, 226726870, 8, 1440x900 
0x37CA2318, 38092272387378192, 226726927, 226726935, 8, 1440x900 
0x37CA2318, 38092272388030760, 226726993, 226727001, 8, 1440x900 
0x37CA2318, 38092272388698936, 226727058, 226727066, 8, 1440x900 
0x37CA2318, 38092272389354176, 226727123, 226727131, 8, 1440x900 
0x37CA2318, 38092272390016304, 226727193, 226727201, 8, 1440x900 
0x37CA2318, 38092272390678080, 226727258, 226727266, 8, 1440x900 
0x37CA2318, 38092272391334888, 226727323, 226727331, 8, 1440x900 
0x37CA2318, 38092272392005936, 226727387, 226727396, 9, 1440x900 
0x37CA2318, 38092272392667008, 226727453, 226727462, 9, 1440x900 
0x37CA2318, 38092272393318112, 226727523, 226727531, 8, 1440x900 
0x37CA2318, 38092272393979456, 226727587, 226727595, 8, 1440x900 
0x37CA2318, 38092272394642048, 226727653, 226727661, 8, 1440x900 
0x37CA2318, 38092272395313976, 226727718, 226727726, 8, 1440x900 
0x37CA2318, 38092272395969504, 226727783, 226727792, 9, 1440x900 
0x37CA2318, 38092272396631104, 226727852, 226727860, 8, 1440x900 
0x37CA2318, 38092272397299520, 226727917, 226727925, 8, 1440x900 
0x37CA2318, 38092272397952408, 226727983, 226727991, 8, 1440x900 
0x37CA2318, 38092272398604968, 226728048, 226728056, 8, 1440x900 
0x37CA2318, 38092272399280680, 226728113, 226728121, 8, 1440x900 
0x37CA2318, 38092272399940720, 226728181, 226728188, 7, 1440x900 
0x37CA2318, 38092272400592176, 226728248, 226728256, 8, 1440x900 
0x37CA2318, 38092272401253328, 226728312, 226728320, 8, 1440x900 
0x37CA2318, 38092272401915176, 226728383, 226728390, 7, 1440x900 
0x37CA2318, 38092272402575808, 226728447, 226728455, 8, 1440x900 
0x37CA2318, 38092272403237488, 226728512, 226728520, 8, 1440x900 
0x37CA2318, 38092272403897872, 226728578, 226728586, 8, 1440x900 
0x37CA2318, 38092272404558800, 226728643, 226728652, 9, 1440x900 
0x37CA2318, 38092272405213184, 226728707, 226728716, 9, 1440x900 
0x37CA2318, 38092272405880600, 226728778, 226728786, 8, 1440x900 
0x37CA2318, 38092272406533864, 226728843, 226728852, 9, 1440x900 
0x37CA2318, 38092272407208392, 226728908, 226728917, 9, 1440x900 
0x37CA2318, 38092272407859456, 226728978, 226728986, 8, 1440x900 
0x37CA2318, 38092272408512336, 226729043, 226729051, 8, 1440x900 
0x37CA2318, 38092272409175848, 226729107, 226729115, 8, 1440x900 
0x37CA2318, 38092272409838008, 226729173, 226729182, 9, 1440x900 
0x37CA2318, 38092272410500360, 226729237, 226729245, 8, 1440x900 
0x37CA2318, 38092272411171256, 226729307, 226729315, 8, 1440x900 
0x37CA2318, 38092272411823384, 226729373, 226729381, 8, 1440x900 
0x37CA2318, 38092272413143104, 226729503, 226729512, 9, 1440x900 
0x37CA2318, 38092272413806072, 226729572, 226729580, 8, 1440x900 
0x37CA2318, 38092272414462432, 226729633, 226729642, 9, 1440x900 
0x37CA2318, 38092272415126656, 226729703, 226729711, 8, 1440x900 
0x37CA2318, 38092272415777944, 226729768, 226729776, 8, 1440x900 
0x37CA2318, 38092272416440080, 226729832, 226729840, 8, 1440x900 
0x37CA2318, 38092272417111824, 226729902, 226729910, 8, 1440x900 
0x37CA2318, 38092272417765744, 226729968, 226729976, 8, 1440x900 
0x37CA2318, 38092272418424736, 226730034, 226730042, 8, 1440x900 
0x37CA2318, 38092272419079048, 226730098, 226730105, 7, 1440x900 
0x37CA2318, 38092272419746960, 226730162, 226730170, 8, 1440x900 
0x37CA2318, 38092272420402456, 226730228, 226730236, 8, 1440x900 
0x37CA2318, 38092272421081992, 226730294, 226730303, 9, 1440x900 
0x37CA2318, 38092272421733976, 226730364, 226730371, 7, 1440x900 
0x37CA2318, 38092272422395728, 226730428, 226730436, 8, 1440x900 
0x37CA2318, 38092272423060720, 226730492, 226730501, 9, 1440x900 
0x37CA2318, 38092272423719688, 226730562, 226730570, 8, 1440x900 
0x37CA2318, 38092272424379992, 226730627, 226730635, 8, 1440x900 
0x37CA2318, 38092272425041632, 226730693, 226730701, 8, 1440x900 
0x37CA2318, 38092272425695024, 226730759, 226730767, 8, 1440x900 
0x37CA2318, 38092272426369184, 226730828, 226730836, 8, 1440x900 
0x37CA2318, 38092272427028280, 226730893, 226730901, 8, 1440x900 
0x37CA2318, 38092272427697928, 226730958, 226730966, 8, 1440x900 
0x37CA2318, 38092272428357712, 226731027, 226731035, 8, 1440x900 
0x37CA2318, 38092272429001496, 226731087, 226731095, 8, 1440x900 
0x37CA2318, 38092272429667416, 226731157, 226731165, 8, 1440x900 
0x37CA2318, 38092272430332016, 226731223, 226731231, 8, 1440x900 
0x37CA2318, 38092272430994304, 226731287, 226731295, 8, 1440x900 
0x37CA2318, 38092272431648872, 226731352, 226731360, 8, 1440x900 
0x37CA2318, 38092272432322216, 226731417, 226731425, 8, 1440x900 
0x37CA2318, 38092272432976400, 226731488, 226731496, 8, 1440x900 
0x37CA2318, 38092272433631336, 226731553, 226731561, 8, 1440x900 
0x37CA2318, 38092272434306912, 226731622, 226731630, 8, 1440x900 
0x37CA2318, 38092272434957016, 226731683, 226731691, 8, 1440x900 
0x37CA2318, 38092272435621784, 226731753, 226731761, 8, 1440x900 
0x37CA2318, 38092272436282912, 226731817, 226731825, 8, 1440x900 
0x37CA2318, 38092272436936328, 226731882, 226731890, 8, 1440x900 
0x37CA2318, 38092272437606648, 226731952, 226731960, 8, 1440x900 
0x37CA2318, 38092272438258552, 226732017, 226732025, 8, 1440x900 
0x37CA2318, 38092272438930592, 226732083, 226732091, 8, 1440x900 
0x37CA2318, 38092272439583048, 226732148, 226732156, 8, 1440x900 
0x37CA2318, 38092272440250304, 226732213, 226732221, 8, 1440x900 
0x37CA2318, 38092272440910416, 226732278, 226732285, 7, 1440x900 
0x37CA2318, 38092272441574360, 226732343, 226732350, 7, 1440x900 
0x37CA2318, 38092272442236984, 226732413, 226732421, 8, 1440x900 
0x37CA2318, 38092272442896416, 226732482, 226732490, 8, 1440x900 
0x37CA2318, 38092272443558032, 226732548, 226732556, 8, 1440x900 
0x37CA2318, 38092272444227920, 226732612, 226732620, 8, 1440x900 
0x37CA2318, 38092272444878744, 226732677, 226732685, 8, 1440x900 
0x37CA2318, 38092272445535904, 226732743, 226732750, 7, 1440x900 
0x37CA2318, 38092272446198096, 226732807, 226732815, 8, 1440x900 
0x37CA2318, 38092272446866824, 226732877, 226732885, 8, 1440x900 
0x37CA2318, 38092272447520904, 226732939, 226732947, 8, 1440x900 
0x37CA2318, 38092272448180704, 226733007, 226733015, 8, 1440x900 
0x37CA2318, 38092272448841664, 226733068, 226733077, 9, 1440x900 
0x37CA2318, 38092272449494032, 226733137, 226733145, 8, 1440x900 
0x37CA2318, 38092272450162336, 226733202, 226733210, 8, 1440x900 
0x37CA2318, 38092272450824128, 226733274, 226733282, 8, 1440x900 
0x37CA2318, 38092272451485488, 226733334, 226733342, 8, 1440x900 
0x37CA2318, 38092272452147824, 226733402, 226733410, 8, 1440x900 
0x37CA2318, 38092272452798256, 226733468, 226733476, 8, 1440x900 
0x37CA2318, 38092272453461096, 226733537, 226733545, 8, 1440x900 
0x37CA2318, 38092272454126248, 226733603, 226733611, 8, 1440x900 
0x37CA2318, 38092272454787240, 226733668, 226733676, 8, 1440x900 
0x37CA2318, 38092272455456984, 226733733, 226733742, 9, 1440x900 
0x37CA2318, 38092272456107680, 226733798, 226733807, 9, 1440x900 
0x37CA2318, 38092272456766224, 226733868, 226733876, 8, 1440x900 
0x37CA2318, 38092272457429384, 226733933, 226733941, 8, 1440x900 
0x37CA2318, 38092272458098992, 226733997, 226734006, 9, 1440x900 
0x37CA2318, 38092272458749456, 226734062, 226734070, 8, 1440x900 
0x37CA2318, 38092272459410864, 226734133, 226734141, 8, 1440x900 
0x37CA2318, 38092272460074072, 226734193, 226734202, 9, 1440x900 
0x37CA2318, 38092272460732528, 226734262, 226734270, 8, 1440x900 
0x37CA2318, 38092272461393624, 226734328, 226734336, 8, 1440x900 
0x37CA2318, 38092272462048952, 226734392, 226734401, 9, 1440x900 
0x37CA2318, 38092272462711552, 226734458, 226734466, 8, 1440x900 
0x37CA2318, 38092272463373648, 226734528, 226734536, 8, 1440x900 
0x37CA2318, 38092272464042600, 226734592, 226734599, 7, 1440x900 
0x37CA2318, 38092272464695032, 226734657, 226734664, 7, 1440x900 
0x37CA2318, 38092272465349472, 226734727, 226734734, 7, 1440x900 
0x37CA2318, 38092272466009808, 226734793, 226734801, 8, 1440x900 
0x37CA2318, 38092272466688656, 226734858, 226734866, 8, 1440x900 
0x37CA2318, 38092272467339184, 226734923, 226734931, 8, 1440x900 
0x37CA2318, 38092272468000144, 226734987, 226734995, 8, 1440x900 
0x37CA2318, 38092272468662368, 226735057, 226735066, 9, 1440x900 
0x37CA2318, 38092272469321040, 226735123, 226735131, 8, 1440x900 
0x37CA2318, 38092272469989032, 226735187, 226735195, 8, 1440x900 
0x37CA2318, 38092272470642056, 226735252, 226735260, 8, 1440x900 
0x37CA2318, 38092272471294912, 226735318, 226735327, 9, 1440x900 
0x37CA2318, 38092272471967112, 226735387, 226735395, 8, 1440x900 
0x37CA2318, 38092272472621520, 226735452, 226735460, 8, 1440x900 
0x37CA2318, 38092272473283880, 226735519, 226735526, 7, 1440x900 
0x37CA2318, 38092272473939640, 226735583, 226735592, 9, 1440x900 
0x37CA2318, 38092272474605432, 226735652, 226735660, 8, 1440x900 
0x37CA2318, 38092272475260480, 226735713, 226735721, 8, 1440x900 
0x37CA2318, 38092272475919736, 226735783, 226735791, 8, 1440x900 
0x37CA2318, 38092272476588664, 226735848, 226735856, 8, 1440x900 
0x37CA2318, 38092272477251680, 226735918, 226735926, 8, 1440x900 
0x37CA2318, 38092272477902096, 226735977, 226735985, 8, 1440x900 
0x37CA2318, 38092272478563232, 226736042, 226736051, 9, 1440x900 
0x37CA2318, 38092272479231120, 226736112, 226736120, 8, 1440x900 
0x37CA2318, 38092272479882720, 226736177, 226736185, 8, 1440x900 
0x37CA2318, 38092272480539704, 226736243, 226736251, 8, 1440x900 
0x37CA2318, 38092272481205440, 226736307, 226736316, 9, 1440x900 
0x37CA2318, 38092272481874632, 226736374, 226736383, 9, 1440x900 
0x37CA2318, 38092272482526976, 226736443, 226736451, 8, 1440x900 
0x37CA2318, 38092272483192464, 226736508, 226736516, 8, 1440x900 
0x37CA2318, 38092272483862480, 226736578, 226736586, 8, 1440x900 
0x37CA2318, 38092272484521200, 226736643, 226736651, 8, 1440x900 
0x37CA2318, 38092272485180736, 226736703, 226736711, 8, 1440x900 
0x37CA2318, 38092272485841112, 226736771, 226736778, 7, 1440x900 
0x37CA2318, 38092272486502232, 226736838, 226736847, 9, 1440x900 
0x37CA2318, 38092272487171928, 226736908, 226736916, 8, 1440x900 
0x37CA2318, 38092272487820888, 226736973, 226736981, 8, 1440x900 
0x37CA2318, 38092272488483504, 226737038, 226737046, 8, 1440x900 
0x37CA2318, 38092272489808384, 226737172, 226737180, 8, 1440x900 
0x37CA2318, 38092272490469088, 226737234, 226737242, 8, 1440x900 
0x37CA2318, 38092272491129144, 226737303, 226737311, 8, 1440x900 
0x37CA2318, 38092272491788216, 226737372, 226737379, 7, 1440x900 
0x37CA2318, 38092272492454080, 226737433, 226737442, 9, 1440x900 
0x37CA2318, 38092272493121256, 226737503, 226737511, 8, 1440x900 
0x37CA2318, 38092272493776616, 226737568, 226737576, 8, 1440x900 
0x37CA2318, 38092272494433048, 226737632, 226737640, 8, 1440x900 
0x37CA2318, 38092272495103496, 226737698, 226737706, 8, 1440x900 
0x37CA2318, 38092272495771736, 226737768, 226737776, 8, 1440x900 
0x37CA2318, 38092272496423800, 226737829, 226737837, 8, 1440x900 
0x37CA2318, 38092272497085312, 226737898, 226737906, 8, 1440x900 
0x37CA2318, 38092272497750872, 226737963, 226737971, 8, 1440x900 
0x37CA2318, 38092272498403928, 226738027, 226738036, 9, 1440x900 
0x37CA2318, 38092272499066312, 226738097, 226738105, 8, 1440x900 
0x37CA2318, 38092272499733304, 226738162, 226738170, 8, 1440x900 
0x37CA2318, 38092272500388352, 226738228, 226738236, 8, 1440x900 
0x37CA2318, 38092272501050328, 226738293, 226738301, 8, 1440x900 
0x37CA2318, 38092272501705552, 226738358, 226738367, 9, 1440x900 
0x37CA2318, 38092272502366616, 226738427, 226738435, 8, 1440x900 
0x37CA2318, 38092272503033032, 226738493, 226738501, 8, 1440x900 
0x37CA2318, 38092272503689128, 226738557, 226738565, 8, 1440x900 
0x37CA2318, 38092272504349872, 226738623, 226738631, 8, 1440x900 
0x37CA2318, 38092272505019432, 226738693, 226738701, 8, 1440x900 
0x37CA2318, 38092272505672600, 226738758, 226738766, 8, 1440x900 
0x37CA2318, 38092272506322976, 226738822, 226738830, 8, 1440x900 
0x37CA2318, 38092272507000896, 226738887, 226738894, 7, 1440x900 
0x37CA2318, 38092272507652304, 226738952, 226738959, 7, 1440x900 
0x37CA2318, 38092272508313912, 226739018, 226739025, 7, 1440x900 
0x37CA2318, 38092272508984896, 226739088, 226739096, 8, 1440x900 
0x37CA2318, 38092272509636344, 226739152, 226739160, 8, 1440x900 
0x37CA2318, 38092272510294536, 226739219, 226739227, 8, 1440x900 
0x37CA2318, 38092272510958056, 226739287, 226739295, 8, 1440x900 
0x37CA2318, 38092272511618704, 226739353, 226739361, 8, 1440x900 
0x37CA2318, 38092272512277912, 226739418, 226739427, 9, 1440x900 
0x37CA2318, 38092272512932512, 226739482, 226739490, 8, 1440x900 
0x37CA2318, 38092272513600488, 226739547, 226739555, 8, 1440x900 
0x37CA2318, 38092272514267768, 226739613, 226739622, 9, 1440x900 
0x37CA2318, 38092272514930304, 226739678, 226739686, 8, 1440x900 
0x37CA2318, 38092272515588552, 226739747, 226739755, 8, 1440x900 
0x37CA2318, 38092272516241144, 226739811, 226739819, 8, 1440x900 
0x37CA2318, 38092272516910856, 226739878, 226739885, 7, 1440x900 
0x37CA2318, 38092272517562792, 226739943, 226739950, 7, 1440x900 
0x37CA2318, 38092272518216304, 226740013, 226740021, 8, 1440x900 
0x37CA2318, 38092272518884672, 226740078, 226740086, 8, 1440x900 
0x37CA2318, 38092272519545528, 226740142, 226740150, 8, 1440x900 
0x37CA2318, 38092272520206912, 226740213, 226740221, 8, 1440x900 
0x37CA2318, 38092272520865720, 226740273, 226740281, 8, 1440x900 
0x37CA2318, 38092272521527064, 226740338, 226740345, 7, 1440x900 
0x37CA2318, 38092272522187632, 226740408, 226740415, 7, 1440x900 
0x37CA2318, 38092272522847608, 226740471, 226740479, 8, 1440x900 
0x37CA2318, 38092272523518056, 226740543, 226740551, 8, 1440x900 
0x37CA2318, 38092272524176488, 226740607, 226740615, 8, 1440x900 
0x37CA2318, 38092272524830304, 226740673, 226740681, 8, 1440x900 
0x37CA2318, 38092272525493208, 226740738, 226740747, 9, 1440x900 
0x37CA2318, 38092272526154136, 226740808, 226740815, 7, 1440x900 
0x37CA2318, 38092272526808160, 226740869, 226740877, 8, 1440x900 
0x37CA2318, 38092272527475784, 226740938, 226740946, 8, 1440x900 
0x37CA2318, 38092272528127480, 226741002, 226741009, 7, 1440x900 
0x37CA2318, 38092272528789824, 226741068, 226741076, 8, 1440x900 
0x37CA2318, 38092272529452240, 226741133, 226741141, 8, 1440x900 
0x37CA2318, 38092272530106376, 226741198, 226741206, 8, 1440x900 
0x37CA2318, 38092272530776528, 226741267, 226741275, 8, 1440x900 
0x37CA2318, 38092272531437304, 226741332, 226741340, 8, 1440x900 
0x37CA2318, 38092272532097800, 226741398, 226741407, 9, 1440x900 
0x37CA2318, 38092272532759728, 226741468, 226741476, 8, 1440x900 
0x37CA2318, 38092272533421680, 226741527, 226741535, 8, 1440x900 
0x37CA2318, 38092272534077896, 226741598, 226741606, 8, 1440x900 
0x37CA2318, 38092272534737576, 226741662, 226741670, 8, 1440x900 
0x37CA2318, 38092272535408448, 226741732, 226741740, 8, 1440x900 
0x37CA2318, 38092272536058360, 226741792, 226741799, 7, 1440x900 
0x37CA2318, 38092272536720440, 226741858, 226741865, 7, 1440x900 
0x37CA2318, 38092272537382080, 226741923, 226741931, 8, 1440x900 
0x37CA2318, 38092272538043048, 226741988, 226741997, 9, 1440x900 
0x37CA2318, 38092272538701816, 226742057, 226742064, 7, 1440x900 
0x37CA2318, 38092272539362912, 226742123, 226742130, 7, 1440x900 
0x37CA2318, 38092272540015728, 226742192, 226742200, 8, 1440x900 
0x37CA2318, 38092272540684224, 226742259, 226742267, 8, 1440x900 
0x37CA2318, 38092272541346480, 226742327, 226742334, 7, 1440x900 
0x37CA2318, 38092272542000880, 226742387, 226742396, 9, 1440x900 
0x37CA2318, 38092272542484280, 226742436, 226742444, 8, 1440x900 
0x37CA2318, 38092272543326008, 226742523, 226742531, 8, 1440x900 
0x37CA2318, 38092272543988608, 226742588, 226742596, 8, 1440x900 
0x37CA2318, 38092272544640432, 226742652, 226742660, 8, 1440x900 
0x37CA2318, 38092272545308960, 226742718, 226742725, 7, 1440x900 
0x37CA2318, 38092272545974896, 226742788, 226742796, 8, 1440x900 
0x37CA2318, 38092272546640592, 226742853, 226742860, 7, 1440x900 
0x37CA2318, 38092272547950544, 226742982, 226742989, 7, 1440x900 
0x37CA2318, 38092272548619672, 226743048, 226743055, 7, 1440x900 
0x37CA2318, 38092272549275656, 226743113, 226743121, 8, 1440x900 
0x37CA2318, 38092272549935688, 226743178, 226743186, 8, 1440x900 
0x37CA2318, 38092272550597504, 226743247, 226743254, 7, 1440x900 
0x37CA2318, 38092272551248800, 226743312, 226743320, 8, 1440x900 
0x37CA2318, 38092272551917888, 226743378, 226743385, 7, 1440x900 
0x37CA2318, 38092272552578392, 226743443, 226743451, 8, 1440x900 
0x37CA2318, 38092272553246656, 226743512, 226743519, 7, 1440x900 
0x37CA2318, 38092272553900880, 226743578, 226743586, 8, 1440x900 
0x37CA2318, 38092272554366608, 226743622, 226743630, 8, 1440x900 
0x37CA2318, 38092272555149616, 226743703, 226743710, 7, 1440x900 
0x37CA2318, 38092272555693736, 226743757, 226743764, 7, 1440x900 
0x37CA2318, 38092272556547616, 226743842, 226743849, 7, 1440x900 
0x37CA2318, 38092272557208200, 226743907, 226743915, 8, 1440x900 
0x37CA2318, 38092272557872712, 226743973, 226743982, 9, 1440x900 
0x37CA2318, 38092272558526208, 226744042, 226744050, 8, 1440x900 
0x37CA2318, 38092272559197648, 226744107, 226744116, 9, 1440x900 
0x37CA2318, 38092272559848928, 226744172, 226744180, 8, 1440x900 
0x37CA2318, 38092272560510120, 226744238, 226744247, 9, 1440x900 
0x37CA2318, 38092272561170536, 226744303, 226744310, 7, 1440x900 
0x37CA2318, 38092272561836312, 226744368, 226744376, 8, 1440x900 
0x37CA2318, 38092272562489336, 226744436, 226744444, 8, 1440x900 
0x37CA2318, 38092272563148976, 226744503, 226744510, 7, 1440x900 
0x37CA2318, 38092272563810744, 226744567, 226744574, 7, 1440x900 
0x37CA2318, 38092272564474760, 226744633, 226744641, 8, 1440x900 
0x37CA2318, 38092272565140840, 226744703, 226744711, 8, 1440x900 
0x37CA2318, 38092272565791776, 226744767, 226744775, 8, 1440x900 
0x37CA2318, 38092272566454416, 226744834, 226744841, 7, 1440x900 
0x37CA2318, 38092272567117704, 226744903, 226744911, 8, 1440x900 
0x37CA2318, 38092272567779808, 226744967, 226744975, 8, 1440x900 
0x37CA2318, 38092272568430152, 226745032, 226745040, 8, 1440x900 
0x37CA2318, 38092272569092704, 226745097, 226745105, 8, 1440x900 
0x37CA2318, 38092272569758416, 226745166, 226745175, 9, 1440x900 
0x37CA2318, 38092272570428176, 226745228, 226745236, 8, 1440x900 
0x37CA2318, 38092272571080000, 226745297, 226745304, 7, 1440x900 
0x37CA2318, 38092272571730576, 226745362, 226745370, 8, 1440x900 
0x37CA2318, 38092272572400256, 226745428, 226745436, 8, 1440x900 
0x37CA2318, 38092272573062760, 226745492, 226745501, 9, 1440x900 
0x37CA2318, 38092272573721632, 226745563, 226745571, 8, 1440x900 
0x37CA2318, 38092272574381368, 226745628, 226745636, 8, 1440x900 
0x37CA2318, 38092272575051920, 226745697, 226745705, 8, 1440x900 
0x37CA2318, 38092272575701272, 226745763, 226745771, 8, 1440x900 
0x37CA2318, 38092272576367488, 226745827, 226745835, 8, 1440x900 
0x37CA2318, 38092272577027696, 226745893, 226745901, 8, 1440x900 
0x37CA2318, 38092272577683056, 226745957, 226745965, 8, 1440x900 
0x37CA2318, 38092272578353360, 226746027, 226746035, 8, 1440x900 
0x37CA2318, 38092272579013096, 226746088, 226746096, 8, 1440x900 
0x37CA2318, 38092272579676208, 226746158, 226746166, 8, 1440x900 
0x37CA2318, 38092272580337624, 226746222, 226746230, 8, 1440x900 
0x37CA2318, 38092272581002048, 226746288, 226746296, 8, 1440x900 
0x37CA2318, 38092272581656720, 226746358, 226746366, 8, 1440x900 
0x37CA2318, 38092272582321808, 226746417, 226746425, 8, 1440x900 
0x37CA2318, 38092272582986048, 226746483, 226746491, 8, 1440x900 
0x37CA2318, 38092272583647936, 226746552, 226746561, 9, 1440x900 
0x37CA2318, 38092272584298504, 226746618, 226746626, 8, 1440x900 
0x37CA2318, 38092272584960296, 226746688, 226746696, 8, 1440x900 
0x37CA2318, 38092272585621336, 226746753, 226746761, 8, 1440x900 
0x37CA2318, 38092272586273128, 226746817, 226746825, 8, 1440x900 
0x37CA2318, 38092272586943432, 226746883, 226746891, 8, 1440x900 
0x37CA2318, 38092272587597800, 226746948, 226746956, 8, 1440x900 
0x37CA2318, 38092272588269648, 226747017, 226747025, 8, 1440x900 
0x37CA2318, 38092272588930264, 226747082, 226747090, 8, 1440x900 
0x37CA2318, 38092272589602016, 226747147, 226747156, 9, 1440x900 
0x37CA2318, 38092272590261800, 226747217, 226747225, 8, 1440x900 
0x37CA2318, 38092272590904304, 226747282, 226747290, 8, 1440x900 
0x37CA2318, 38092272591566928, 226747343, 226747352, 9, 1440x900 
0x37CA2318, 38092272592245376, 226747413, 226747421, 8, 1440x900 
0x37CA2318, 38092272592896120, 226747477, 226747485, 8, 1440x900 
0x37CA2318, 38092272593557680, 226747543, 226747551, 8, 1440x900 
0x37CA2318, 38092272594212312, 226747608, 226747616, 8, 1440x900 
0x37CA2318, 38092272594872880, 226747673, 226747682, 9, 1440x900 
0x37CA2318, 38092272595545208, 226747743, 226747750, 7, 1440x900 
0x37CA2318, 38092272596203664, 226747807, 226747815, 8, 1440x900 
0x37CA2318, 38092272596864512, 226747873, 226747882, 9, 1440x900 
0x37CA2318, 38092272597526608, 226747943, 226747951, 8, 1440x900 
0x37CA2318, 38092272598193688, 226748007, 226748015, 8, 1440x900 
0x37CA2318, 38092272598851032, 226748073, 226748081, 8, 1440x900 
0x37CA2318, 38092272599513440, 226748142, 226748150, 8, 1440x900 
0x37CA2318, 38092272600180672, 226748208, 226748235, 27, 1440x900 
0x37CA2318, 38092272600850792, 226748275, 226748285, 10, 1440x900 
0x37CA2318, 38092272601508736, 226748338, 226748344, 6, 1440x900 
0x37CA2318, 38092272602178688, 226748407, 226748414, 7, 1440x900 
0x37CA2318, 38092272602839016, 226748473, 226748480, 7, 1440x900 
0x37CA2318, 38092272603497680, 226748537, 226748544, 7, 1440x900 
0x37CA2318, 38092272604168192, 226748602, 226748609, 7, 1440x900 
0x37CA2318, 38092272604817392, 226748667, 226748674, 7, 1440x900 
0x37CA2318, 38092272605480688, 226748733, 226748742, 9, 1440x900 
0x37CA2318, 38092272606139008, 226748801, 226748808, 7, 1440x900 
0x37CA2318, 38092272606796064, 226748866, 226748873, 7, 1440x900 
0x37CA2318, 38092272607465184, 226748933, 226748940, 7, 1440x900 
0x37CA2318, 38092272608134528, 226748998, 226749005, 7, 1440x900 
0x37CA2318, 38092272608804288, 226749068, 226749075, 7, 1440x900 
0x37CA2318, 38092272609463832, 226749133, 226749140, 7, 1440x900 
0x37CA2318, 38092272610133456, 226749198, 226749206, 8, 1440x900 
0x37CA2318, 38092272610783912, 226749264, 226749271, 7, 1440x900 
0x37CA2318, 38092272611452512, 226749333, 226749341, 8, 1440x900 
0x37CA2318, 38092272612110848, 226749398, 226749406, 8, 1440x900 
0x37CA2318, 38092272612762744, 226749467, 226749475, 8, 1440x900 
0x37CA2318, 38092272613422928, 226749528, 226749536, 8, 1440x900 
0x37CA2318, 38092272614101960, 226749597, 226749605, 8, 1440x900 
0x37CA2318, 38092272614761712, 226749663, 226749669, 6, 1440x900 
0x37CA2318, 38092272615431088, 226749727, 226749735, 8, 1440x900 
0x37CA2318, 38092272616090712, 226749797, 226749804, 7, 1440x900 
0x37CA2318, 38092272616751696, 226749862, 226749869, 7, 1440x900 
0x37CA2318, 38092272617408752, 226749927, 226749934, 7, 1440x900 
0x37CA2318, 38092272618070536, 226749992, 226749999, 7, 1440x900 
0x37CA2318, 38092272618723496, 226750058, 226750065, 7, 1440x900 
0x37CA2318, 38092272619384816, 226750128, 226750136, 8, 1440x900 
0x37CA2318, 38092272620056048, 226750193, 226750202, 9, 1440x900 
0x37CA2318, 38092272620710696, 226750262, 226750270, 8, 1440x900 
0x37CA2318, 38092272621372496, 226750327, 226750335, 8, 1440x900 
0x37CA2318, 38092272622033608, 226750393, 226750401, 8, 1440x900 
0x37CA2318, 38092272622688704, 226750458, 226750466, 8, 1440x900 
0x37CA2318, 38092272623360056, 226750528, 226750536, 8, 1440x900 
0x37CA2318, 38092272624029536, 226750588, 226750595, 7, 1440x900 
0x37CA2318, 38092272624682024, 226750658, 226750666, 8, 1440x900 
0x37CA2318, 38092272625344336, 226750727, 226750735, 8, 1440x900 
0x37CA2318, 38092272626005408, 226750787, 226750795, 8, 1440x900 
0x37CA2318, 38092272626674496, 226750853, 226750861, 8, 1440x900 
0x37CA2318, 38092272627324768, 226750919, 226750927, 8, 1440x900 
0x37CA2318, 38092272627994672, 226750987, 226750994, 7, 1440x900 
0x37CA2318, 38092272628646392, 226751052, 226751059, 7, 1440x900 
0x37CA2318, 38092272629298040, 226751117, 226751124, 7, 1440x900 
0x37CA2318, 38092272629969680, 226751188, 226751196, 8, 1440x900 
0x37CA2318, 38092272630622224, 226751252, 226751260, 8, 1440x900 
0x37CA2318, 38092272631290960, 226751317, 226751325, 8, 1440x900 
0x37CA2318, 38092272632614136, 226751453, 226751461, 8, 1440x900 
0x37CA2318, 38092272633282752, 226751518, 226751526, 8, 1440x900 
0x37CA2318, 38092272633944304, 226751584, 226751591, 7, 1440x900 
0x37CA2318, 38092272634602560, 226751647, 226751655, 8, 1440x900 
0x37CA2318, 38092272635282616, 226751713, 226751720, 7, 1440x900 
0x37CA2318, 38092272635943368, 226751783, 226751791, 8, 1440x900 
0x37CA2318, 38092272636594672, 226751849, 226751857, 8, 1440x900 
0x37CA2318, 38092272637253536, 226751913, 226751920, 7, 1440x900 
0x37CA2318, 38092272637915112, 226751984, 226751992, 8, 1440x900 
0x37CA2318, 38092272638569576, 226752043, 226752052, 9, 1440x900 
0x37CA2318, 38092272639243040, 226752113, 226752121, 8, 1440x900 
0x37CA2318, 38092272639895136, 226752178, 226752186, 8, 1440x900 
0x37CA2318, 38092272640555632, 226752242, 226752251, 9, 1440x900 
0x37CA2318, 38092272641216224, 226752313, 226752321, 8, 1440x900 
0x37CA2318, 38092272641887296, 226752377, 226752385, 8, 1440x900 
0x37CA2318, 38092272642528088, 226752443, 226752451, 8, 1440x900 
0x37CA2318, 38092272643205184, 226752513, 226752521, 8, 1440x900 
0x37CA2318, 38092272643857632, 226752573, 226752582, 9, 1440x900 
0x37CA2318, 38092272644518712, 226752643, 226752651, 8, 1440x900 
0x37CA2318, 38092272645170864, 226752707, 226752715, 8, 1440x900 
0x37CA2318, 38092272645841928, 226752773, 226752781, 8, 1440x900 
0x37CA2318, 38092272646502968, 226752839, 226752847, 8, 1440x900 
0x37CA2318, 38092272647162544, 226752902, 226752910, 8, 1440x900 
0x37CA2318, 38092272647825352, 226752971, 226752979, 8, 1440x900 
0x37CA2318, 38092272648485184, 226753038, 226753046, 8, 1440x900 
0x37CA2318, 38092272649149296, 226753102, 226753111, 9, 1440x900 
0x37CA2318, 38092272649810416, 226753173, 226753181, 8, 1440x900 
0x37CA2318, 38092272650471208, 226753233, 226753242, 9, 1440x900 
0x37CA2318, 38092272651131640, 226753303, 226753311, 8, 1440x900 
0x37CA2318, 38092272651785128, 226753368, 226753375, 7, 1440x900 
0x37CA2318, 38092272652454360, 226753438, 226753446, 8, 1440x900 
0x37CA2318, 38092272653120632, 226753502, 226753510, 8, 1440x900 
0x37CA2318, 38092272653780072, 226753563, 226753570, 7, 1440x900 
0x37CA2318, 38092272654432320, 226753632, 226753640, 8, 1440x900 
0x37CA2318, 38092272655093512, 226753697, 226753704, 7, 1440x900 
0x37CA2318, 38092272655756152, 226753767, 226753775, 8, 1440x900 
0x37CA2318, 38092272656415520, 226753833, 226753841, 8, 1440x900 
0x37CA2318, 38092272657076936, 226753897, 226753905, 8, 1440x900 
0x37CA2318, 38092272657736336, 226753962, 226753970, 8, 1440x900 
0x37CA2318, 38092272658401016, 226754027, 226754035, 8, 1440x900 
0x37CA2318, 38092272659059224, 226754093, 226754101, 8, 1440x900 
0x37CA2318, 38092272659725400, 226754162, 226754170, 8, 1440x900 
0x37CA2318, 38092272660383744, 226754227, 226754235, 8, 1440x900 
0x37CA2318, 38092272661035440, 226754293, 226754301, 8, 1440x900 
0x37CA2318, 38092272661707408, 226754362, 226754370, 8, 1440x900 
0x37CA2318, 38092272662368264, 226754428, 226754436, 8, 1440x900 
0x37CA2318, 38092272663031376, 226754493, 226754501, 8, 1440x900 
0x37CA2318, 38092272663691776, 226754558, 226754566, 8, 1440x900 
0x37CA2318, 38092272664350192, 226754623, 226754631, 8, 1440x900 
0x37CA2318, 38092272665011856, 226754692, 226754700, 8, 1440x900 
0x37CA2318, 38092272665673528, 226754752, 226754761, 9, 1440x900 
0x37CA2318, 38092272666332952, 226754823, 226754831, 8, 1440x900 
0x37CA2318, 38092272666994824, 226754888, 226754895, 7, 1440x900 
0x37CA2318, 38092272667652688, 226754953, 226754961, 8, 1440x900 
0x37CA2318, 38092272668324416, 226755024, 226755032, 8, 1440x900 
0x37CA2318, 38092272668984584, 226755083, 226755091, 8, 1440x900 
0x37CA2318, 38092272669638744, 226755151, 226755159, 8, 1440x900 
0x37CA2318, 38092272670301304, 226755216, 226755223, 7, 1440x900 
0x37CA2318, 38092272670979040, 226755283, 226755292, 9, 1440x900 
0x37CA2318, 38092272671631264, 226755348, 226755355, 7, 1440x900 
0x37CA2318, 38092272672292000, 226755416, 226755423, 7, 1440x900 
0x37CA2318, 38092272672953096, 226755483, 226755491, 8, 1440x900 
0x37CA2318, 38092272673614688, 226755553, 226755561, 8, 1440x900 
0x37CA2318, 38092272674266208, 226755613, 226755622, 9, 1440x900 
0x37CA2318, 38092272674943520, 226755682, 226755690, 8, 1440x900 
0x37CA2318, 38092272675594576, 226755747, 226755755, 8, 1440x900 
0x37CA2318, 38092272676248744, 226755813, 226755821, 8, 1440x900 
0x37CA2318, 38092272676929224, 226755882, 226755890, 8, 1440x900 
0x37CA2318, 38092272677587784, 226755947, 226755955, 8, 1440x900 
0x37CA2318, 38092272678238640, 226756012, 226756020, 8, 1440x900 
0x37CA2318, 38092272678899408, 226756077, 226756085, 8, 1440x900 
0x37CA2318, 38092272679553976, 226756143, 226756151, 8, 1440x900 
0x37CA2318, 38092272680222048, 226756213, 226756221, 8, 1440x900 
0x37CA2318, 38092272680883656, 226756278, 226756286, 8, 1440x900 
0x37CA2318, 38092272681534184, 226756344, 226756352, 8, 1440x900 
0x37CA2318, 38092272682213840, 226756409, 226756417, 8, 1440x900 
0x37CA2318, 38092272682865688, 226756472, 226756479, 7, 1440x900 
0x37CA2318, 38092272683535560, 226756542, 226756551, 9, 1440x900 
0x37CA2318, 38092272684189384, 226756607, 226756615, 8, 1440x900 
0x37CA2318, 38092272684858720, 226756673, 226756682, 9, 1440x900 
0x37CA2318, 38092272685510848, 226756742, 226756750, 8, 1440x900 
0x37CA2318, 38092272686168144, 226756802, 226756810, 8, 1440x900 
0x37CA2318, 38092272686840080, 226756872, 226756881, 9, 1440x900 
0x37CA2318, 38092272687499000, 226756937, 226756945, 8, 1440x900 
0x37CA2318, 38092272688167800, 226757007, 226757015, 8, 1440x900 
0x37CA2318, 38092272688817600, 226757068, 226757075, 7, 1440x900 
0x37CA2318, 38092272689488552, 226757137, 226757145, 8, 1440x900 
0x37CA2318, 38092272690148656, 226757202, 226757209, 7, 1440x900 
0x37CA2318, 38092272690799488, 226757268, 226757276, 8, 1440x900 
0x37CA2318, 38092272691469280, 226757338, 226757346, 8, 1440x900 
0x37CA2318, 38092272692140336, 226757403, 226757411, 8, 1440x900 
0x37CA2318, 38092272692782040, 226757468, 226757476, 8, 1440x900 
0x37CA2318, 38092272693462088, 226757533, 226757542, 9, 1440x900 
0x37CA2318, 38092272694120184, 226757603, 226757611, 8, 1440x900 
0x37CA2318, 38092272694780952, 226757667, 226757675, 8, 1440x900 
0x37CA2318, 38092272695450088, 226757732, 226757740, 8, 1440x900 
0x37CA2318, 38092272696101560, 226757797, 226757805, 8, 1440x900 
0x37CA2318, 38092272696762104, 226757863, 226757870, 7, 1440x900 
0x37CA2318, 38092272697423304, 226757928, 226757936, 8, 1440x900 
0x37CA2318, 38092272698091928, 226757996, 226758004, 8, 1440x900 
0x37CA2318, 38092272698741992, 226758063, 226758071, 8, 1440x900 
0x37CA2318, 38092272699405296, 226758127, 226758135, 8, 1440x900 
0x37CA2318, 38092272700067008, 226758197, 226758205, 8, 1440x900 
0x37CA2318, 38092272700728400, 226758263, 226758271, 8, 1440x900 
0x37CA2318, 38092272701398096, 226758327, 226758335, 8, 1440x900 
0x37CA2318, 38092272702056344, 226758392, 226758400, 8, 1440x900 
0x37CA2318, 38092272702716184, 226758458, 226758465, 7, 1440x900 
0x37CA2318, 38092272703385408, 226758527, 226758535, 8, 1440x900 
0x37CA2318, 38092272704037416, 226758591, 226758599, 8, 1440x900 
0x37CA2318, 38092272704689528, 226758657, 226758665, 8, 1440x900 
0x37CA2318, 38092272705360560, 226758727, 226758735, 8, 1440x900 
0x37CA2318, 38092272706021256, 226758792, 226758800, 8, 1440x900 
0x37CA2318, 38092272706693624, 226758858, 226758868, 10, 1440x900 
0x37CA2318, 38092272707340880, 226758918, 226758926, 8, 1440x900 
0x37CA2318, 38092272708001040, 226758987, 226758995, 8, 1440x900 
0x37CA2318, 38092272708655040, 226759053, 226759060, 7, 1440x900 
0x37CA2318, 38092272709317456, 226759123, 226759131, 8, 1440x900 
0x37CA2318, 38092272709987232, 226759188, 226759196, 8, 1440x900 
0x37CA2318, 38092272710657168, 226759253, 226759261, 8, 1440x900 
0x37CA2318, 38092272711303864, 226759317, 226759326, 9, 1440x900 
0x37CA2318, 38092272711982088, 226759383, 226759391, 8, 1440x900 
0x37CA2318, 38092272712641480, 226759452, 226759459, 7, 1440x900 
0x37CA2318, 38092272713311312, 226759518, 226759525, 7, 1440x900 
0x37CA2318, 38092272713970752, 226759582, 226759589, 7, 1440x900 
0x37CA2318, 38092272714630544, 226759647, 226759654, 7, 1440x900 
0x37CA2318, 38092272715291720, 226759717, 226759725, 8, 1440x900 
0x37CA2318, 38092272716614136, 226759848, 226759856, 8, 1440x900 
0x37CA2318, 38092272717283656, 226759918, 226759926, 8, 1440x900 
0x37CA2318, 38092272717938672, 226759982, 226759990, 8, 1440x900 
0x37CA2318, 38092272718590272, 226760047, 226760055, 8, 1440x900 
0x37CA2318, 38092272719269056, 226760113, 226760122, 9, 1440x900 
0x37CA2318, 38092272719921768, 226760182, 226760190, 8, 1440x900 
0x37CA2318, 38092272720582352, 226760248, 226760256, 8, 1440x900 
0x37CA2318, 38092272721244504, 226760313, 226760321, 8, 1440x900 
0x37CA2318, 38092272721905584, 226760379, 226760387, 8, 1440x900 
0x37CA2318, 38092272722567616, 226760443, 226760451, 8, 1440x900 
0x37CA2318, 38092272723234720, 226760514, 226760521, 7, 1440x900 
0x37CA2318, 38092272723894480, 226760578, 226760586, 8, 1440x900 
0x37CA2318, 38092272724553568, 226760643, 226760651, 8, 1440x900 
0x37CA2318, 38092272725214840, 226760708, 226760717, 9, 1440x900 
0x37CA2318, 38092272725875304, 226760777, 226760785, 8, 1440x900 
0x37CA2318, 38092272726536208, 226760843, 226760852, 9, 1440x900 
0x37CA2318, 38092272727196976, 226760913, 226760921, 8, 1440x900 
0x37CA2318, 38092272727857864, 226760978, 226760986, 8, 1440x900 
0x37CA2318, 38092272728511728, 226761038, 226761046, 8, 1440x900 
0x37CA2318, 38092272729177808, 226761107, 226761115, 8, 1440x900 
0x37CA2318, 38092272729837472, 226761173, 226761181, 8, 1440x900 
0x37CA2318, 38092272730498352, 226761242, 226761250, 8, 1440x900 
0x37CA2318, 38092272731158784, 226761303, 226761311, 8, 1440x900 
0x37CA2318, 38092272731819816, 226761373, 226761381, 8, 1440x900 
0x37CA2318, 38092272732481352, 226761437, 226761445, 8, 1440x900 
0x37CA2318, 38092272733141328, 226761503, 226761511, 8, 1440x900 
0x37CA2318, 38092272733811816, 226761573, 226761581, 8, 1440x900 
0x37CA2318, 38092272734465832, 226761637, 226761645, 8, 1440x900 
0x37CA2318, 38092272735135384, 226761703, 226761711, 8, 1440x900 
0x37CA2318, 38092272735786680, 226761767, 226761775, 8, 1440x900 
0x37CA2318, 38092272736448232, 226761833, 226761842, 9, 1440x900 
0x37CA2318, 38092272737108968, 226761897, 226761904, 7, 1440x900 
0x37CA2318, 38092272737768480, 226761963, 226761970, 7, 1440x900 
0x37CA2318, 38092272738431104, 226762031, 226762039, 8, 1440x900 
0x37CA2318, 38092272739098584, 226762097, 226762104, 7, 1440x900 
0x37CA2318, 38092272739757976, 226762162, 226762169, 7, 1440x900 
0x37CA2318, 38092272740427912, 226762232, 226762239, 7, 1440x900 
0x37CA2318, 38092272741087920, 226762298, 226762306, 8, 1440x900 
0x37CA2318, 38092272741749584, 226762362, 226762370, 8, 1440x900 
0x37CA2318, 38092272742412344, 226762429, 226762437, 8, 1440x900 
0x37CA2318, 38092272743063648, 226762493, 226762502, 9, 1440x900 
0x37CA2318, 38092272743741920, 226762562, 226762570, 8, 1440x900 
0x37CA2318, 38092272744391488, 226762626, 226762634, 8, 1440x900 
0x37CA2318, 38092272745051984, 226762693, 226762701, 8, 1440x900 
0x37CA2318, 38092272745715544, 226762762, 226762770, 8, 1440x900 
0x37CA2318, 38092272746377944, 226762828, 226762836, 8, 1440x900 
0x37CA2318, 38092272747039184, 226762893, 226762901, 8, 1440x900 
0x37CA2318, 38092272747707584, 226762957, 226762966, 9, 1440x900 
0x37CA2318, 38092272748361456, 226763023, 226763031, 8, 1440x900 
0x37CA2318, 38092272749014800, 226763092, 226763100, 8, 1440x900 
0x37CA2318, 38092272749676984, 226763158, 226763166, 8, 1440x900 
0x37CA2318, 38092272750342392, 226763222, 226763230, 8, 1440x900 
0x37CA2318, 38092272751003208, 226763292, 226763300, 8, 1440x900 
0x37CA2318, 38092272751657120, 226763357, 226763365, 8, 1440x900 
0x37CA2318, 38092272752328536, 226763423, 226763431, 8, 1440x900 
0x37CA2318, 38092272752989088, 226763488, 226763496, 8, 1440x900 
0x37CA2318, 38092272753649576, 226763552, 226763561, 9, 1440x900 
0x37CA2318, 38092272754304736, 226763618, 226763626, 8, 1440x900 
0x37CA2318, 38092272754971576, 226763687, 226763695, 8, 1440x900 
0x37CA2318, 38092272755621456, 226763752, 226763760, 8, 1440x900 
0x37CA2318, 38092272756292128, 226763817, 226763825, 8, 1440x900 
0x37CA2318, 38092272756952168, 226763882, 226763891, 9, 1440x900 
0x37CA2318, 38092272757611600, 226763947, 226763956, 9, 1440x900 
0x37CA2318, 38092272758271768, 226764018, 226764026, 8, 1440x900 
0x37CA2318, 38092272758933568, 226764083, 226764091, 8, 1440x900 
0x37CA2318, 38092272759584864, 226764147, 226764155, 8, 1440x900 
0x37CA2318, 38092272760237128, 226764211, 226764219, 8, 1440x900 
0x37CA2318, 38092272760906112, 226764278, 226764285, 7, 1440x900 
0x37CA2318, 38092272761559680, 226764343, 226764350, 7, 1440x900 
0x37CA2318, 38092272762221712, 226764408, 226764417, 9, 1440x900 
0x37CA2318, 38092272762892032, 226764482, 226764490, 8, 1440x900 
0x37CA2318, 38092272763552296, 226764547, 226764555, 8, 1440x900 
0x37CA2318, 38092272764231560, 226764612, 226764620, 8, 1440x900 
0x37CA2318, 38092272764883648, 226764677, 226764686, 9, 1440x900 
0x37CA2318, 38092272765547472, 226764742, 226764750, 8, 1440x900 
0x37CA2318, 38092272766214344, 226764812, 226764820, 8, 1440x900 
0x37CA2318, 38092272766873312, 226764873, 226764882, 9, 1440x900 
0x37CA2318, 38092272767539112, 226764942, 226764950, 8, 1440x900 
0x37CA2318, 38092272768191680, 226765008, 226765016, 8, 1440x900 
0x37CA2318, 38092272768861680, 226765074, 226765082, 8, 1440x900 
0x37CA2318, 38092272769523824, 226765143, 226765150, 7, 1440x900 
0x37CA2318, 38092272770178880, 226765208, 226765216, 8, 1440x900 
0x37CA2318, 38092272770840968, 226765272, 226765280, 8, 1440x900 
0x37CA2318, 38092272771501896, 226765342, 226765350, 8, 1440x900 
0x37CA2318, 38092272772170760, 226765408, 226765416, 8, 1440x900 
0x37CA2318, 38092272772822880, 226765473, 226765481, 8, 1440x900 
0x37CA2318, 38092272773483200, 226765537, 226765545, 8, 1440x900 
0x37CA2318, 38092272774146864, 226765604, 226765612, 8, 1440x900 
0x37CA2318, 38092272774799056, 226765667, 226765675, 8, 1440x900 
0x37CA2318, 38092272775470432, 226765736, 226765744, 8, 1440x900 
0x37CA2318, 38092272776130168, 226765798, 226765806, 8, 1440x900 
0x37CA2318, 38092272776789512, 226765866, 226765874, 8, 1440x900 
0x37CA2318, 38092272777447136, 226765933, 226765940, 7, 1440x900 
0x37CA2318, 38092272778108992, 226765997, 226766005, 8, 1440x900 
0x37CA2318, 38092272778770480, 226766063, 226766072, 9, 1440x900 
0x37CA2318, 38092272779430688, 226766132, 226766140, 8, 1440x900 
0x37CA2318, 38092272780091656, 226766197, 226766205, 8, 1440x900 
0x37CA2318, 38092272780742488, 226766262, 226766270, 8, 1440x900 
0x37CA2318, 38092272781407088, 226766328, 226766336, 8, 1440x900 
0x37CA2318, 38092272782076688, 226766397, 226766405, 8, 1440x900 
0x37CA2318, 38092272782727584, 226766463, 226766471, 8, 1440x900 
0x37CA2318, 38092272783393632, 226766528, 226766536, 8, 1440x900 
0x37CA2318, 38092272784054560, 226766594, 226766602, 8, 1440x900 
0x37CA2318, 38092272784708208, 226766658, 226766666, 8, 1440x900 
0x37CA2318, 38092272785379224, 226766727, 226766735, 8, 1440x900 
0x37CA2318, 38092272786040904, 226766793, 226766801, 8, 1440x900 
0x37CA2318, 38092272786700992, 226766858, 226766866, 8, 1440x900 
0x37CA2318, 38092272787354672, 226766924, 226766932, 8, 1440x900 
0x37CA2318, 38092272788015112, 226766988, 226766996, 8, 1440x900 
0x37CA2318, 38092272788676192, 226767057, 226767065, 8, 1440x900 
0x37CA2318, 38092272789337504, 226767122, 226767130, 8, 1440x900 
0x37CA2318, 38092272789996640, 226767188, 226767196, 8, 1440x900 
0x37CA2318, 38092272790662880, 226767253, 226767261, 8, 1440x900 
0x37CA2318, 38092272791316616, 226767322, 226767330, 8, 1440x900 
0x37CA2318, 38092272791978784, 226767388, 226767396, 8, 1440x900 
0x37CA2318, 38092272792629936, 226767452, 226767460, 8, 1440x900 
0x37CA2318, 38092272793297424, 226767522, 226767530, 8, 1440x900 
0x37CA2318, 38092272793962000, 226767583, 226767592, 9, 1440x900 
0x37CA2318, 38092272795272000, 226767713, 226767734, 21, 1440x900 
0x37CA2318, 38092272795949896, 226767782, 226767789, 7, 1440x900 
0x37CA2318, 38092272796606800, 226767852, 226767860, 8, 1440x900 
0x37CA2318, 38092272797267600, 226767913, 226767922, 9, 1440x900 
0x37CA2318, 38092272797921464, 226767983, 226767991, 8, 1440x900 
0x37CA2318, 38092272798586480, 226768048, 226768056, 8, 1440x900 
0x37CA2318, 38092272799251688, 226768113, 226768121, 8, 1440x900 
0x37CA2318, 38092272799909976, 226768177, 226768184, 7, 1440x900 
0x37CA2318, 38092272800571504, 226768242, 226768250, 8, 1440x900 
0x37CA2318, 38092272801239776, 226768313, 226768321, 8, 1440x900 
0x37CA2318, 38092272802009640, 226768387, 226768395, 8, 1440x900 
0x37CA2318, 38092272802680400, 226768458, 226768466, 8, 1440x900 
0x37CA2318, 38092272803342112, 226768522, 226768530, 8, 1440x900 
0x37CA2318, 38092272804006960, 226768592, 226768600, 8, 1440x900 
0x37CA2318, 38092272804659656, 226768653, 226768661, 8, 1440x900 
0x37CA2318, 38092272805328832, 226768722, 226768730, 8, 1440x900 
0x37CA2318, 38092272805985576, 226768787, 226768795, 8, 1440x900 
0x37CA2318, 38092272806646072, 226768854, 226768862, 8, 1440x900 
0x37CA2318, 38092272807306256, 226768917, 226768926, 9, 1440x900 
0x37CA2318, 38092272807975864, 226768988, 226768996, 8, 1440x900 
0x37CA2318, 38092272808629664, 226769048, 226769056, 8, 1440x900 
0x37CA2318, 38092272809294352, 226769118, 226769125, 7, 1440x900 
0x37CA2318, 38092272809953784, 226769183, 226769190, 7, 1440x900 
0x37CA2318, 38092272810615104, 226769248, 226769255, 7, 1440x900 
0x37CA2318, 38092272811277064, 226769317, 226769325, 8, 1440x900 
0x37CA2318, 38092272811928888, 226769382, 226769390, 8, 1440x900 
0x37CA2318, 38092272812590824, 226769448, 226769456, 8, 1440x900 
0x37CA2318, 38092272813260736, 226769517, 226769525, 8, 1440x900 
0x37CA2318, 38092272813926064, 226769583, 226769591, 8, 1440x900 
0x37CA2318, 38092272814591400, 226769648, 226769656, 8, 1440x900 
0x37CA2318, 38092272815244416, 226769714, 226769722, 8, 1440x900 
0x37CA2318, 38092272815906448, 226769783, 226769791, 8, 1440x900 
0x37CA2318, 38092272816568000, 226769848, 226769856, 8, 1440x900 
0x37CA2318, 38092272817229088, 226769913, 226769921, 8, 1440x900 
0x37CA2318, 38092272817881920, 226769977, 226769985, 8, 1440x900 
0x37CA2318, 38092272818551864, 226770042, 226770050, 8, 1440x900 
0x37CA2318, 38092272819203504, 226770108, 226770116, 8, 1440x900 
0x37CA2318, 38092272819867888, 226770174, 226770182, 8, 1440x900 
0x37CA2318, 38092272820535216, 226770244, 226770252, 8, 1440x900 
0x37CA2318, 38092272821194008, 226770307, 226770314, 7, 1440x900 
0x37CA2318, 38092272821860032, 226770372, 226770379, 7, 1440x900 
0x37CA2318, 38092272822518080, 226770438, 226770445, 7, 1440x900 
0x37CA2318, 38092272823179248, 226770503, 226770511, 8, 1440x900 
0x37CA2318, 38092272823834752, 226770573, 226770580, 7, 1440x900 
0x37CA2318, 38092272824504288, 226770637, 226770644, 7, 1440x900 
0x37CA2318, 38092272825173808, 226770703, 226770710, 7, 1440x900 
0x37CA2318, 38092272825832944, 226770768, 226770776, 8, 1440x900 
0x37CA2318, 38092272826487800, 226770838, 226770845, 7, 1440x900 
0x37CA2318, 38092272827142096, 226770901, 226770909, 8, 1440x900 
0x37CA2318, 38092272827811832, 226770968, 226770975, 7, 1440x900 
0x37CA2318, 38092272828473168, 226771034, 226771042, 8, 1440x900 
0x37CA2318, 38092272829133472, 226771103, 226771112, 9, 1440x900 
0x37CA2318, 38092272829787512, 226771168, 226771176, 8, 1440x900 
0x37CA2318, 38092272830452672, 226771232, 226771240, 8, 1440x900 
0x37CA2318, 38092272831114808, 226771299, 226771306, 7, 1440x900 
0x37CA2318, 38092272831775888, 226771367, 226771374, 7, 1440x900 
0x37CA2318, 38092272832433088, 226771433, 226771441, 8, 1440x900 
0x37CA2318, 38092272833094328, 226771499, 226771507, 8, 1440x900 
0x37CA2318, 38092272833746808, 226771563, 226771571, 8, 1440x900 
0x37CA2318, 38092272834408488, 226771628, 226771636, 8, 1440x900 
0x37CA2318, 38092272835073240, 226771698, 226771706, 8, 1440x900 
0x37CA2318, 38092272835730816, 226771762, 226771770, 8, 1440x900 
0x37CA2318, 38092272836391536, 226771827, 226771835, 8, 1440x900 
0x37CA2318, 38092272837068672, 226771898, 226771906, 8, 1440x900 
0x37CA2318, 38092272837735656, 226771963, 226771971, 8, 1440x900 
0x37CA2318, 38092272838388664, 226772028, 226772036, 8, 1440x900 
0x37CA2318, 38092272839048376, 226772093, 226772101, 8, 1440x900 
0x37CA2318, 38092272839713216, 226772162, 226772170, 8, 1440x900 
0x37CA2318, 38092272840381824, 226772227, 226772235, 8, 1440x900 
0x37CA2318, 38092272841043064, 226772292, 226772300, 8, 1440x900 
0x37CA2318, 38092272841702096, 226772357, 226772366, 9, 1440x900 
0x37CA2318, 38092272842364352, 226772423, 226772432, 9, 1440x900 
0x37CA2318, 38092272843033536, 226772492, 226772500, 8, 1440x900 
0x37CA2318, 38092272843693888, 226772558, 226772566, 8, 1440x900 
0x37CA2318, 38092272844343584, 226772624, 226772632, 8, 1440x900 
0x37CA2318, 38092272845014800, 226772693, 226772701, 8, 1440x900 
0x37CA2318, 38092272845674696, 226772757, 226772765, 8, 1440x900 
0x37CA2318, 38092272846338216, 226772823, 226772831, 8, 1440x900 
0x37CA2318, 38092272847007744, 226772887, 226772896, 9, 1440x900 
0x37CA2318, 38092272847664256, 226772953, 226772962, 9, 1440x900 
0x37CA2318, 38092272848321080, 226773022, 226773030, 8, 1440x900 
0x37CA2318, 38092272848983760, 226773088, 226773096, 8, 1440x900 
0x37CA2318, 38092272849641088, 226773153, 226773161, 8, 1440x900 
0x37CA2318, 38092272850295216, 226773219, 226773227, 8, 1440x900 
0x37CA2318, 38092272850957232, 226773283, 226773291, 8, 1440x900 
0x37CA2318, 38092272851627552, 226773353, 226773361, 8, 1440x900 
0x37CA2318, 38092272852290256, 226773417, 226773425, 8, 1440x900 
0x37CA2318, 38092272852941272, 226773483, 226773491, 8, 1440x900 
0x37CA2318, 38092272853602400, 226773548, 226773556, 8, 1440x900 
0x37CA2318, 38092272854262360, 226773617, 226773625, 8, 1440x900 
0x37CA2318, 38092272854929592, 226773687, 226773701, 14, 1440x900 
0x37CA2318, 38092272855391544, 226773728, 226773735, 7, 1440x900 
0x37CA2318, 38092272856055432, 226773792, 226773799, 7, 1440x900 
0x37CA2318, 38092272856901080, 226773877, 226773884, 7, 1440x900 
0x37CA2318, 38092272857572936, 226773943, 226773951, 8, 1440x900 
0x37CA2318, 38092272858226152, 226774012, 226774020, 8, 1440x900 
0x37CA2318, 38092272858894264, 226774078, 226774087, 9, 1440x900 
0x37CA2318, 38092272859545896, 226774142, 226774149, 7, 1440x900 
0x37CA2318, 38092272860208104, 226774208, 226774216, 8, 1440x900 
0x37CA2318, 38092272860869392, 226774273, 226774282, 9, 1440x900 
0x37CA2318, 38092272861539024, 226774342, 226774350, 8, 1440x900 
0x37CA2318, 38092272862193736, 226774408, 226774416, 8, 1440x900 
0x37CA2318, 38092272862854024, 226774473, 226774481, 8, 1440x900 
0x37CA2318, 38092272863507408, 226774542, 226774550, 8, 1440x900 
0x37CA2318, 38092272864177736, 226774607, 226774614, 7, 1440x900 
0x37CA2318, 38092272864846712, 226774672, 226774679, 7, 1440x900 
0x37CA2318, 38092272865497424, 226774737, 226774744, 7, 1440x900 
0x37CA2318, 38092272866163288, 226774803, 226774810, 7, 1440x900 
0x37CA2318, 38092272866815344, 226774873, 226774880, 7, 1440x900 
0x37CA2318, 38092272867485248, 226774938, 226774945, 7, 1440x900 
0x37CA2318, 38092272868146112, 226775003, 226775010, 7, 1440x900 
0x37CA2318, 38092272868809168, 226775068, 226775076, 8, 1440x900 
0x37CA2318, 38092272869477088, 226775138, 226775147, 9, 1440x900 
0x37CA2318, 38092272870136584, 226775202, 226775210, 8, 1440x900 
0x37CA2318, 38092272870801304, 226775268, 226775276, 8, 1440x900 
0x37CA2318, 38092272871458840, 226775333, 226775342, 9, 1440x900 
0x37CA2318, 38092272872122432, 226775402, 226775410, 8, 1440x900 
0x37CA2318, 38092272872774544, 226775468, 226775476, 8, 1440x900 
0x37CA2318, 38092272873445256, 226775532, 226775540, 8, 1440x900 
0x37CA2318, 38092272874106480, 226775598, 226775606, 8, 1440x900 
0x37CA2318, 38092272874775488, 226775663, 226775670, 7, 1440x900 
0x37CA2318, 38092272875418752, 226775728, 226775736, 8, 1440x900 
0x37CA2318, 38092272876097232, 226775798, 226775806, 8, 1440x900 
0x37CA2318, 38092272876747512, 226775862, 226775871, 9, 1440x900 
0x37CA2318, 38092272877412488, 226775932, 226775940, 8, 1440x900 
0x37CA2318, 38092272878074792, 226775997, 226776005, 8, 1440x900 
0x37CA2318, 38092272878735720, 226776062, 226776070, 8, 1440x900 
0x37CA2318, 38092272879396640, 226776127, 226776136, 9, 1440x900 
0x37CA2318, 38092272880050656, 226776193, 226776201, 8, 1440x900 
0x37CA2318, 38092272880722528, 226776262, 226776270, 8, 1440x900 
0x37CA2318, 38092272881374904, 226776328, 226776336, 8, 1440x900 
0x37CA2318, 38092272882039120, 226776392, 226776400, 8, 1440x900 
0x37CA2318, 38092272882709864, 226776462, 226776470, 8, 1440x900 
0x37CA2318, 38092272883361488, 226776528, 226776536, 8, 1440x900 
0x37CA2318, 38092272884031840, 226776593, 226776601, 8, 1440x900 
0x37CA2318, 38092272884683776, 226776658, 226776666, 8, 1440x900 
0x37CA2318, 38092272886003384, 226776787, 226776795, 8, 1440x900 
0x37CA2318, 38092272886673224, 226776857, 226776865, 8, 1440x900 
0x37CA2318, 38092272887332000, 226776923, 226776931, 8, 1440x900 
0x37CA2318, 38092272887984336, 226776988, 226776996, 8, 1440x900 
0x37CA2318, 38092272888654112, 226777057, 226777065, 8, 1440x900 
0x37CA2318, 38092272889314224, 226777122, 226777130, 8, 1440x900 
0x37CA2318, 38092272889972608, 226777188, 226777196, 8, 1440x900 
0x37CA2318, 38092272890652176, 226777257, 226777265, 8, 1440x900 
0x37CA2318, 38092272891300248, 226777323, 226777331, 8, 1440x900 
0x37CA2318, 38092272891967848, 226777387, 226777395, 8, 1440x900 
0x37CA2318, 38092272892624752, 226777453, 226777461, 8, 1440x900 
0x37CA2318, 38092272893284952, 226777518, 226777526, 8, 1440x900 
0x37CA2318, 38092272893946328, 226777583, 226777591, 8, 1440x900 
0x37CA2318, 38092272894605632, 226777649, 226777658, 9, 1440x900 
0x37CA2318, 38092272895256704, 226777712, 226777719, 7, 1440x900 
0x37CA2318, 38092272895918384, 226777778, 226777785, 7, 1440x900 
0x37CA2318, 38092272896587944, 226777848, 226777856, 8, 1440x900 
0x37CA2318, 38092272897242376, 226777913, 226777921, 8, 1440x900 
0x37CA2318, 38092272897902744, 226777977, 226777984, 7, 1440x900 
0x37CA2318, 38092272898564624, 226778042, 226778052, 10, 1440x900 
0x37CA2318, 38092272899226584, 226778112, 226778120, 8, 1440x900 
0x37CA2318, 38092272899887648, 226778178, 226778186, 8, 1440x900 
0x37CA2318, 38092272900557472, 226778247, 226778255, 8, 1440x900 
0x37CA2318, 38092272901208720, 226778313, 226778321, 8, 1440x900 
0x37CA2318, 38092272901869104, 226778373, 226778382, 9, 1440x900 
0x37CA2318, 38092272902535024, 226778443, 226778451, 8, 1440x900 
0x37CA2318, 38092272903192920, 226778507, 226778515, 8, 1440x900 
0x37CA2318, 38092272903860480, 226778573, 226778582, 9, 1440x900 
0x37CA2318, 38092272904526096, 226778643, 226778651, 8, 1440x900 
0x37CA2318, 38092272905180376, 226778703, 226778711, 8, 1440x900 
0x37CA2318, 38092272905832960, 226778769, 226778776, 7, 1440x900 
0x37CA2318, 38092272906503840, 226778838, 226778847, 9, 1440x900 
0x37CA2318, 38092272907171824, 226778907, 226778915, 8, 1440x900 
0x37CA2318, 38092272907832816, 226778973, 226778981, 8, 1440x900 
0x37CA2318, 38092272908491744, 226779037, 226779045, 8, 1440x900 
0x37CA2318, 38092272909155152, 226779103, 226779111, 8, 1440x900 
0x37CA2318, 38092272909818056, 226779172, 226779180, 8, 1440x900 
0x37CA2318, 38092272910481112, 226779237, 226779245, 8, 1440x900 
0x37CA2318, 38092272911133424, 226779298, 226779306, 8, 1440x900 
0x37CA2318, 38092272911806136, 226779368, 226779375, 7, 1440x900 
0x37CA2318, 38092272912459152, 226779432, 226779439, 7, 1440x900 
0x37CA2318, 38092272913121048, 226779503, 226779511, 8, 1440x900 
0x37CA2318, 38092272913781192, 226779568, 226779576, 8, 1440x900 
0x37CA2318, 38092272914437304, 226779633, 226779641, 8, 1440x900 
0x37CA2318, 38092272915100064, 226779697, 226779705, 8, 1440x900 
0x37CA2318, 38092272915760944, 226779762, 226779771, 9, 1440x900 
0x37CA2318, 38092272916414888, 226779828, 226779835, 7, 1440x900 
0x37CA2318, 38092272917076960, 226779893, 226779901, 8, 1440x900 
0x37CA2318, 38092272917751472, 226779961, 226779968, 7, 1440x900 
0x37CA2318, 38092272918402096, 226780027, 226780034, 7, 1440x900 
0x37CA2318, 38092272919062104, 226780098, 226780106, 8, 1440x900 
0x37CA2318, 38092272919731528, 226780163, 226780172, 9, 1440x900 
0x37CA2318, 38092272920393424, 226780228, 226780236, 8, 1440x900 
0x37CA2318, 38092272921045808, 226780292, 226780300, 8, 1440x900 
0x37CA2318, 38092272921703760, 226780358, 226780366, 8, 1440x900 
0x37CA2318, 38092272922362360, 226780427, 226780435, 8, 1440x900 
0x37CA2318, 38092272923027288, 226780493, 226780501, 8, 1440x900 
0x37CA2318, 38092272923679184, 226780558, 226780566, 8, 1440x900 
0x37CA2318, 38092272924352176, 226780622, 226780630, 8, 1440x900 
0x37CA2318, 38092272925007792, 226780692, 226780700, 8, 1440x900 
0x37CA2318, 38092272925677256, 226780757, 226780765, 8, 1440x900 
0x37CA2318, 38092272926333776, 226780819, 226780826, 7, 1440x900 
0x37CA2318, 38092272927004864, 226780889, 226780896, 7, 1440x900 
0x37CA2318, 38092272927659192, 226780957, 226780965, 8, 1440x900 
0x37CA2318, 38092272928318224, 226781022, 226781030, 8, 1440x900 
0x37CA2318, 38092272928978432, 226781087, 226781095, 8, 1440x900 
0x37CA2318, 38092272929639376, 226781153, 226781161, 8, 1440x900 
0x37CA2318, 38092272930309648, 226781218, 226781227, 9, 1440x900 
0x37CA2318, 38092272930961200, 226781288, 226781295, 7, 1440x900 
0x37CA2318, 38092272931614008, 226781348, 226781355, 7, 1440x900 
0x37CA2318, 38092272932282160, 226781413, 226781421, 8, 1440x900 
0x37CA2318, 38092272932943264, 226781481, 226781489, 8, 1440x900 
0x37CA2318, 38092272933603376, 226781547, 226781555, 8, 1440x900 
0x37CA2318, 38092272934264504, 226781613, 226781620, 7, 1440x900 
0x37CA2318, 38092272934918816, 226781678, 226781685, 7, 1440x900 
0x37CA2318, 38092272935589984, 226781746, 226781754, 8, 1440x900 
0x37CA2318, 38092272936250808, 226781812, 226781820, 8, 1440x900 
0x37CA2318, 38092272936913824, 226781877, 226781884, 7, 1440x900 
0x37CA2318, 38092272937583808, 226781943, 226781951, 8, 1440x900 
0x37CA2318, 38092272938236248, 226782013, 226782021, 8, 1440x900 
0x37CA2318, 38092272938898072, 226782077, 226782085, 8, 1440x900 
0x37CA2318, 38092272939562032, 226782147, 226782155, 8, 1440x900 
0x37CA2318, 38092272940215168, 226782208, 226782217, 9, 1440x900 
0x37CA2318, 38092272940868432, 226782277, 226782285, 8, 1440x900 
0x37CA2318, 38092272941538624, 226782341, 226782348, 7, 1440x900 
0x37CA2318, 38092272942200320, 226782407, 226782415, 8, 1440x900 
0x37CA2318, 38092272942857376, 226782473, 226782481, 8, 1440x900 
0x37CA2318, 38092272943527552, 226782542, 226782550, 8, 1440x900 
0x37CA2318, 38092272944185752, 226782608, 226782616, 8, 1440x900 
0x37CA2318, 38092272944839576, 226782673, 226782681, 8, 1440x900 
0x37CA2318, 38092272945491776, 226782737, 226782745, 8, 1440x900 
0x37CA2318, 38092272946168032, 226782802, 226782809, 7, 1440x900 
0x37CA2318, 38092272946819160, 226782868, 226782875, 7, 1440x900 
0x37CA2318, 38092272947480432, 226782938, 226782946, 8, 1440x900 
0x37CA2318, 38092272948138952, 226783003, 226783011, 8, 1440x900 
0x37CA2318, 38092272948801080, 226783072, 226783080, 8, 1440x900 
0x37CA2318, 38092272949460256, 226783133, 226783142, 9, 1440x900 
0x37CA2318, 38092272950124072, 226783203, 226783212, 9, 1440x900 
0x37CA2318, 38092272950778672, 226783267, 226783275, 8, 1440x900 
0x37CA2318, 38092272951434928, 226783333, 226783341, 8, 1440x900 
0x37CA2318, 38092272952097368, 226783398, 226783411, 13, 1440x900 
0x37CA2318, 38092272952767696, 226783462, 226783470, 8, 1440x900 
0x37CA2318, 38092272953423432, 226783528, 226783535, 7, 1440x900 
0x37CA2318, 38092272954092704, 226783597, 226783605, 8, 1440x900 
0x37CA2318, 38092272954744976, 226783662, 226783670, 8, 1440x900 
0x37CA2318, 38092272955415312, 226783728, 226783734, 6, 1440x900 
0x37CA2318, 38092272956067136, 226783792, 226783800, 8, 1440x900 
0x37CA2318, 38092272956728224, 226783858, 226783866, 8, 1440x900 
0x37CA2318, 38092272957389576, 226783927, 226783935, 8, 1440x900 
0x37CA2318, 38092272958057432, 226783998, 226784006, 8, 1440x900 
0x37CA2318, 38092272958718960, 226784062, 226784070, 8, 1440x900 
0x37CA2318, 38092272959371896, 226784128, 226784136, 8, 1440x900 
0x37CA2318, 38092272960030848, 226784193, 226784201, 8, 1440x900 
0x37CA2318, 38092272960690256, 226784258, 226784266, 8, 1440x900 
0x37CA2318, 38092272961351856, 226784323, 226784331, 8, 1440x900 
0x37CA2318, 38092272962014784, 226784388, 226784397, 9, 1440x900 
0x37CA2318, 38092272963331016, 226784523, 226784531, 8, 1440x900 
0x37CA2318, 38092272964001512, 226784587, 226784595, 8, 1440x900 
0x37CA2318, 38092272964652744, 226784653, 226784661, 8, 1440x900 
0x37CA2318, 38092272965314232, 226784718, 226784726, 8, 1440x900 
0x37CA2318, 38092272965968168, 226784787, 226784795, 8, 1440x900 
0x37CA2318, 38092272966633008, 226784853, 226784861, 8, 1440x900 
0x37CA2318, 38092272967302568, 226784918, 226784926, 8, 1440x900 
0x37CA2318, 38092272967952960, 226784982, 226784990, 8, 1440x900 
0x37CA2318, 38092272968615064, 226785052, 226785060, 8, 1440x900 
0x37CA2318, 38092272969284344, 226785118, 226785126, 8, 1440x900 
0x37CA2318, 38092272969934680, 226785179, 226785186, 7, 1440x900 
0x37CA2318, 38092272970596016, 226785247, 226785254, 7, 1440x900 
0x37CA2318, 38092272971264544, 226785313, 226785320, 7, 1440x900 
0x37CA2318, 38092272971917344, 226785383, 226785391, 8, 1440x900 
0x37CA2318, 38092272972578424, 226785447, 226785454, 7, 1440x900 
0x37CA2318, 38092272973245200, 226785513, 226785521, 8, 1440x900 
0x37CA2318, 38092272973896584, 226785582, 226785590, 8, 1440x900 
0x37CA2318, 38092272974557720, 226785647, 226785655, 8, 1440x900 
0x37CA2318, 38092272975226728, 226785713, 226785721, 8, 1440x900 
0x37CA2318, 38092272975878968, 226785778, 226785786, 8, 1440x900 
0x37CA2318, 38092272976530752, 226785843, 226785851, 8, 1440x900 
0x37CA2318, 38092272977201328, 226785907, 226785916, 9, 1440x900 
0x37CA2318, 38092272977854944, 226785973, 226785981, 8, 1440x900 
0x37CA2318, 38092272978524144, 226786043, 226786051, 8, 1440x900 
0x37CA2318, 38092272979180672, 226786106, 226786115, 9, 1440x900 
0x37CA2318, 38092272979834304, 226786174, 226786182, 8, 1440x900 
0x37CA2318, 38092272980511720, 226786238, 226786246, 8, 1440x900 
0x37CA2318, 38092272981165784, 226786308, 226786316, 8, 1440x900 
0x37CA2318, 38092272981834112, 226786372, 226786380, 8, 1440x900 
0x37CA2318, 38092272982485512, 226786436, 226786443, 7, 1440x900 
0x37CA2318, 38092272983156064, 226786503, 226786511, 8, 1440x900 
0x37CA2318, 38092272983806640, 226786572, 226786580, 8, 1440x900 
0x37CA2318, 38092272984470944, 226786638, 226786646, 8, 1440x900 
0x37CA2318, 38092272985133888, 226786702, 226786711, 9, 1440x900 
0x37CA2318, 38092272985785656, 226786768, 226786775, 7, 1440x900 
0x37CA2318, 38092272986452112, 226786838, 226786846, 8, 1440x900 
0x37CA2318, 38092272987115120, 226786903, 226786911, 8, 1440x900 
0x37CA2318, 38092272987767928, 226786967, 226786975, 8, 1440x900 
0x37CA2318, 38092272988432312, 226787032, 226787040, 8, 1440x900 
0x37CA2318, 38092272989096360, 226787098, 226787108, 10, 1440x900 
0x37CA2318, 38092272989750336, 226787162, 226787171, 9, 1440x900 
0x37CA2318, 38092272990423352, 226787232, 226787240, 8, 1440x900 
0x37CA2318, 38092272991085240, 226787297, 226787305, 8, 1440x900 
0x37CA2318, 38092272991737280, 226787362, 226787369, 7, 1440x900 
0x37CA2318, 38092272992403168, 226787427, 226787435, 8, 1440x900 
0x37CA2318, 38092272993065720, 226787497, 226787505, 8, 1440x900 
0x37CA2318, 38092272993727264, 226787563, 226787571, 8, 1440x900 
0x37CA2318, 38092272994379664, 226787627, 226787635, 8, 1440x900 
0x37CA2318, 38092272995058328, 226787698, 226787706, 8, 1440x900 
0x37CA2318, 38092272995712872, 226787758, 226787767, 9, 1440x900 
0x37CA2318, 38092272996369944, 226787828, 226787836, 8, 1440x900 
0x37CA2318, 38092272997031288, 226787892, 226787900, 8, 1440x900 
0x37CA2318, 38092272997691744, 226787958, 226787966, 8, 1440x900 
0x37CA2318, 38092272998356152, 226788027, 226788035, 8, 1440x900 
0x37CA2318, 38092272999012472, 226788087, 226788096, 9, 1440x900 
0x37CA2318, 38092272999673752, 226788153, 226788162, 9, 1440x900 
0x37CA2318, 38092273000343720, 226788223, 226788231, 8, 1440x900 
0x37CA2318, 38092273000993696, 226788287, 226788295, 8, 1440x900 
0x37CA2318, 38092273001656848, 226788357, 226788365, 8, 1440x900 
0x37CA2318, 38092273002326032, 226788423, 226788431, 8, 1440x900 
0x37CA2318, 38092273002986496, 226788486, 226788494, 8, 1440x900 
0x37CA2318, 38092273003654152, 226788554, 226788561, 7, 1440x900 
0x37CA2318, 38092273004315184, 226788622, 226788630, 8, 1440x900 
0x37CA2318, 38092273004968296, 226788688, 226788696, 8, 1440x900 
0x37CA2318, 38092273005636424, 226788752, 226788760, 8, 1440x900 
0x37CA2318, 38092273006297408, 226788817, 226788825, 8, 1440x900 
0x37CA2318, 38092273006949640, 226788882, 226788890, 8, 1440x900 
0x37CA2318, 38092273007611872, 226788953, 226788961, 8, 1440x900 
0x37CA2318, 38092273008271856, 226789018, 226789026, 8, 1440x900 
0x37CA2318, 38092273008932248, 226789083, 226789091, 8, 1440x900 
0x37CA2318, 38092273009601888, 226789148, 226789156, 8, 1440x900 
0x37CA2318, 38092273010253912, 226789212, 226789220, 8, 1440x900 
0x37CA2318, 38092273010915632, 226789284, 226789292, 8, 1440x900 
0x37CA2318, 38092273011569200, 226789348, 226789356, 8, 1440x900 
0x37CA2318, 38092273012251520, 226789412, 226789420, 8, 1440x900 
0x37CA2318, 38092273012908880, 226789483, 226789491, 8, 1440x900 
0x37CA2318, 38092273013562648, 226789543, 226789552, 9, 1440x900 
0x37CA2318, 38092273014221248, 226789612, 226789620, 8, 1440x900 
0x37CA2318, 38092273014882256, 226789676, 226789684, 8, 1440x900 
0x37CA2318, 38092273015540736, 226789742, 226789750, 8, 1440x900 
0x37CA2318, 38092273016211360, 226789808, 226789815, 7, 1440x900 
0x37CA2318, 38092273016869408, 226789873, 226789880, 7, 1440x900 
0x37CA2318, 38092273017531696, 226789942, 226789950, 8, 1440x900 
0x37CA2318, 38092273018185720, 226790008, 226790016, 8, 1440x900 
0x37CA2318, 38092273018854816, 226790073, 226790081, 8, 1440x900 
0x37CA2318, 38092273019507296, 226790142, 226790150, 8, 1440x900 
0x37CA2318, 38092273020180336, 226790207, 226790215, 8, 1440x900 
0x37CA2318, 38092273020838800, 226790273, 226790281, 8, 1440x900 
0x37CA2318, 38092273021499024, 226790342, 226790350, 8, 1440x900 
0x37CA2318, 38092273022152624, 226790407, 226790415, 8, 1440x900 
0x37CA2318, 38092273022819856, 226790473, 226790481, 8, 1440x900 
0x37CA2318, 38092273023480568, 226790537, 226790545, 8, 1440x900 
0x37CA2318, 38092273024140880, 226790602, 226790610, 8, 1440x900 
0x37CA2318, 38092273024792752, 226790668, 226790676, 8, 1440x900 
0x37CA2318, 38092273025463504, 226790732, 226790741, 9, 1440x900 
0x37CA2318, 38092273026123832, 226790803, 226790811, 8, 1440x900 
0x37CA2318, 38092273026793480, 226790868, 226790876, 8, 1440x900 
0x37CA2318, 38092273027445448, 226790937, 226790945, 8, 1440x900 
0x37CA2318, 38092273028096272, 226790998, 226791006, 8, 1440x900 
0x37CA2318, 38092273028765776, 226791067, 226791075, 8, 1440x900 
0x37CA2318, 38092273029419152, 226791132, 226791140, 8, 1440x900 
0x37CA2318, 38092273030090200, 226791198, 226791206, 8, 1440x900 
0x37CA2318, 38092273030751768, 226791263, 226791271, 8, 1440x900 
0x37CA2318, 38092273031413208, 226791328, 226791336, 8, 1440x900 
0x37CA2318, 38092273032072464, 226791398, 226791406, 8, 1440x900 
0x37CA2318, 38092273032719400, 226791458, 226791467, 9, 1440x900 
0x37CA2318, 38092273033380680, 226791528, 226791536, 8, 1440x900 
0x37CA2318, 38092273034050992, 226791598, 226791606, 8, 1440x900 
0x37CA2318, 38092273034712824, 226791662, 226791670, 8, 1440x900 
0x37CA2318, 38092273035365232, 226791727, 226791735, 8, 1440x900 
0x37CA2318, 38092273036028400, 226791793, 226791801, 8, 1440x900 
0x37CA2318, 38092273036698176, 226791858, 226791867, 9, 1440x900 
0x37CA2318, 38092273037366968, 226791922, 226791929, 7, 1440x900 
0x37CA2318, 38092273038026600, 226791988, 226791995, 7, 1440x900 
0x37CA2318, 38092273038696192, 226792057, 226792064, 7, 1440x900 
0x37CA2318, 38092273039355856, 226792122, 226792128, 6, 1440x900 
0x37CA2318, 38092273040017760, 226792188, 226792197, 9, 1440x900 
0x37CA2318, 38092273041340176, 226792324, 226792332, 8, 1440x900 
0x37CA2318, 38092273041991512, 226792388, 226792397, 9, 1440x900 
0x37CA2318, 38092273042652832, 226792452, 226792460, 8, 1440x900 
0x37CA2318, 38092273043324256, 226792523, 226792532, 9, 1440x900 
0x37CA2318, 38092273043976544, 226792583, 226792591, 8, 1440x900 
0x37CA2318, 38092273044641376, 226792651, 226792658, 7, 1440x900 
0x37CA2318, 38092273045295216, 226792718, 226792726, 8, 1440x900 
0x37CA2318, 38092273045966000, 226792788, 226792796, 8, 1440x900 
0x37CA2318, 38092273046627520, 226792848, 226792856, 8, 1440x900 
0x37CA2318, 38092273047287544, 226792917, 226792924, 7, 1440x900 
0x37CA2318, 38092273047957208, 226792982, 226792990, 8, 1440x900 
0x37CA2318, 38092273048616976, 226793047, 226793055, 8, 1440x900 
0x37CA2318, 38092273049276304, 226793113, 226793121, 8, 1440x900 
0x37CA2318, 38092273049936400, 226793182, 226793188, 6, 1440x900 
0x37CA2318, 38092273050597816, 226793248, 226793255, 7, 1440x900 
0x37CA2318, 38092273051249640, 226793312, 226793319, 7, 1440x900 
0x37CA2318, 38092273051920752, 226793383, 226793391, 8, 1440x900 
0x37CA2318, 38092273052581400, 226793447, 226793455, 8, 1440x900 
0x37CA2318, 38092273053236080, 226793513, 226793521, 8, 1440x900 
0x37CA2318, 38092273053902176, 226793583, 226793591, 8, 1440x900 
0x37CA2318, 38092273054552848, 226793642, 226793650, 8, 1440x900 
0x37CA2318, 38092273055212744, 226793712, 226793720, 8, 1440x900 
0x37CA2318, 38092273055884144, 226793777, 226793785, 8, 1440x900 
0x37CA2318, 38092273056546584, 226793848, 226793856, 8, 1440x900 
0x37CA2318, 38092273057206136, 226793912, 226793920, 8, 1440x900 
0x37CA2318, 38092273057859616, 226793972, 226793980, 8, 1440x900 
0x37CA2318, 38092273058529864, 226794043, 226794051, 8, 1440x900 
0x37CA2318, 38092273059181352, 226794108, 226794115, 7, 1440x900 
0x37CA2318, 38092273059842544, 226794172, 226794180, 8, 1440x900 
0x37CA2318, 38092273060515400, 226794238, 226794246, 8, 1440x900 
0x37CA2318, 38092273061165960, 226794307, 226794315, 8, 1440x900 
0x37CA2318, 38092273061835472, 226794372, 226794380, 8, 1440x900 
0x37CA2318, 38092273062488792, 226794437, 226794445, 8, 1440x900 
0x37CA2318, 38092273063148976, 226794502, 226794510, 8, 1440x900 
0x37CA2318, 38092273063800048, 226794573, 226794581, 8, 1440x900 
0x37CA2318, 38092273064464624, 226794633, 226794643, 10, 1440x900 
0x37CA2318, 38092273065128080, 226794703, 226794711, 8, 1440x900 
0x37CA2318, 38092273065789040, 226794768, 226794776, 8, 1440x900 
0x37CA2318, 38092273066449888, 226794838, 226794846, 8, 1440x900 
0x37CA2318, 38092273067110728, 226794898, 226794907, 9, 1440x900 
0x37CA2318, 38092273067772192, 226794968, 226794976, 8, 1440x900 
0x37CA2318, 38092273068432720, 226795028, 226795036, 8, 1440x900 
0x37CA2318, 38092273069094920, 226795098, 226795106, 8, 1440x900 
0x37CA2318, 38092273069761936, 226795162, 226795169, 7, 1440x900 
0x37CA2318, 38092273070425216, 226795234, 226795242, 8, 1440x900 
0x37CA2318, 38092273071085256, 226795298, 226795306, 8, 1440x900 
0x37CA2318, 38092273071736576, 226795363, 226795371, 8, 1440x900 
0x37CA2318, 38092273072405960, 226795428, 226795436, 8, 1440x900 
0x37CA2318, 38092273073066648, 226795493, 226795502, 9, 1440x900 
0x37CA2318, 38092273073730376, 226795563, 226795571, 8, 1440x900 
0x37CA2318, 38092273074386920, 226795627, 226795636, 9, 1440x900 
0x37CA2318, 38092273075046216, 226795692, 226795700, 8, 1440x900 
0x37CA2318, 38092273075716400, 226795762, 226795770, 8, 1440x900 
0x37CA2318, 38092273076367648, 226795827, 226795835, 8, 1440x900 
0x37CA2318, 38092273077026960, 226795893, 226795901, 8, 1440x900 
0x37CA2318, 38092273077689568, 226795958, 226795966, 8, 1440x900 
0x37CA2318, 38092273078350736, 226796027, 226796035, 8, 1440x900 
0x37CA2318, 38092273079012152, 226796088, 226796096, 8, 1440x900 
0x37CA2318, 38092273079671376, 226796158, 226796166, 8, 1440x900 
0x37CA2318, 38092273080333184, 226796223, 226796231, 8, 1440x900 
0x37CA2318, 38092273080993984, 226796287, 226796295, 8, 1440x900 
0x37CA2318, 38092273081662464, 226796353, 226796361, 8, 1440x900 
0x37CA2318, 38092273082314744, 226796422, 226796431, 9, 1440x900 
0x37CA2318, 38092273082976992, 226796488, 226796496, 8, 1440x900 
0x37CA2318, 38092273083637776, 226796553, 226796561, 8, 1440x900 
0x37CA2318, 38092273084307536, 226796622, 226796630, 8, 1440x900 
0x37CA2318, 38092273084959008, 226796682, 226796691, 9, 1440x900 
0x37CA2318, 38092273085624816, 226796753, 226796761, 8, 1440x900 
0x37CA2318, 38092273086281864, 226796818, 226796826, 8, 1440x900 
0x37CA2318, 38092273086942048, 226796883, 226796891, 8, 1440x900 
0x37CA2318, 38092273087596112, 226796948, 226796956, 8, 1440x900 
0x37CA2318, 38092273088258832, 226797013, 226797021, 8, 1440x900 
0x37CA2318, 38092273088918904, 226797082, 226797090, 8, 1440x900 
0x37CA2318, 38092273089590032, 226797152, 226797159, 7, 1440x900 
0x37CA2318, 38092273090243136, 226797212, 226797220, 8, 1440x900 
0x37CA2318, 38092273090897344, 226797278, 226797286, 8, 1440x900 
0x37CA2318, 38092273091561432, 226797343, 226797351, 8, 1440x900 
0x37CA2318, 38092273092214944, 226797408, 226797418, 10, 1440x900 
0x37CA2318, 38092273092877552, 226797477, 226797485, 8, 1440x900 
0x37CA2318, 38092273093541288, 226797543, 226797550, 7, 1440x900 
0x37CA2318, 38092273094208800, 226797612, 226797620, 8, 1440x900 
0x37CA2318, 38092273094870016, 226797673, 226797680, 7, 1440x900 
0x37CA2318, 38092273095526816, 226797741, 226797749, 8, 1440x900 
0x37CA2318, 38092273096187712, 226797807, 226797814, 7, 1440x900 
0x37CA2318, 38092273096859712, 226797873, 226797882, 9, 1440x900 
0x37CA2318, 38092273097511216, 226797942, 226797950, 8, 1440x900 
0x37CA2318, 38092273098175064, 226798007, 226798015, 8, 1440x900 
0x37CA2318, 38092273098828096, 226798072, 226798079, 7, 1440x900 
0x37CA2318, 38092273099500304, 226798138, 226798146, 8, 1440x900 
0x37CA2318, 38092273100165160, 226798202, 226798212, 10, 1440x900 
0x37CA2318, 38092273100816032, 226798273, 226798281, 8, 1440x900 
0x37CA2318, 38092273101469712, 226798333, 226798342, 9, 1440x900 
0x37CA2318, 38092273102131872, 226798403, 226798411, 8, 1440x900 
0x37CA2318, 38092273102794240, 226798469, 226798477, 8, 1440x900 
0x37CA2318, 38092273103463872, 226798537, 226798545, 8, 1440x900 
0x37CA2318, 38092273104125312, 226798603, 226798611, 8, 1440x900 
0x37CA2318, 38092273104785056, 226798668, 226798676, 8, 1440x900 
0x37CA2318, 38092273105440240, 226798732, 226798740, 8, 1440x900 
0x37CA2318, 38092273106106296, 226798802, 226798810, 8, 1440x900 
0x37CA2318, 38092273106768160, 226798863, 226798872, 9, 1440x900 
0x37CA2318, 38092273107421520, 226798933, 226798941, 8, 1440x900 
0x37CA2318, 38092273108082760, 226798997, 226799004, 7, 1440x900 
0x37CA2318, 38092273108734776, 226799064, 226799072, 8, 1440x900 
0x37CA2318, 38092273109397256, 226799128, 226799136, 8, 1440x900 
0x37CA2318, 38092273110059360, 226799197, 226799205, 8, 1440x900 
0x37CA2318, 38092273110715008, 226799263, 226799271, 8, 1440x900 
0x37CA2318, 38092273111377096, 226799327, 226799335, 8, 1440x900 
0x37CA2318, 38092273112040512, 226799393, 226799401, 8, 1440x900 
0x37CA2318, 38092273112707480, 226799462, 226799470, 8, 1440x900 
0x37CA2318, 38092273113360288, 226799523, 226799531, 8, 1440x900 
0x37CA2318, 38092273114022720, 226799588, 226799597, 9, 1440x900 
0x37CA2318, 38092273114685000, 226799659, 226799667, 8, 1440x900 
0x37CA2318, 38092273115999200, 226799788, 226799796, 8, 1440x900 
0x37CA2318, 38092273116673016, 226799858, 226799866, 8, 1440x900 
0x37CA2318, 38092273117333744, 226799923, 226799931, 8, 1440x900 
0x37CA2318, 38092273118002160, 226799988, 226799996, 8, 1440x900 
0x37CA2318, 38092273118653168, 226800053, 226800061, 8, 1440x900 
0x37CA2318, 38092273119316560, 226800122, 226800130, 8, 1440x900 
0x37CA2318, 38092273119977592, 226800188, 226800196, 8, 1440x900 
0x37CA2318, 38092273120645992, 226800252, 226800260, 8, 1440x900 
0x37CA2318, 38092273121297728, 226800318, 226800326, 8, 1440x900 
0x37CA2318, 38092273121964384, 226800383, 226800391, 8, 1440x900 
0x37CA2318, 38092273122621488, 226800452, 226800460, 8, 1440x900 
0x37CA2318, 38092273123282464, 226800518, 226800526, 8, 1440x900 
0x37CA2318, 38092273123944032, 226800583, 226800591, 8, 1440x900 
0x37CA2318, 38092273124596656, 226800648, 226800655, 7, 1440x900 
0x37CA2318, 38092273125268632, 226800717, 226800725, 8, 1440x900 
0x37CA2318, 38092273125923632, 226800782, 226800790, 8, 1440x900 
0x37CA2318, 38092273126584240, 226800848, 226800856, 8, 1440x900 
0x37CA2318, 38092273127236744, 226800913, 226800921, 8, 1440x900 
0x37CA2318, 38092273127898000, 226800977, 226800985, 8, 1440x900 
0x37CA2318, 38092273128570416, 226801048, 226801056, 8, 1440x900 
0x37CA2318, 38092273129230096, 226801113, 226801121, 8, 1440x900 
0x37CA2318, 38092273129890152, 226801177, 226801185, 8, 1440x900 
0x37CA2318, 38092273130541040, 226801243, 226801251, 8, 1440x900 
0x37CA2318, 38092273131210176, 226801312, 226801320, 8, 1440x900 
0x37CA2318, 38092273131877912, 226801377, 226801385, 8, 1440x900 
0x37CA2318, 38092273132536288, 226801443, 226801451, 8, 1440x900 
0x37CA2318, 38092273133195768, 226801506, 226801514, 8, 1440x900 
0x37CA2318, 38092273133865680, 226801578, 226801586, 8, 1440x900 
0x37CA2318, 38092273134524160, 226801644, 226801652, 8, 1440x900 
0x37CA2318, 38092273135186840, 226801707, 226801715, 8, 1440x900 
0x37CA2318, 38092273135847392, 226801772, 226801779, 7, 1440x900 
0x37CA2318, 38092273136507896, 226801838, 226801845, 7, 1440x900 
0x37CA2318, 38092273137168800, 226801903, 226801912, 9, 1440x900 
0x37CA2318, 38092273137830688, 226801973, 226801981, 8, 1440x900 
0x37CA2318, 38092273138491824, 226802037, 226802045, 8, 1440x900 
0x37CA2318, 38092273139160168, 226802103, 226802111, 8, 1440x900 
0x37CA2318, 38092273139822376, 226802168, 226802177, 9, 1440x900 
0x37CA2318, 38092273140482144, 226802237, 226802245, 8, 1440x900 
0x37CA2318, 38092273141145408, 226802303, 226802311, 8, 1440x900 
0x37CA2318, 38092273141812656, 226802368, 226802376, 8, 1440x900 
0x37CA2318, 38092273142456928, 226802438, 226802446, 8, 1440x900 
0x37CA2318, 38092273142938032, 226802483, 226802491, 8, 1440x900 
0x37CA2318, 38092273143787784, 226802567, 226802575, 8, 1440x900 
0x37CA2318, 38092273144452320, 226802637, 226802645, 8, 1440x900 
0x37CA2318, 38092273145105416, 226802698, 226802705, 7, 1440x900 
0x37CA2318, 38092273145773984, 226802763, 226802771, 8, 1440x900 
0x37CA2318, 38092273146427528, 226802828, 226802836, 8, 1440x900 
0x37CA2318, 38092273147097608, 226802897, 226802905, 8, 1440x900 
0x37CA2318, 38092273147748384, 226802965, 226802974, 9, 1440x900 
0x37CA2318, 38092273148418432, 226803033, 226803041, 8, 1440x900 
0x37CA2318, 38092273149080632, 226803097, 226803105, 8, 1440x900 
0x37CA2318, 38092273149741328, 226803163, 226803172, 9, 1440x900 
0x37CA2318, 38092273150415288, 226803228, 226803236, 8, 1440x900 
0x37CA2318, 38092273150867080, 226803273, 226803279, 6, 1440x900 
0x37CA2318, 38092273151729696, 226803357, 226803365, 8, 1440x900 
0x37CA2318, 38092273152399472, 226803427, 226803434, 7, 1440x900 
0x37CA2318, 38092273153041792, 226803491, 226803498, 7, 1440x900 
0x37CA2318, 38092273153705744, 226803558, 226803564, 6, 1440x900 
0x37CA2318, 38092273154376576, 226803628, 226803636, 8, 1440x900 
0x37CA2318, 38092273155036696, 226803698, 226803706, 8, 1440x900 
0x37CA2318, 38092273155506648, 226803737, 226803744, 7, 1440x900 
0x37CA2318, 38092273156165592, 226803802, 226803810, 8, 1440x900 
0x37CA2318, 38092273156823448, 226803867, 226803875, 8, 1440x900 
0x37CA2318, 38092273157684840, 226803953, 226803960, 7, 1440x900 
0x37CA2318, 38092273158339752, 226804017, 226804025, 8, 1440x900 
0x37CA2318, 38092273159002440, 226804087, 226804095, 8, 1440x900 
0x37CA2318, 38092273159665408, 226804153, 226804160, 7, 1440x900 
0x37CA2318, 38092273160334104, 226804222, 226804229, 7, 1440x900 
0x37CA2318, 38092273160986216, 226804288, 226804296, 8, 1440x900 
0x37CA2318, 38092273161656272, 226804358, 226804366, 8, 1440x900 
0x37CA2318, 38092273162306080, 226804417, 226804425, 8, 1440x900 
0x37CA2318, 38092273162968112, 226804488, 226804496, 8, 1440x900 
0x37CA2318, 38092273163627360, 226804553, 226804561, 8, 1440x900 
0x37CA2318, 38092273164288432, 226804618, 226804626, 8, 1440x900 
0x37CA2318, 38092273164944160, 226804682, 226804689, 7, 1440x900 
0x37CA2318, 38092273165610128, 226804749, 226804757, 8, 1440x900 
0x37CA2318, 38092273166271536, 226804817, 226804825, 8, 1440x900 
0x37CA2318, 38092273166939568, 226804882, 226804890, 8, 1440x900 
0x37CA2318, 38092273167597864, 226804948, 226804956, 8, 1440x900 
0x37CA2318, 38092273168258080, 226805017, 226805025, 8, 1440x900 
0x37CA2318, 38092273168920464, 226805082, 226805090, 8, 1440x900 
0x37CA2318, 38092273169572864, 226805147, 226805155, 8, 1440x900 
0x37CA2318, 38092273170238872, 226805213, 226805221, 8, 1440x900 
0x37CA2318, 38092273170904640, 226805277, 226805287, 10, 1440x900 
0x37CA2318, 38092273171561232, 226805342, 226805351, 9, 1440x900 
0x37CA2318, 38092273172221720, 226805413, 226805421, 8, 1440x900 
0x37CA2318, 38092273172882384, 226805478, 226805486, 8, 1440x900 
0x37CA2318, 38092273173544224, 226805543, 226805551, 8, 1440x900 
0x37CA2318, 38092273174204752, 226805609, 226805617, 8, 1440x900 
0x37CA2318, 38092273174870992, 226805677, 226805685, 8, 1440x900 
0x37CA2318, 38092273175524912, 226805743, 226805750, 7, 1440x900 
0x37CA2318, 38092273176190128, 226805806, 226805813, 7, 1440x900 
0x37CA2318, 38092273176851680, 226805872, 226805879, 7, 1440x900 
0x37CA2318, 38092273177517760, 226805943, 226805951, 8, 1440x900 
0x37CA2318, 38092273178179520, 226806008, 226806016, 8, 1440x900 
0x37CA2318, 38092273178840280, 226806073, 226806081, 8, 1440x900 
0x37CA2318, 38092273179492336, 226806138, 226806146, 8, 1440x900 
0x37CA2318, 38092273180155888, 226806208, 226806216, 8, 1440x900 
0x37CA2318, 38092273180819024, 226806269, 226806277, 8, 1440x900 
0x37CA2318, 38092273181472840, 226806338, 226806346, 8, 1440x900 
0x37CA2318, 38092273182144200, 226806403, 226806411, 8, 1440x900 
0x37CA2318, 38092273182796336, 226806467, 226806475, 8, 1440x900 
0x37CA2318, 38092273183458160, 226806537, 226806545, 8, 1440x900 
0x37CA2318, 38092273184128840, 226806602, 226806609, 7, 1440x900 
0x37CA2318, 38092273184794120, 226806667, 226806675, 8, 1440x900 
0x37CA2318, 38092273185445536, 226806733, 226806742, 9, 1440x900 
0x37CA2318, 38092273186117520, 226806802, 226806810, 8, 1440x900 
0x37CA2318, 38092273186777360, 226806863, 226806871, 8, 1440x900 
0x37CA2318, 38092273187436832, 226806931, 226806938, 7, 1440x900 
0x37CA2318, 38092273188099208, 226807003, 226807011, 8, 1440x900 
0x37CA2318, 38092273188760624, 226807063, 226807071, 8, 1440x900 
0x37CA2318, 38092273189419848, 226807133, 226807141, 8, 1440x900 
0x37CA2318, 38092273190080656, 226807197, 226807205, 8, 1440x900 
0x37CA2318, 38092273190749792, 226807263, 226807271, 8, 1440x900 
0x37CA2318, 38092273191397112, 226807328, 226807336, 8, 1440x900 
0x37CA2318, 38092273192074992, 226807398, 226807406, 8, 1440x900 
0x37CA2318, 38092273192726400, 226807463, 226807471, 8, 1440x900 
0x37CA2318, 38092273193386248, 226807527, 226807535, 8, 1440x900 
0x37CA2318, 38092273194056560, 226807594, 226807602, 8, 1440x900 
0x37CA2318, 38092273194707432, 226807658, 226807666, 8, 1440x900 
0x37CA2318, 38092273195365360, 226807728, 226807736, 8, 1440x900 
0x37CA2318, 38092273196036984, 226807793, 226807801, 8, 1440x900 
0x37CA2318, 38092273196705600, 226807857, 226807864, 7, 1440x900 
0x37CA2318, 38092273197357520, 226807927, 226807934, 7, 1440x900 
0x37CA2318, 38092273198689904, 226808057, 226808065, 8, 1440x900 
0x37CA2318, 38092273199343304, 226808122, 226808131, 9, 1440x900 
0x37CA2318, 38092273200003232, 226808187, 226808195, 8, 1440x900 
0x37CA2318, 38092273200665240, 226808258, 226808267, 9, 1440x900 
0x37CA2318, 38092273201332208, 226808323, 226808331, 8, 1440x900 
0x37CA2318, 38092273201985048, 226808389, 226808397, 8, 1440x900 
0x37CA2318, 38092273202636848, 226808452, 226808460, 8, 1440x900 
0x37CA2318, 38092273203298848, 226808517, 226808525, 8, 1440x900 
0x37CA2318, 38092273203969936, 226808588, 226808596, 8, 1440x900 
0x37CA2318, 38092273204622904, 226808652, 226808660, 8, 1440x900 
0x37CA2318, 38092273205276520, 226808718, 226808726, 8, 1440x900 
0x37CA2318, 38092273205939928, 226808783, 226808791, 8, 1440x900 
0x37CA2318, 38092273206612344, 226808853, 226808861, 8, 1440x900 
0x37CA2318, 38092273207281312, 226808913, 226808921, 8, 1440x900 
0x37CA2318, 38092273207940576, 226808981, 226808988, 7, 1440x900 
0x37CA2318, 38092273208610328, 226809048, 226809055, 7, 1440x900 
0x37CA2318, 38092273209269808, 226809112, 226809119, 7, 1440x900 
0x37CA2318, 38092273209939448, 226809177, 226809184, 7, 1440x900 
0x37CA2318, 38092273210599064, 226809247, 226809254, 7, 1440x900 
0x37CA2318, 38092273211268688, 226809312, 226809319, 7, 1440x900 
0x37CA2318, 38092273211918400, 226809378, 226809385, 7, 1440x900 
0x37CA2318, 38092273212589712, 226809447, 226809455, 8, 1440x900 
0x37CA2318, 38092273213249608, 226809512, 226809520, 8, 1440x900 
0x37CA2318, 38092273213919240, 226809578, 226809586, 8, 1440x900 
0x37CA2318, 38092273214576440, 226809643, 226809650, 7, 1440x900 
0x37CA2318, 38092273215237504, 226809712, 226809720, 8, 1440x900 
0x37CA2318, 38092273215899952, 226809779, 226809787, 8, 1440x900 
0x37CA2318, 38092273216570392, 226809848, 226809856, 8, 1440x900 
0x37CA2318, 38092273217210248, 226809907, 226809914, 7, 1440x900 
0x37CA2318, 38092273217882224, 226809977, 226809985, 8, 1440x900 
0x37CA2318, 38092273218534032, 226810042, 226810051, 9, 1440x900 
0x37CA2318, 38092273219207040, 226810107, 226810116, 9, 1440x900 
0x37CA2318, 38092273219857464, 226810177, 226810185, 8, 1440x900 
0x37CA2318, 38092273220518048, 226810242, 226810250, 8, 1440x900 
0x37CA2318, 38092273221186064, 226810307, 226810315, 8, 1440x900 
0x37CA2318, 38092273221839816, 226810373, 226810381, 8, 1440x900 
0x37CA2318, 38092273222500864, 226810437, 226810446, 9, 1440x900 
0x37CA2318, 38092273223163280, 226810503, 226810512, 9, 1440x900 
0x37CA2318, 38092273223822288, 226810573, 226810581, 8, 1440x900 
0x37CA2318, 38092273224482784, 226810638, 226810646, 8, 1440x900 
0x37CA2318, 38092273225143264, 226810703, 226810712, 9, 1440x900 
0x37CA2318, 38092273225808152, 226810769, 226810777, 8, 1440x900 
0x37CA2318, 38092273226467520, 226810837, 226810846, 9, 1440x900 
0x37CA2318, 38092273227127592, 226810903, 226810911, 8, 1440x900 
0x37CA2318, 38092273227789816, 226810968, 226810976, 8, 1440x900 
0x37CA2318, 38092273228448712, 226811032, 226811039, 7, 1440x900 
0x37CA2318, 38092273229105320, 226811102, 226811110, 8, 1440x900 
0x37CA2318, 38092273229770776, 226811163, 226811172, 9, 1440x900 
0x37CA2318, 38092273230431160, 226811232, 226811240, 8, 1440x900 
0x37CA2318, 38092273231083408, 226811298, 226811306, 8, 1440x900 
0x37CA2318, 38092273231745376, 226811363, 226811371, 8, 1440x900 
0x37CA2318, 38092273232408424, 226811432, 226811440, 8, 1440x900 
0x37CA2318, 38092273233070440, 226811493, 226811502, 9, 1440x900 
0x37CA2318, 38092273233733400, 226811563, 226811571, 8, 1440x900 
0x37CA2318, 38092273234389320, 226811628, 226811636, 8, 1440x900 
0x37CA2318, 38092273235050632, 226811697, 226811705, 8, 1440x900 
0x37CA2318, 38092273235712256, 226811762, 226811770, 8, 1440x900 
0x37CA2318, 38092273236374560, 226811828, 226811835, 7, 1440x900 
0x37CA2318, 38092273237035456, 226811893, 226811901, 8, 1440x900 
0x37CA2318, 38092273237695312, 226811958, 226811966, 8, 1440x900 
0x37CA2318, 38092273238366968, 226812028, 226812036, 8, 1440x900 
0x37CA2318, 38092273239024712, 226812093, 226812102, 9, 1440x900 
0x37CA2318, 38092273239689472, 226812157, 226812165, 8, 1440x900 
0x37CA2318, 38092273240340080, 226812222, 226812230, 8, 1440x900 
0x37CA2318, 38092273241004424, 226812288, 226812296, 8, 1440x900 
0x37CA2318, 38092273241659544, 226812353, 226812361, 8, 1440x900 
0x37CA2318, 38092273242320424, 226812418, 226812427, 9, 1440x900 
0x37CA2318, 38092273242980424, 226812487, 226812495, 8, 1440x900 
0x37CA2318, 38092273243640928, 226812552, 226812560, 8, 1440x900 
0x37CA2318, 38092273244302456, 226812617, 226812625, 8, 1440x900 
0x37CA2318, 38092273244958800, 226812688, 226812696, 8, 1440x900 
0x37CA2318, 38092273245636936, 226812752, 226812760, 8, 1440x900 
0x37CA2318, 38092273246289336, 226812817, 226812825, 8, 1440x900 
0x37CA2318, 38092273246951008, 226812888, 226812896, 8, 1440x900 
0x37CA2318, 38092273247611768, 226812952, 226812960, 8, 1440x900 
0x37CA2318, 38092273248280056, 226813017, 226813024, 7, 1440x900 
0x37CA2318, 38092273248931200, 226813083, 226813091, 8, 1440x900 
0x37CA2318, 38092273249592432, 226813148, 226813156, 8, 1440x900 
0x37CA2318, 38092273250253952, 226813217, 226813225, 8, 1440x900 
0x37CA2318, 38092273250915240, 226813283, 226813291, 8, 1440x900 
0x37CA2318, 38092273251569872, 226813343, 226813352, 9, 1440x900 
0x37CA2318, 38092273252240744, 226813413, 226813421, 8, 1440x900 
0x37CA2318, 38092273252900568, 226813477, 226813485, 8, 1440x900 
0x37CA2318, 38092273253560760, 226813543, 226813551, 8, 1440x900 
0x37CA2318, 38092273254230472, 226813612, 226813620, 8, 1440x900 
0x37CA2318, 38092273254881888, 226813678, 226813686, 8, 1440x900 
0x37CA2318, 38092273255550608, 226813742, 226813751, 9, 1440x900 
0x37CA2318, 38092273256211296, 226813812, 226813820, 8, 1440x900 
0x37CA2318, 38092273256874264, 226813878, 226813889, 11, 1440x900 
0x37CA2318, 38092273257535048, 226813942, 226813950, 8, 1440x900 
0x37CA2318, 38092273258196840, 226814007, 226814015, 8, 1440x900 
0x37CA2318, 38092273258848912, 226814073, 226814081, 8, 1440x900 
0x37CA2318, 38092273259520136, 226814143, 226814151, 8, 1440x900 
0x37CA2318, 38092273260180992, 226814208, 226814216, 8, 1440x900 
0x37CA2318, 38092273260842472, 226814273, 226814281, 8, 1440x900 
0x37CA2318, 38092273261512640, 226814342, 226814350, 8, 1440x900 
0x37CA2318, 38092273262163440, 226814407, 226814415, 8, 1440x900 
0x37CA2318, 38092273262824808, 226814468, 226814477, 9, 1440x900 
0x37CA2318, 38092273263486000, 226814537, 226814545, 8, 1440x900 
0x37CA2318, 38092273264148000, 226814607, 226814615, 8, 1440x900 
0x37CA2318, 38092273264808584, 226814667, 226814676, 9, 1440x900 
0x37CA2318, 38092273265471768, 226814734, 226814742, 8, 1440x900 
0x37CA2318, 38092273266132608, 226814803, 226814811, 8, 1440x900 
0x37CA2318, 38092273266791632, 226814867, 226814875, 8, 1440x900 
0x37CA2318, 38092273267452472, 226814932, 226814940, 8, 1440x900 
0x37CA2318, 38092273268115368, 226815003, 226815011, 8, 1440x900 
0x37CA2318, 38092273268784616, 226815068, 226815077, 9, 1440x900 
0x37CA2318, 38092273269437784, 226815132, 226815140, 8, 1440x900 
0x37CA2318, 38092273270104160, 226815202, 226815210, 8, 1440x900 
0x37CA2318, 38092273270770880, 226815263, 226815270, 7, 1440x900 
0x37CA2318, 38092273271421272, 226815333, 226815341, 8, 1440x900 
0x37CA2318, 38092273272092384, 226815398, 226815406, 8, 1440x900 
0x37CA2318, 38092273272754608, 226815463, 226815471, 8, 1440x900 
0x37CA2318, 38092273273408768, 226815532, 226815540, 8, 1440x900 
0x37CA2318, 38092273274074200, 226815598, 226815606, 8, 1440x900 
0x37CA2318, 38092273274743792, 226815662, 226815670, 8, 1440x900 
0x37CA2318, 38092273275395528, 226815728, 226815736, 8, 1440x900 
0x37CA2318, 38092273276054688, 226815793, 226815801, 8, 1440x900 
0x37CA2318, 38092273276708416, 226815858, 226815866, 8, 1440x900 
0x37CA2318, 38092273277378800, 226815927, 226815935, 8, 1440x900 
0x37CA2318, 38092273278032784, 226815993, 226816001, 8, 1440x900 
0x37CA2318, 38092273278713952, 226816058, 226816066, 8, 1440x900 
0x37CA2318, 38092273279366592, 226816127, 226816135, 8, 1440x900 
0x37CA2318, 38092273280029152, 226816193, 226816201, 8, 1440x900 
0x37CA2318, 38092273281337280, 226816322, 226816329, 7, 1440x900 
0x37CA2318, 38092273282008288, 226816393, 226816401, 8, 1440x900 
0x37CA2318, 38092273282671048, 226816457, 226816465, 8, 1440x900 
0x37CA2318, 38092273283325280, 226816523, 226816531, 8, 1440x900 
0x37CA2318, 38092273283995432, 226816592, 226816600, 8, 1440x900 
0x37CA2318, 38092273284649864, 226816657, 226816665, 8, 1440x900 
0x37CA2318, 38092273285323096, 226816722, 226816731, 9, 1440x900 
0x37CA2318, 38092273285981344, 226816787, 226816795, 8, 1440x900 
0x37CA2318, 38092273286634480, 226816854, 226816862, 8, 1440x900 
0x37CA2318, 38092273287303968, 226816918, 226816926, 8, 1440x900 
0x37CA2318, 38092273287965032, 226816984, 226816992, 8, 1440x900 
0x37CA2318, 38092273288616200, 226817051, 226817059, 8, 1440x900 
0x37CA2318, 38092273289293840, 226817117, 226817125, 8, 1440x900 
0x37CA2318, 38092273289945656, 226817183, 226817191, 8, 1440x900 
0x37CA2318, 38092273290609680, 226817249, 226817257, 8, 1440x900 
0x37CA2318, 38092273291277336, 226817318, 226817326, 8, 1440x900 
0x37CA2318, 38092273291922256, 226817383, 226817391, 8, 1440x900 
0x37CA2318, 38092273292585696, 226817447, 226817455, 8, 1440x900 
0x37CA2318, 38092273293246952, 226817513, 226817521, 8, 1440x900 
0x37CA2318, 38092273293908328, 226817578, 226817585, 7, 1440x900 
0x37CA2318, 38092273294565304, 226817642, 226817649, 7, 1440x900 
0x37CA2318, 38092273295236608, 226817708, 226817717, 9, 1440x900 
0x37CA2318, 38092273295898664, 226817778, 226817787, 9, 1440x900 
0x37CA2318, 38092273296559656, 226817848, 226817856, 8, 1440x900 
0x37CA2318, 38092273297223848, 226817913, 226817921, 8, 1440x900 
0x37CA2318, 38092273297884032, 226817978, 226817986, 8, 1440x900 
0x37CA2318, 38092273298536584, 226818042, 226818050, 8, 1440x900 
0x37CA2318, 38092273299200008, 226818108, 226818116, 8, 1440x900 
0x37CA2318, 38092273299870016, 226818178, 226818186, 8, 1440x900 
0x37CA2318, 38092273300523040, 226818242, 226818250, 8, 1440x900 
0x37CA2318, 38092273301189440, 226818308, 226818316, 8, 1440x900 
0x37CA2318, 38092273301849312, 226818373, 226818381, 8, 1440x900 
0x37CA2318, 38092273302514000, 226818438, 226818446, 8, 1440x900 
0x37CA2318, 38092273303166216, 226818507, 226818514, 7, 1440x900 
0x37CA2318, 38092273303838072, 226818573, 226818581, 8, 1440x900 
0x37CA2318, 38092273304490928, 226818637, 226818645, 8, 1440x900 
0x37CA2318, 38092273305157632, 226818707, 226818715, 8, 1440x900 
0x37CA2318, 38092273305810192, 226818767, 226818776, 9, 1440x900 
0x37CA2318, 38092273306471496, 226818837, 226818846, 9, 1440x900 
0x37CA2318, 38092273307124544, 226818902, 226818910, 8, 1440x900 
0x37CA2318, 38092273307789168, 226818966, 226818973, 7, 1440x900 
0x37CA2318, 38092273308456544, 226819032, 226819040, 8, 1440x900 
0x37CA2318, 38092273309119376, 226819098, 226819105, 7, 1440x900 
0x37CA2318, 38092273309782064, 226819167, 226819175, 8, 1440x900 
0x37CA2318, 38092273310440312, 226819232, 226819240, 8, 1440x900 
0x37CA2318, 38092273311103288, 226819302, 226819310, 8, 1440x900 
0x37CA2318, 38092273311764440, 226819364, 226819373, 9, 1440x900 
0x37CA2318, 38092273312426200, 226819432, 226819440, 8, 1440x900 
0x37CA2318, 38092273313079936, 226819498, 226819506, 8, 1440x900 
0x37CA2318, 38092273313750792, 226819563, 226819571, 8, 1440x900 
0x37CA2318, 38092273314411824, 226819632, 226819640, 8, 1440x900 
0x37CA2318, 38092273315072840, 226819693, 226819702, 9, 1440x900 
0x37CA2318, 38092273315726048, 226819763, 226819771, 8, 1440x900 
0x37CA2318, 38092273316395032, 226819828, 226819836, 8, 1440x900 
0x37CA2318, 38092273317055744, 226819898, 226819907, 9, 1440x900 
0x37CA2318, 38092273317718040, 226819963, 226819971, 8, 1440x900 
0x37CA2318, 38092273318377104, 226820028, 226820036, 8, 1440x900 
0x37CA2318, 38092273319032272, 226820093, 226820101, 8, 1440x900 
0x37CA2318, 38092273319703008, 226820157, 226820165, 8, 1440x900 
0x37CA2318, 38092273320365024, 226820227, 226820235, 8, 1440x900 
0x37CA2318, 38092273321016816, 226820288, 226820297, 9, 1440x900 
0x37CA2318, 38092273321678944, 226820357, 226820365, 8, 1440x900 
0x37CA2318, 38092273322350048, 226820423, 226820431, 8, 1440x900 
0x37CA2318, 38092273323011048, 226820487, 226820496, 9, 1440x900 
0x37CA2318, 38092273323672328, 226820558, 226820566, 8, 1440x900 
0x37CA2318, 38092273324334256, 226820619, 226820627, 8, 1440x900 
0x37CA2318, 38092273324997792, 226820687, 226820696, 9, 1440x900 
0x37CA2318, 38092273325659112, 226820752, 226820761, 9, 1440x900 
0x37CA2318, 38092273326320824, 226820823, 226820831, 8, 1440x900 
0x37CA2318, 38092273326980992, 226820887, 226820895, 8, 1440x900 
0x37CA2318, 38092273327651296, 226820952, 226820960, 8, 1440x900 
0x37CA2318, 38092273328301528, 226821017, 226821025, 8, 1440x900 
0x37CA2318, 38092273328962784, 226821082, 226821091, 9, 1440x900 
0x37CA2318, 38092273329615088, 226821153, 226821160, 7, 1440x900 
0x37CA2318, 38092273330283952, 226821217, 226821225, 8, 1440x900 
0x37CA2318, 38092273330944248, 226821282, 226821290, 8, 1440x900 
0x37CA2318, 38092273331613976, 226821348, 226821357, 9, 1440x900 
0x37CA2318, 38092273332266664, 226821417, 226821425, 8, 1440x900 
0x37CA2318, 38092273332928888, 226821482, 226821490, 8, 1440x900 
0x37CA2318, 38092273333582656, 226821548, 226821556, 8, 1440x900 
0x37CA2318, 38092273334245304, 226821612, 226821620, 8, 1440x900 
0x37CA2318, 38092273334908728, 226821678, 226821686, 8, 1440x900 
0x37CA2318, 38092273335565232, 226821749, 226821757, 8, 1440x900 
0x37CA2318, 38092273336227104, 226821813, 226821821, 8, 1440x900 
0x37CA2318, 38092273336891048, 226821877, 226821885, 8, 1440x900 
0x37CA2318, 38092273337549528, 226821947, 226821955, 8, 1440x900 
0x37CA2318, 38092273338200736, 226822012, 226822020, 8, 1440x900 
0x37CA2318, 38092273338873400, 226822077, 226822085, 8, 1440x900 
0x37CA2318, 38092273339542016, 226822142, 226822150, 8, 1440x900 
0x37CA2318, 38092273340193800, 226822208, 226822215, 7, 1440x900 
0x37CA2318, 38092273340845496, 226822272, 226822279, 7, 1440x900 
0x37CA2318, 38092273341516656, 226822342, 226822350, 8, 1440x900 
0x37CA2318, 38092273342177248, 226822408, 226822416, 8, 1440x900 
0x37CA2318, 38092273342839184, 226822473, 226822481, 8, 1440x900 
0x37CA2318, 38092273343496736, 226822537, 226822546, 9, 1440x900 
0x37CA2318, 38092273344162504, 226822607, 226822615, 8, 1440x900 
0x37CA2318, 38092273344830248, 226822673, 226822681, 8, 1440x900 
0x37CA2318, 38092273345481904, 226822737, 226822745, 8, 1440x900 
0x37CA2318, 38092273346141816, 226822802, 226822810, 8, 1440x900 
0x37CA2318, 38092273346795232, 226822868, 226822875, 7, 1440x900 
0x37CA2318, 38092273347463528, 226822933, 226822941, 8, 1440x900 
0x37CA2318, 38092273348123624, 226823003, 226823011, 8, 1440x900 
0x37CA2318, 38092273348783584, 226823068, 226823076, 8, 1440x900 
0x37CA2318, 38092273349452736, 226823132, 226823140, 8, 1440x900 
0x37CA2318, 38092273350112984, 226823197, 226823204, 7, 1440x900 
0x37CA2318, 38092273350775136, 226823263, 226823270, 7, 1440x900 
0x37CA2318, 38092273351436144, 226823333, 226823341, 8, 1440x900 
0x37CA2318, 38092273352097912, 226823397, 226823406, 9, 1440x900 
0x37CA2318, 38092273352749856, 226823463, 226823471, 8, 1440x900 
0x37CA2318, 38092273353418576, 226823533, 226823541, 8, 1440x900 
0x37CA2318, 38092273354080960, 226823598, 226823606, 8, 1440x900 
0x37CA2318, 38092273354732248, 226823663, 226823671, 8, 1440x900 
0x37CA2318, 38092273355402960, 226823727, 226823735, 8, 1440x900 
0x37CA2318, 38092273356064576, 226823793, 226823801, 8, 1440x900 
0x37CA2318, 38092273356725736, 226823862, 226823870, 8, 1440x900 
0x37CA2318, 38092273357376984, 226823928, 226823936, 8, 1440x900 
0x37CA2318, 38092273358050720, 226823992, 226824000, 8, 1440x900 
0x37CA2318, 38092273358710320, 226824057, 226824066, 9, 1440x900 
0x37CA2318, 38092273359368664, 226824127, 226824135, 8, 1440x900 
0x37CA2318, 38092273360029792, 226824192, 226824199, 7, 1440x900 
0x37CA2318, 38092273360701472, 226824257, 226824266, 9, 1440x900 
0x37CA2318, 38092273361359864, 226824328, 226824336, 8, 1440x900 
0x37CA2318, 38092273362023792, 226824393, 226824401, 8, 1440x900 
0x37CA2318, 38092273362691536, 226824458, 226824466, 8, 1440x900 
0x37CA2318, 38092273364011688, 226824588, 226824596, 8, 1440x900 
0x37CA2318, 38092273364674456, 226824658, 226824666, 8, 1440x900 
0x37CA2318, 38092273365329720, 226824723, 226824731, 8, 1440x900 
0x37CA2318, 38092273365989080, 226824788, 226824796, 8, 1440x900 
0x37CA2318, 38092273366658728, 226824857, 226824865, 8, 1440x900 
0x37CA2318, 38092273367310664, 226824922, 226824930, 8, 1440x900 
0x37CA2318, 38092273367970880, 226824985, 226824993, 8, 1440x900 
0x37CA2318, 38092273368631480, 226825052, 226825060, 8, 1440x900 
0x37CA2318, 38092273369285224, 226825118, 226825126, 8, 1440x900 
0x37CA2318, 38092273369947704, 226825183, 226825191, 8, 1440x900 
0x37CA2318, 38092273370626528, 226825248, 226825256, 8, 1440x900 
0x37CA2318, 38092273371279312, 226825316, 226825324, 8, 1440x900 
0x37CA2318, 38092273371949016, 226825382, 226825390, 8, 1440x900 
0x37CA2318, 38092273372599760, 226825447, 226825454, 7, 1440x900 
0x37CA2318, 38092273373261672, 226825512, 226825520, 8, 1440x900 
0x37CA2318, 38092273373931160, 226825581, 226825588, 7, 1440x900 
0x37CA2318, 38092273374583096, 226825648, 226825656, 8, 1440x900 
0x37CA2318, 38092273375235912, 226825712, 226825720, 8, 1440x900 
0x37CA2318, 38092273375904256, 226825778, 226825787, 9, 1440x900 
0x37CA2318, 38092273376558528, 226825848, 226825856, 8, 1440x900 
0x37CA2318, 38092273377228824, 226825913, 226825921, 8, 1440x900 
0x37CA2318, 38092273377889488, 226825977, 226825985, 8, 1440x900 
0x37CA2318, 38092273378551040, 226826043, 226826051, 8, 1440x900 
0x37CA2318, 38092273379202480, 226826107, 226826115, 8, 1440x900 
0x37CA2318, 38092273379881728, 226826178, 226826189, 11, 1440x900 
0x37CA2318, 38092273380610784, 226826247, 226826253, 6, 1440x900 
0x37CA2318, 38092273381200592, 226826308, 226826316, 8, 1440x900 
0x37CA2318, 38092273381861080, 226826377, 226826385, 8, 1440x900 
0x37CA2318, 38092273382522968, 226826442, 226826450, 8, 1440x900 
0x37CA2318, 38092273383182592, 226826507, 226826514, 7, 1440x900 
0x37CA2318, 38092273383841808, 226826574, 226826582, 8, 1440x900 
0x37CA2318, 38092273384494328, 226826638, 226826646, 8, 1440x900 
0x37CA2318, 38092273385158992, 226826703, 226826711, 8, 1440x900 
0x37CA2318, 38092273385822720, 226826769, 226826777, 8, 1440x900 
0x37CA2318, 38092273386484728, 226826838, 226826847, 9, 1440x900 
0x37CA2318, 38092273387145312, 226826907, 226826914, 7, 1440x900 
0x37CA2318, 38092273387805328, 226826973, 226826981, 8, 1440x900 
0x37CA2318, 38092273388466288, 226827037, 226827045, 8, 1440x900 
0x37CA2318, 38092273389127328, 226827102, 226827110, 8, 1440x900 
0x37CA2318, 38092273389791184, 226827168, 226827176, 8, 1440x900 
0x37CA2318, 38092273390441976, 226827232, 226827241, 9, 1440x900 
0x37CA2318, 38092273391111760, 226827297, 226827304, 7, 1440x900 
0x37CA2318, 38092273391770432, 226827363, 226827370, 7, 1440x900 
0x37CA2318, 38092273392432616, 226827432, 226827440, 8, 1440x900 
0x37CA2318, 38092273393093176, 226827497, 226827505, 8, 1440x900 
0x37CA2318, 38092273393762392, 226827563, 226827572, 9, 1440x900 
0x37CA2318, 38092273394408760, 226827628, 226827636, 8, 1440x900 
0x37CA2318, 38092273395072600, 226827694, 226827703, 9, 1440x900 
0x37CA2318, 38092273395742880, 226827762, 226827770, 8, 1440x900 
0x37CA2318, 38092273396397008, 226827828, 226827836, 8, 1440x900 
0x37CA2318, 38092273397057048, 226827894, 226827903, 9, 1440x900 
0x37CA2318, 38092273397724992, 226827964, 226827972, 8, 1440x900 
0x37CA2318, 38092273398395024, 226828028, 226828037, 9, 1440x900 
0x37CA2318, 38092273399053704, 226828092, 226828100, 8, 1440x900 
0x37CA2318, 38092273399713792, 226828162, 226828171, 9, 1440x900 
0x37CA2318, 38092273400366864, 226828227, 226828235, 8, 1440x900 
0x37CA2318, 38092273401026392, 226828293, 226828301, 8, 1440x900 
0x37CA2318, 38092273401686336, 226828357, 226828365, 8, 1440x900 
0x37CA2318, 38092273402355888, 226828424, 226828432, 8, 1440x900 
0x37CA2318, 38092273403007624, 226828487, 226828496, 9, 1440x900 
0x37CA2318, 38092273403662008, 226828553, 226828562, 9, 1440x900 
0x37CA2318, 38092273404332808, 226828623, 226828631, 8, 1440x900 
0x37CA2318, 38092273404996888, 226828687, 226828696, 9, 1440x900 
0x37CA2318, 38092273405658128, 226828757, 226828765, 8, 1440x900 
0x37CA2318, 38092273406309248, 226828817, 226828826, 9, 1440x900 
0x37CA2318, 38092273406971952, 226828888, 226828896, 8, 1440x900 
0x37CA2318, 38092273407643872, 226828953, 226828961, 8, 1440x900 
0x37CA2318, 38092273408313832, 226829018, 226829026, 8, 1440x900 
0x37CA2318, 38092273408965376, 226829087, 226829095, 8, 1440x900 
0x37CA2318, 38092273409626040, 226829151, 226829158, 7, 1440x900 
0x37CA2318, 38092273410283864, 226829217, 226829225, 8, 1440x900 
0x37CA2318, 38092273410957472, 226829288, 226829296, 8, 1440x900 
0x37CA2318, 38092273411620944, 226829352, 226829360, 8, 1440x900 
0x37CA2318, 38092273412281120, 226829418, 226829426, 8, 1440x900 
0x37CA2318, 38092273412942560, 226829482, 226829490, 8, 1440x900 
0x37CA2318, 38092273413604176, 226829548, 226829556, 8, 1440x900 
0x37CA2318, 38092273414266512, 226829613, 226829622, 9, 1440x900 
0x37CA2318, 38092273414935216, 226829683, 226829691, 8, 1440x900 
0x37CA2318, 38092273415587408, 226829747, 226829755, 8, 1440x900 
0x37CA2318, 38092273416241584, 226829812, 226829820, 8, 1440x900 
0x37CA2318, 38092273416904264, 226829878, 226829886, 8, 1440x900 
0x37CA2318, 38092273417569192, 226829943, 226829952, 9, 1440x900 
0x37CA2318, 38092273418227848, 226830012, 226830020, 8, 1440x900 
0x37CA2318, 38092273418888464, 226830078, 226830086, 8, 1440x900 
0x37CA2318, 38092273419550464, 226830143, 226830151, 8, 1440x900 
0x37CA2318, 38092273420218960, 226830213, 226830221, 8, 1440x900 
0x37CA2318, 38092273420872144, 226830273, 226830280, 7, 1440x900 
0x37CA2318, 38092273421529232, 226830338, 226830345, 7, 1440x900 
0x37CA2318, 38092273422198640, 226830406, 226830413, 7, 1440x900 
0x37CA2318, 38092273422853816, 226830477, 226830486, 9, 1440x900 
0x37CA2318, 38092273423508800, 226830538, 226830546, 8, 1440x900 
0x37CA2318, 38092273424175648, 226830608, 226830616, 8, 1440x900 
0x37CA2318, 38092273424836000, 226830672, 226830680, 8, 1440x900 
0x37CA2318, 38092273425495552, 226830737, 226830745, 8, 1440x900 
0x37CA2318, 38092273426157280, 226830808, 226830816, 8, 1440x900 
0x37CA2318, 38092273426814336, 226830869, 226830876, 7, 1440x900 
0x37CA2318, 38092273427474640, 226830933, 226830941, 8, 1440x900 
0x37CA2318, 38092273428138544, 226831003, 226831011, 8, 1440x900 
0x37CA2318, 38092273428798832, 226831067, 226831075, 8, 1440x900 
0x37CA2318, 38092273429461248, 226831132, 226831141, 9, 1440x900 
0x37CA2318, 38092273430116608, 226831203, 226831211, 8, 1440x900 
0x37CA2318, 38092273430788704, 226831268, 226831276, 8, 1440x900 
0x37CA2318, 38092273431446024, 226831336, 226831344, 8, 1440x900 
0x37CA2318, 38092273432099624, 226831397, 226831404, 7, 1440x900 
0x37CA2318, 38092273432760200, 226831468, 226831476, 8, 1440x900 
0x37CA2318, 38092273433419464, 226831527, 226831534, 7, 1440x900 
0x37CA2318, 38092273434082632, 226831593, 226831601, 8, 1440x900 
0x37CA2318, 38092273434741728, 226831662, 226831670, 8, 1440x900 
0x37CA2318, 38092273435404504, 226831727, 226831736, 9, 1440x900 
0x37CA2318, 38092273436073296, 226831793, 226831800, 7, 1440x900 
0x37CA2318, 38092273436734288, 226831859, 226831867, 8, 1440x900 
0x37CA2318, 38092273437385416, 226831928, 226831936, 8, 1440x900 
0x37CA2318, 38092273438046752, 226831993, 226832001, 8, 1440x900 
0x37CA2318, 38092273438708824, 226832062, 226832070, 8, 1440x900 
0x37CA2318, 38092273439378120, 226832127, 226832135, 8, 1440x900 
0x37CA2318, 38092273440031560, 226832193, 226832201, 8, 1440x900 
0x37CA2318, 38092273441353288, 226832327, 226832335, 8, 1440x900 
0x37CA2318, 38092273442022912, 226832393, 226832401, 8, 1440x900 
0x37CA2318, 38092273442682424, 226832458, 226832466, 8, 1440x900 
0x37CA2318, 38092273443343544, 226832522, 226832530, 8, 1440x900 
0x37CA2318, 38092273443995648, 226832592, 226832600, 8, 1440x900 
0x37CA2318, 38092273444655896, 226832652, 226832661, 9, 1440x900 
0x37CA2318, 38092273445318584, 226832723, 226832731, 8, 1440x900 
0x37CA2318, 38092273445977520, 226832787, 226832795, 8, 1440x900 
0x37CA2318, 38092273446644424, 226832857, 226832865, 8, 1440x900 
0x37CA2318, 38092273447294456, 226832918, 226832926, 8, 1440x900 
0x37CA2318, 38092273447966944, 226832987, 226832995, 8, 1440x900 
0x37CA2318, 38092273448610352, 226833052, 226833060, 8, 1440x900 
0x37CA2318, 38092273449273056, 226833117, 226833125, 8, 1440x900 
0x37CA2318, 38092273449934896, 226833184, 226833191, 7, 1440x900 
0x37CA2318, 38092273450599592, 226833247, 226833255, 8, 1440x900 
0x37CA2318, 38092273451259560, 226833313, 226833322, 9, 1440x900 
0x37CA2318, 38092273451925568, 226833381, 226833389, 8, 1440x900 
0x37CA2318, 38092273452569424, 226833443, 226833450, 7, 1440x900 
0x37CA2318, 38092273453231600, 226833508, 226833516, 8, 1440x900 
0x37CA2318, 38092273453892512, 226833577, 226833585, 8, 1440x900 
0x37CA2318, 38092273454558104, 226833643, 226833651, 8, 1440x900 
0x37CA2318, 38092273455247608, 226833711, 226833720, 9, 1440x900 
0x37CA2318, 38092273455707648, 226833757, 226833764, 7, 1440x900 
0x37CA2318, 38092273456561608, 226833842, 226833850, 8, 1440x900 
0x37CA2318, 38092273457228528, 226833908, 226833916, 8, 1440x900 
0x37CA2318, 38092273457874416, 226833973, 226833981, 8, 1440x900 
0x37CA2318, 38092273458541976, 226834047, 226834055, 8, 1440x900 
0x37CA2318, 38092273459196832, 226834113, 226834121, 8, 1440x900 
0x37CA2318, 38092273459867344, 226834173, 226834182, 9, 1440x900 
0x37CA2318, 38092273460529864, 226834243, 226834251, 8, 1440x900 
0x37CA2318, 38092273461198176, 226834313, 226834321, 8, 1440x900 
0x37CA2318, 38092273461848376, 226834372, 226834380, 8, 1440x900 
0x37CA2318, 38092273462508832, 226834436, 226834443, 7, 1440x900 
0x37CA2318, 38092273463172656, 226834503, 226834511, 8, 1440x900 
0x37CA2318, 38092273463842232, 226834572, 226834579, 7, 1440x900 
0x37CA2318, 38092273464502792, 226834637, 226834644, 7, 1440x900 
0x37CA2318, 38092273465154408, 226834703, 226834712, 9, 1440x900 
0x37CA2318, 38092273465815744, 226834772, 226834780, 8, 1440x900 
0x37CA2318, 38092273466468656, 226834838, 226834847, 9, 1440x900 
0x37CA2318, 38092273467148536, 226834902, 226834910, 8, 1440x900 
0x37CA2318, 38092273467799904, 226834968, 226834976, 8, 1440x900 
0x37CA2318, 38092273468463240, 226835033, 226835041, 8, 1440x900 
0x37CA2318, 38092273469116496, 226835103, 226835111, 8, 1440x900 
0x37CA2318, 38092273469779024, 226835168, 226835176, 8, 1440x900 
0x37CA2318, 38092273470441184, 226835232, 226835240, 8, 1440x900 
0x37CA2318, 38092273471111008, 226835298, 226835306, 8, 1440x900 
0x37CA2318, 38092273471764944, 226835364, 226835373, 9, 1440x900 
0x37CA2318, 38092273472420096, 226835428, 226835435, 7, 1440x900 
0x37CA2318, 38092273473092816, 226835496, 226835504, 8, 1440x900 
0x37CA2318, 38092273473744880, 226835562, 226835570, 8, 1440x900 
0x37CA2318, 38092273474396288, 226835627, 226835635, 8, 1440x900 
0x37CA2318, 38092273475067832, 226835698, 226835706, 8, 1440x900 
0x37CA2318, 38092273475721408, 226835759, 226835767, 8, 1440x900 
0x37CA2318, 38092273476384688, 226835829, 226835836, 7, 1440x900 
0x37CA2318, 38092273477043008, 226835892, 226835900, 8, 1440x900 
0x37CA2318, 38092273477702216, 226835957, 226835965, 8, 1440x900 
0x37CA2318, 38092273478362544, 226836024, 226836032, 8, 1440x900 
0x37CA2318, 38092273479033640, 226836093, 226836101, 8, 1440x900 
0x37CA2318, 38092273479695088, 226836158, 226836166, 8, 1440x900 
0x37CA2318, 38092273480346088, 226836227, 226836235, 8, 1440x900 
0x37CA2318, 38092273481018944, 226836293, 226836302, 9, 1440x900 
0x37CA2318, 38092273481481296, 226836336, 226836343, 7, 1440x900 
0x37CA2318, 38092273482152544, 226836403, 226836410, 7, 1440x900 
0x37CA2318, 38092273482806288, 226836467, 226836474, 7, 1440x900 
0x37CA2318, 38092273483659136, 226836552, 226836559, 7, 1440x900 
0x37CA2318, 38092273484322216, 226836618, 226836625, 7, 1440x900 
0x37CA2318, 38092273484976024, 226836688, 226836696, 8, 1440x900 
0x37CA2318, 38092273485647040, 226836757, 226836765, 8, 1440x900 
0x37CA2318, 38092273486298624, 226836816, 226836823, 7, 1440x900 
0x37CA2318, 38092273486958136, 226836882, 226836889, 7, 1440x900 
0x37CA2318, 38092273487618624, 226836947, 226836955, 8, 1440x900 
0x37CA2318, 38092273488285336, 226837017, 226837024, 7, 1440x900 
0x37CA2318, 38092273488946568, 226837083, 226837091, 8, 1440x900 
0x37CA2318, 38092273489606400, 226837152, 226837160, 8, 1440x900 
0x37CA2318, 38092273490267392, 226837213, 226837222, 9, 1440x900 
0x37CA2318, 38092273490923384, 226837283, 226837310, 27, 1440x900 
0x37CA2318, 38092273491601776, 226837347, 226837354, 7, 1440x900 
0x37CA2318, 38092273492250160, 226837412, 226837419, 7, 1440x900 
0x37CA2318, 38092273492918976, 226837477, 226837485, 8, 1440x900 
0x37CA2318, 38092273493571672, 226837547, 226837555, 8, 1440x900 
0x37CA2318, 38092273494240504, 226837612, 226837620, 8, 1440x900 
0x37CA2318, 38092273494905808, 226837677, 226837686, 9, 1440x900 
0x37CA2318, 38092273495560320, 226837742, 226837750, 8, 1440x900 
0x37CA2318, 38092273496227856, 226837808, 226837816, 8, 1440x900 
0x37CA2318, 38092273496888040, 226837877, 226837884, 7, 1440x900 
0x37CA2318, 38092273497550544, 226837942, 226837950, 8, 1440x900 
0x37CA2318, 38092273498202376, 226838007, 226838015, 8, 1440x900 
0x37CA2318, 38092273498863728, 226838073, 226838080, 7, 1440x900 
0x37CA2318, 38092273499518448, 226838138, 226838145, 7, 1440x900 
0x37CA2318, 38092273500189088, 226838207, 226838215, 8, 1440x900 
0x37CA2318, 38092273500840184, 226838273, 226838282, 9, 1440x900 
0x37CA2318, 38092273501511320, 226838342, 226838350, 8, 1440x900 
0x37CA2318, 38092273502163872, 226838409, 226838417, 8, 1440x900 
0x37CA2318, 38092273502823072, 226838468, 226838475, 7, 1440x900 
0x37CA2318, 38092273503489512, 226838538, 226838546, 8, 1440x900 
0x37CA2318, 38092273504150192, 226838602, 226838611, 9, 1440x900 
0x37CA2318, 38092273504812704, 226838670, 226838678, 8, 1440x900 
0x37CA2318, 38092273505475320, 226838737, 226838745, 8, 1440x900 
0x37CA2318, 38092273506125256, 226838802, 226838810, 8, 1440x900 
0x37CA2318, 38092273507320344, 226838923, 226838930, 7, 1440x900 
0x37CA2318, 38092273507925072, 226838978, 226838986, 8, 1440x900 
0x37CA2318, 38092273508786984, 226839067, 226839075, 8, 1440x900 
0x37CA2318, 38092273509448112, 226839133, 226839141, 8, 1440x900 
0x37CA2318, 38092273510100840, 226839198, 226839207, 9, 1440x900 
0x37CA2318, 38092273510761120, 226839263, 226839271, 8, 1440x900 
0x37CA2318, 38092273511430464, 226839333, 226839341, 8, 1440x900 
0x37CA2318, 38092273512088560, 226839398, 226839406, 8, 1440x900 
0x37CA2318, 38092273512740032, 226839462, 226839470, 8, 1440x900 
0x37CA2318, 38092273513400640, 226839528, 226839536, 8, 1440x900 
0x37CA2318, 38092273514066160, 226839597, 226839605, 8, 1440x900 
0x37CA2318, 38092273514718224, 226839663, 226839671, 8, 1440x900 
0x37CA2318, 38092273515390888, 226839732, 226839740, 8, 1440x900 
0x37CA2318, 38092273516051504, 226839792, 226839801, 9, 1440x900 
0x37CA2318, 38092273516721688, 226839862, 226839869, 7, 1440x900 
0x37CA2318, 38092273517381424, 226839928, 226839936, 8, 1440x900 
0x37CA2318, 38092273518050720, 226839992, 226840000, 8, 1440x900 
0x37CA2318, 38092273518705184, 226840057, 226840064, 7, 1440x900 
0x37CA2318, 38092273519363648, 226840128, 226840136, 8, 1440x900 
0x37CA2318, 38092273520017496, 226840193, 226840201, 8, 1440x900 
0x37CA2318, 38092273520688496, 226840258, 226840267, 9, 1440x900 
0x37CA2318, 38092273521348480, 226840323, 226840332, 9, 1440x900 
0x37CA2318, 38092273522011032, 226840388, 226840397, 9, 1440x900 
0x37CA2318, 38092273522670640, 226840453, 226840460, 7, 1440x900 
0x37CA2318, 38092273523323912, 226840522, 226840530, 8, 1440x900 
0x37CA2318, 38092273523995064, 226840588, 226840596, 8, 1440x900 
0x37CA2318, 38092273524662992, 226840657, 226840665, 8, 1440x900 
0x37CA2318, 38092273525312784, 226840722, 226840730, 8, 1440x900 
0x37CA2318, 38092273525976144, 226840788, 226840796, 8, 1440x900 
0x37CA2318, 38092273526635632, 226840852, 226840860, 8, 1440x900 
0x37CA2318, 38092273527296392, 226840918, 226840926, 8, 1440x900 
0x37CA2318, 38092273527948304, 226840982, 226840990, 8, 1440x900 
0x37CA2318, 38092273528621448, 226841052, 226841060, 8, 1440x900 
0x37CA2318, 38092273529290432, 226841119, 226841127, 8, 1440x900 
0x37CA2318, 38092273529940696, 226841178, 226841186, 8, 1440x900 
0x37CA2318, 38092273530605328, 226841247, 226841254, 7, 1440x900 
0x37CA2318, 38092273531265440, 226841312, 226841320, 8, 1440x900 
0x37CA2318, 38092273531925520, 226841378, 226841386, 8, 1440x900 
0x37CA2318, 38092273532584984, 226841443, 226841451, 8, 1440x900 
0x37CA2318, 38092273533236368, 226841511, 226841518, 7, 1440x900 
0x37CA2318, 38092273533900400, 226841577, 226841585, 8, 1440x900 
0x37CA2318, 38092273534571456, 226841643, 226841652, 9, 1440x900 
0x37CA2318, 38092273535232840, 226841713, 226841721, 8, 1440x900 
0x37CA2318, 38092273535891376, 226841778, 226841786, 8, 1440x900 
0x37CA2318, 38092273536544512, 226841848, 226841856, 8, 1440x900 
0x37CA2318, 38092273537205056, 226841909, 226841917, 8, 1440x900 
0x37CA2318, 38092273537869096, 226841978, 226841986, 8, 1440x900 
0x37CA2318, 38092273538527192, 226842042, 226842050, 8, 1440x900 
0x37CA2318, 38092273539196976, 226842108, 226842116, 8, 1440x900 
0x37CA2318, 38092273539848456, 226842173, 226842181, 8, 1440x900 
0x37CA2318, 38092273540500912, 226842237, 226842245, 8, 1440x900 
0x37CA2318, 38092273541176848, 226842308, 226842316, 8, 1440x900 
0x37CA2318, 38092273541828320, 226842373, 226842381, 8, 1440x900 
0x37CA2318, 38092273542500424, 226842442, 226842450, 8, 1440x900 
0x37CA2318, 38092273543158808, 226842502, 226842511, 9, 1440x900 
0x37CA2318, 38092273543810888, 226842567, 226842574, 7, 1440x900 
0x37CA2318, 38092273544462696, 226842637, 226842645, 8, 1440x900 
0x37CA2318, 38092273545125408, 226842703, 226842711, 8, 1440x900 
0x37CA2318, 38092273545805008, 226842769, 226842778, 9, 1440x900 
0x37CA2318, 38092273546456336, 226842833, 226842842, 9, 1440x900 
0x37CA2318, 38092273547116424, 226842898, 226842906, 8, 1440x900 
0x37CA2318, 38092273547771168, 226842968, 226842976, 8, 1440x900 
0x37CA2318, 38092273548441448, 226843033, 226843041, 8, 1440x900 
0x37CA2318, 38092273549103104, 226843098, 226843106, 8, 1440x900 
0x37CA2318, 38092273549765776, 226843168, 226843176, 8, 1440x900 
0x37CA2318, 38092273550419344, 226843233, 226843241, 8, 1440x900 
0x37CA2318, 38092273551095200, 226843298, 226843306, 8, 1440x900 
0x37CA2318, 38092273551754096, 226843363, 226843370, 7, 1440x900 
0x37CA2318, 38092273552414248, 226843429, 226843437, 8, 1440x900 
0x37CA2318, 38092273553066552, 226843497, 226843504, 7, 1440x900 
0x37CA2318, 38092273553720784, 226843558, 226843565, 7, 1440x900 
0x37CA2318, 38092273554393000, 226843626, 226843634, 8, 1440x900 
0x37CA2318, 38092273555050448, 226843692, 226843700, 8, 1440x900 
0x37CA2318, 38092273555713712, 226843763, 226843770, 7, 1440x900 
0x37CA2318, 38092273556376096, 226843828, 226843836, 8, 1440x900 
0x37CA2318, 38092273557036736, 226843892, 226843900, 8, 1440x900 
0x37CA2318, 38092273557687744, 226843958, 226843966, 8, 1440x900 
0x37CA2318, 38092273558360440, 226844023, 226844031, 8, 1440x900 
0x37CA2318, 38092273559029952, 226844092, 226844100, 8, 1440x900 
0x37CA2318, 38092273559682312, 226844158, 226844166, 8, 1440x900 
0x37CA2318, 38092273560350904, 226844227, 226844235, 8, 1440x900 
0x37CA2318, 38092273561001888, 226844293, 226844301, 8, 1440x900 
0x37CA2318, 38092273561671664, 226844357, 226844364, 7, 1440x900 
0x37CA2318, 38092273562331952, 226844423, 226844431, 8, 1440x900 
0x37CA2318, 38092273562990744, 226844486, 226844493, 7, 1440x900 
0x37CA2318, 38092273563643072, 226844553, 226844561, 8, 1440x900 
0x37CA2318, 38092273564300824, 226844617, 226844625, 8, 1440x900 
0x37CA2318, 38092273564970752, 226844683, 226844690, 7, 1440x900 
0x37CA2318, 38092273565622184, 226844748, 226844755, 7, 1440x900 
0x37CA2318, 38092273566281976, 226844818, 226844826, 8, 1440x900 
0x37CA2318, 38092273566953552, 226844883, 226844891, 8, 1440x900 
0x37CA2318, 38092273567606536, 226844953, 226844961, 8, 1440x900 
0x37CA2318, 38092273568274464, 226845018, 226845026, 8, 1440x900 
0x37CA2318, 38092273568929832, 226845082, 226845090, 8, 1440x900 
0x37CA2318, 38092273569599640, 226845148, 226845155, 7, 1440x900 
0x37CA2318, 38092273570261496, 226845217, 226845225, 8, 1440x900 
0x37CA2318, 38092273570914976, 226845279, 226845288, 9, 1440x900 
0x37CA2318, 38092273571575808, 226845348, 226845356, 8, 1440x900 
0x37CA2318, 38092273572238312, 226845412, 226845420, 8, 1440x900 
0x37CA2318, 38092273572896920, 226845478, 226845486, 8, 1440x900 
0x37CA2318, 38092273573549816, 226845543, 226845551, 8, 1440x900 
0x37CA2318, 38092273574210952, 226845608, 226845617, 9, 1440x900 
0x37CA2318, 38092273574881848, 226845678, 226845686, 8, 1440x900 
0x37CA2318, 38092273575542416, 226845743, 226845751, 8, 1440x900 
0x37CA2318, 38092273576206496, 226845812, 226845820, 8, 1440x900 
0x37CA2318, 38092273576875320, 226845877, 226845885, 8, 1440x900 
0x37CA2318, 38092273577534880, 226845943, 226845951, 8, 1440x900 
0x37CA2318, 38092273578196864, 226846013, 226846021, 8, 1440x900 
0x37CA2318, 38092273578848800, 226846072, 226846080, 8, 1440x900 
0x37CA2318, 38092273579510120, 226846143, 226846151, 8, 1440x900 
0x37CA2318, 38092273580170544, 226846208, 226846216, 8, 1440x900 
0x37CA2318, 38092273580824352, 226846273, 226846280, 7, 1440x900 
0x37CA2318, 38092273581500000, 226846338, 226846347, 9, 1440x900 
0x37CA2318, 38092273582147696, 226846403, 226846410, 7, 1440x900 
0x37CA2318, 38092273582811832, 226846468, 226846475, 7, 1440x900 
0x37CA2318, 38092273583475760, 226846533, 226846541, 8, 1440x900 
0x37CA2318, 38092273584128384, 226846598, 226846606, 8, 1440x900 
0x37CA2318, 38092273584800416, 226846667, 226846674, 7, 1440x900 
0x37CA2318, 38092273586108712, 226846798, 226846807, 9, 1440x900 
0x37CA2318, 38092273586777288, 226846868, 226846876, 8, 1440x900 
0x37CA2318, 38092273587437400, 226846932, 226846940, 8, 1440x900 
0x37CA2318, 38092273588097200, 226846997, 226847006, 9, 1440x900 
0x37CA2318, 38092273588758240, 226847063, 226847071, 8, 1440x900 
0x37CA2318, 38092273589426112, 226847133, 226847140, 7, 1440x900 
0x37CA2318, 38092273590088672, 226847197, 226847205, 8, 1440x900 
0x37CA2318, 38092273590739904, 226847262, 226847270, 8, 1440x900 
0x37CA2318, 38092273591401720, 226847328, 226847336, 8, 1440x900 
0x37CA2318, 38092273592059632, 226847397, 226847405, 8, 1440x900 
0x37CA2318, 38092273592739168, 226847463, 226847471, 8, 1440x900 
0x37CA2318, 38092273593391944, 226847528, 226847536, 8, 1440x900 
0x37CA2318, 38092273594047248, 226847598, 226847606, 8, 1440x900 
0x37CA2318, 38092273594718112, 226847658, 226847667, 9, 1440x900 
0x37CA2318, 38092273595370304, 226847728, 226847736, 8, 1440x900 
0x37CA2318, 38092273596034672, 226847794, 226847802, 8, 1440x900 
0x37CA2318, 38092273596686544, 226847857, 226847865, 8, 1440x900 
0x37CA2318, 38092273597350512, 226847922, 226847931, 9, 1440x900 
0x37CA2318, 38092273598020320, 226847992, 226848000, 8, 1440x900 
0x37CA2318, 38092273598672880, 226848053, 226848063, 10, 1440x900 
0x37CA2318, 38092273599327896, 226848123, 226848130, 7, 1440x900 
0x37CA2318, 38092273599990536, 226848187, 226848195, 8, 1440x900 
0x37CA2318, 38092273600654640, 226848253, 226848261, 8, 1440x900 
0x37CA2318, 38092273601313776, 226848318, 226848326, 8, 1440x900 
0x37CA2318, 38092273601975736, 226848388, 226848396, 8, 1440x900 
0x37CA2318, 38092273602634784, 226848453, 226848461, 8, 1440x900 
0x37CA2318, 38092273603297240, 226848518, 226848526, 8, 1440x900 
0x37CA2318, 38092273603957424, 226848583, 226848592, 9, 1440x900 
0x37CA2318, 38092273604612048, 226848652, 226848660, 8, 1440x900 
0x37CA2318, 38092273605268776, 226848717, 226848725, 8, 1440x900 
0x37CA2318, 38092273605936904, 226848781, 226848789, 8, 1440x900 
0x37CA2318, 38092273606589656, 226848848, 226848855, 7, 1440x900 
0x37CA2318, 38092273607258912, 226848913, 226848921, 8, 1440x900 
0x37CA2318, 38092273607919840, 226848978, 226848987, 9, 1440x900 
0x37CA2318, 38092273608579424, 226849048, 226849056, 8, 1440x900 
0x37CA2318, 38092273609241024, 226849113, 226849121, 8, 1440x900 
0x37CA2318, 38092273609902936, 226849182, 226849190, 8, 1440x900 
0x37CA2318, 38092273610565408, 226849243, 226849252, 9, 1440x900 
0x37CA2318, 38092273611218760, 226849308, 226849317, 9, 1440x900 
0x37CA2318, 38092273611895592, 226849382, 226849390, 8, 1440x900 
0x37CA2318, 38092273612555800, 226849442, 226849451, 9, 1440x900 
0x37CA2318, 38092273613209240, 226849508, 226849517, 9, 1440x900 
0x37CA2318, 38092273613869496, 226849573, 226849582, 9, 1440x900 
0x37CA2318, 38092273614532432, 226849643, 226849651, 8, 1440x900 
0x37CA2318, 38092273615191968, 226849703, 226849711, 8, 1440x900 
0x37CA2318, 38092273615845408, 226849772, 226849779, 7, 1440x900 
0x37CA2318, 38092273616507256, 226849839, 226849848, 9, 1440x900 
0x37CA2318, 38092273617177856, 226849907, 226849915, 8, 1440x900 
0x37CA2318, 38092273617833600, 226849973, 226849981, 8, 1440x900 
0x37CA2318, 38092273618484920, 226850039, 226850047, 8, 1440x900 
0x37CA2318, 38092273619154912, 226850107, 226850115, 8, 1440x900 
0x37CA2318, 38092273619809824, 226850172, 226850180, 8, 1440x900 
0x37CA2318, 38092273620479064, 226850238, 226850246, 8, 1440x900 
0x37CA2318, 38092273621140952, 226850303, 226850311, 8, 1440x900 
0x37CA2318, 38092273621810808, 226850372, 226850380, 8, 1440x900 
0x37CA2318, 38092273622461080, 226850438, 226850446, 8, 1440x900 
0x37CA2318, 38092273623131360, 226850502, 226850510, 8, 1440x900 
0x37CA2318, 38092273623793624, 226850568, 226850576, 8, 1440x900 
0x37CA2318, 38092273624462952, 226850638, 226850648, 10, 1440x900 
0x37CA2318, 38092273624923072, 226850677, 226850685, 8, 1440x900 
0x37CA2318, 38092273625582312, 226850742, 226850750, 8, 1440x900 
0x37CA2318, 38092273626248336, 226850814, 226850821, 7, 1440x900 
0x37CA2318, 38092273627103496, 226850898, 226850905, 7, 1440x900 
0x37CA2318, 38092273627757000, 226850962, 226850970, 8, 1440x900 
0x37CA2318, 38092273628418392, 226851028, 226851036, 8, 1440x900 
0x37CA2318, 38092273629079336, 226851098, 226851105, 7, 1440x900 
0x37CA2318, 38092273629736696, 226851163, 226851170, 7, 1440x900 
0x37CA2318, 38092273630399656, 226851228, 226851235, 7, 1440x900 
0x37CA2318, 38092273631060936, 226851293, 226851300, 7, 1440x900 
0x37CA2318, 38092273631717880, 226851362, 226851369, 7, 1440x900 
0x37CA2318, 38092273632369528, 226851423, 226851432, 9, 1440x900 
0x37CA2318, 38092273633038704, 226851492, 226851500, 8, 1440x900 
0x37CA2318, 38092273633702624, 226851557, 226851565, 8, 1440x900 
0x37CA2318, 38092273634365880, 226851624, 226851632, 8, 1440x900 
0x37CA2318, 38092273635025896, 226851693, 226851701, 8, 1440x900 
0x37CA2318, 38092273635686816, 226851756, 226851763, 7, 1440x900 
0x37CA2318, 38092273636338208, 226851818, 226851826, 8, 1440x900 
0x37CA2318, 38092273637013568, 226851887, 226851894, 7, 1440x900 
0x37CA2318, 38092273637670320, 226851952, 226851960, 8, 1440x900 
0x37CA2318, 38092273638339848, 226852023, 226852031, 8, 1440x900 
0x37CA2318, 38092273638990376, 226852088, 226852096, 8, 1440x900 
0x37CA2318, 38092273639653392, 226852156, 226852164, 8, 1440x900 
0x37CA2318, 38092273640313920, 226852218, 226852225, 7, 1440x900 
0x37CA2318, 38092273640967768, 226852288, 226852296, 8, 1440x900 
0x37CA2318, 38092273641634000, 226852352, 226852361, 9, 1440x900 
0x37CA2318, 38092273642288128, 226852417, 226852425, 8, 1440x900 
0x37CA2318, 38092273642959192, 226852483, 226852491, 8, 1440x900 
0x37CA2318, 38092273643623640, 226852553, 226852561, 8, 1440x900 
0x37CA2318, 38092273644274616, 226852618, 226852626, 8, 1440x900 
0x37CA2318, 38092273644935680, 226852682, 226852690, 8, 1440x900 
0x37CA2318, 38092273645597272, 226852748, 226852756, 8, 1440x900 
0x37CA2318, 38092273646257880, 226852818, 226852826, 8, 1440x900 
0x37CA2318, 38092273646919032, 226852882, 226852890, 8, 1440x900 
0x37CA2318, 38092273647587360, 226852948, 226852956, 8, 1440x900 
0x37CA2318, 38092273648248640, 226853012, 226853020, 8, 1440x900 
0x37CA2318, 38092273648899232, 226853078, 226853087, 9, 1440x900 
0x37CA2318, 38092273649559192, 226853147, 226853155, 8, 1440x900 
0x37CA2318, 38092273650230104, 226853213, 226853221, 8, 1440x900 
0x37CA2318, 38092273650881640, 226853278, 226853286, 8, 1440x900 
0x37CA2318, 38092273651540208, 226853343, 226853351, 8, 1440x900 
0x37CA2318, 38092273652201088, 226853408, 226853417, 9, 1440x900 
0x37CA2318, 38092273652866592, 226853477, 226853485, 8, 1440x900 
0x37CA2318, 38092273653528480, 226853543, 226853551, 8, 1440x900 
0x37CA2318, 38092273654187368, 226853608, 226853616, 8, 1440x900 
0x37CA2318, 38092273654839984, 226853673, 226853681, 8, 1440x900 
0x37CA2318, 38092273655499616, 226853742, 226853750, 8, 1440x900 
0x37CA2318, 38092273656160416, 226853807, 226853815, 8, 1440x900 
0x37CA2318, 38092273656822200, 226853872, 226853880, 8, 1440x900 
0x37CA2318, 38092273657490808, 226853938, 226853946, 8, 1440x900 
0x37CA2318, 38092273658146128, 226854003, 226854011, 8, 1440x900 
0x37CA2318, 38092273658798688, 226854068, 226854076, 8, 1440x900 
0x37CA2318, 38092273659476920, 226854138, 226854146, 8, 1440x900 
0x37CA2318, 38092273660127952, 226854202, 226854210, 8, 1440x900 
0x37CA2318, 38092273660787608, 226854267, 226854275, 8, 1440x900 
0x37CA2318, 38092273661453960, 226854332, 226854341, 9, 1440x900 
0x37CA2318, 38092273662765176, 226854463, 226854472, 9, 1440x900 
0x37CA2318, 38092273663440544, 226854533, 226854541, 8, 1440x900 
0x37CA2318, 38092273664103680, 226854597, 226854605, 8, 1440x900 
0x37CA2318, 38092273664764128, 226854663, 226854671, 8, 1440x900 
0x37CA2318, 38092273665415424, 226854733, 226854741, 8, 1440x900 
0x37CA2318, 38092273666074768, 226854793, 226854801, 8, 1440x900 
0x37CA2318, 38092273666755664, 226854862, 226854869, 7, 1440x900 
0x37CA2318, 38092273667407160, 226854927, 226854935, 8, 1440x900 
0x37CA2318, 38092273668076520, 226854993, 226855001, 8, 1440x900 
0x37CA2318, 38092273668735208, 226855064, 226855072, 8, 1440x900 
0x37CA2318, 38092273669396096, 226855127, 226855135, 8, 1440x900 
0x37CA2318, 38092273670053968, 226855198, 226855206, 8, 1440x900 
0x37CA2318, 38092273670714936, 226855263, 226855271, 8, 1440x900 
0x37CA2318, 38092273671373120, 226855328, 226855336, 8, 1440x900 
0x37CA2318, 38092273672037352, 226855393, 226855401, 8, 1440x900 
0x37CA2318, 38092273672692352, 226855458, 226855466, 8, 1440x900 
0x37CA2318, 38092273673355216, 226855527, 226855535, 8, 1440x900 
0x37CA2318, 38092273674033120, 226855593, 226855601, 8, 1440x900 
0x37CA2318, 38092273674695592, 226855658, 226855666, 8, 1440x900 
0x37CA2318, 38092273675345784, 226855722, 226855730, 8, 1440x900 
0x37CA2318, 38092273676025712, 226855793, 226855801, 8, 1440x900 
0x37CA2318, 38092273676679560, 226855857, 226855865, 8, 1440x900 
0x37CA2318, 38092273677347248, 226855922, 226855930, 8, 1440x900 
0x37CA2318, 38092273677999440, 226855988, 226855996, 8, 1440x900 
0x37CA2318, 38092273678656160, 226856054, 226856062, 8, 1440x900 
0x37CA2318, 38092273679318792, 226856118, 226856127, 9, 1440x900 
0x37CA2318, 38092273679986520, 226856188, 226856197, 9, 1440x900 
0x37CA2318, 38092273680448824, 226856232, 226856240, 8, 1440x900 
0x37CA2318, 38092273681298480, 226856323, 226856330, 7, 1440x900 
0x37CA2318, 38092273681768928, 226856362, 226856370, 8, 1440x900 
0x37CA2318, 38092273682620208, 226856448, 226856455, 7, 1440x900 
0x37CA2318, 38092273683277872, 226856513, 226856521, 8, 1440x900 
0x37CA2318, 38092273683940512, 226856582, 226856590, 8, 1440x900 
0x37CA2318, 38092273684600712, 226856647, 226856655, 8, 1440x900 
0x37CA2318, 38092273685263888, 226856717, 226856725, 8, 1440x900 
0x37CA2318, 38092273685930160, 226856782, 226856790, 8, 1440x900 
0x37CA2318, 38092273686581248, 226856848, 226856856, 8, 1440x900 
0x37CA2318, 38092273687253664, 226856912, 226856920, 8, 1440x900 
0x37CA2318, 38092273687914360, 226856983, 226856991, 8, 1440x900 
0x37CA2318, 38092273688584664, 226857048, 226857057, 9, 1440x900 
0x37CA2318, 38092273689248856, 226857118, 226857126, 8, 1440x900 
0x37CA2318, 38092273689904208, 226857182, 226857190, 8, 1440x900 
0x37CA2318, 38092273690556312, 226857247, 226857255, 8, 1440x900 
0x37CA2318, 38092273691216328, 226857311, 226857318, 7, 1440x900 
0x37CA2318, 38092273691878872, 226857377, 226857385, 8, 1440x900 
0x37CA2318, 38092273692540008, 226857443, 226857451, 8, 1440x900 
0x37CA2318, 38092273693203616, 226857507, 226857514, 7, 1440x900 
0x37CA2318, 38092273693871696, 226857578, 226857586, 8, 1440x900 
0x37CA2318, 38092273694541048, 226857642, 226857650, 8, 1440x900 
0x37CA2318, 38092273695195424, 226857713, 226857721, 8, 1440x900 
0x37CA2318, 38092273695856720, 226857773, 226857780, 7, 1440x900 
0x37CA2318, 38092273696518632, 226857838, 226857846, 8, 1440x900 
0x37CA2318, 38092273697171584, 226857903, 226857911, 8, 1440x900 
0x37CA2318, 38092273697829504, 226857973, 226857980, 7, 1440x900 
0x37CA2318, 38092273698493240, 226858037, 226858044, 7, 1440x900 
0x37CA2318, 38092273699156224, 226858103, 226858111, 8, 1440x900 
0x37CA2318, 38092273699816280, 226858168, 226858174, 6, 1440x900 
0x37CA2318, 38092273700470120, 226858233, 226858241, 8, 1440x900 
0x37CA2318, 38092273701143776, 226858308, 226858315, 7, 1440x900 
0x37CA2318, 38092273701609656, 226858347, 226858354, 7, 1440x900 
0x37CA2318, 38092273702271912, 226858417, 226858425, 8, 1440x900 
0x37CA2318, 38092273702934040, 226858482, 226858490, 8, 1440x900 
0x37CA2318, 38092273703780096, 226858567, 226858575, 8, 1440x900 
0x37CA2318, 38092273704449512, 226858632, 226858640, 8, 1440x900 
0x37CA2318, 38092273705104600, 226858697, 226858706, 9, 1440x900 
0x37CA2318, 38092273705756488, 226858762, 226858771, 9, 1440x900 
0x37CA2318, 38092273706426632, 226858833, 226858841, 8, 1440x900 
0x37CA2318, 38092273707087400, 226858897, 226858905, 8, 1440x900 
0x37CA2318, 38092273707748704, 226858967, 226858975, 8, 1440x900 
0x37CA2318, 38092273708409360, 226859028, 226859036, 8, 1440x900 
0x37CA2318, 38092273709071672, 226859098, 226859106, 8, 1440x900 
0x37CA2318, 38092273709723784, 226859163, 226859171, 8, 1440x900 
0x37CA2318, 38092273710395200, 226859228, 226859236, 8, 1440x900 
0x37CA2318, 38092273711055088, 226859293, 226859301, 8, 1440x900 
0x37CA2318, 38092273711709504, 226859362, 226859370, 8, 1440x900 
0x37CA2318, 38092273712377264, 226859428, 226859436, 8, 1440x900 
0x37CA2318, 38092273713028576, 226859488, 226859496, 8, 1440x900 
0x37CA2318, 38092273713682848, 226859553, 226859561, 8, 1440x900 
0x37CA2318, 38092273714343736, 226859622, 226859629, 7, 1440x900 
0x37CA2318, 38092273715005176, 226859688, 226859696, 8, 1440x900 
0x37CA2318, 38092273715668032, 226859753, 226859762, 9, 1440x900 
0x37CA2318, 38092273716328216, 226859823, 226859831, 8, 1440x900 
0x37CA2318, 38092273716988432, 226859888, 226859896, 8, 1440x900 
0x37CA2318, 38092273717643736, 226859953, 226859961, 8, 1440x900 
0x37CA2318, 38092273718308792, 226860018, 226860026, 8, 1440x900 
0x37CA2318, 38092273718965088, 226860088, 226860096, 8, 1440x900 
0x37CA2318, 38092273719626456, 226860152, 226860160, 8, 1440x900 
0x37CA2318, 38092273720289096, 226860217, 226860225, 8, 1440x900 
0x37CA2318, 38092273720959904, 226860282, 226860291, 9, 1440x900 
0x37CA2318, 38092273721619512, 226860352, 226860360, 8, 1440x900 
0x37CA2318, 38092273722278048, 226860418, 226860426, 8, 1440x900 
0x37CA2318, 38092273722935728, 226860483, 226860490, 7, 1440x900 
0x37CA2318, 38092273723588464, 226860547, 226860555, 8, 1440x900 
0x37CA2318, 38092273724250016, 226860612, 226860620, 8, 1440x900 
0x37CA2318, 38092273724912144, 226860678, 226860687, 9, 1440x900 
0x37CA2318, 38092273725581776, 226860747, 226860754, 7, 1440x900 
0x37CA2318, 38092273726236232, 226860812, 226860820, 8, 1440x900 
0x37CA2318, 38092273726905888, 226860882, 226860890, 8, 1440x900 
0x37CA2318, 38092273727558440, 226860943, 226860952, 9, 1440x900 
0x37CA2318, 38092273728218248, 226861009, 226861017, 8, 1440x900 
0x37CA2318, 38092273728880528, 226861078, 226861086, 8, 1440x900 
0x37CA2318, 38092273729533504, 226861143, 226861151, 8, 1440x900 
0x37CA2318, 38092273730200944, 226861208, 226861216, 8, 1440x900 
0x37CA2318, 38092273730866504, 226861277, 226861285, 8, 1440x900 
0x37CA2318, 38092273731536064, 226861343, 226861351, 8, 1440x900 
0x37CA2318, 38092273732188200, 226861407, 226861415, 8, 1440x900 
0x37CA2318, 38092273732848216, 226861473, 226861482, 9, 1440x900 
0x37CA2318, 38092273733509248, 226861542, 226861550, 8, 1440x900 
0x37CA2318, 38092273734171552, 226861603, 226861610, 7, 1440x900 
0x37CA2318, 38092273734830856, 226861667, 226861675, 8, 1440x900 
0x37CA2318, 38092273735500808, 226861738, 226861745, 7, 1440x900 
0x37CA2318, 38092273736143592, 226861801, 226861808, 7, 1440x900 
0x37CA2318, 38092273736806216, 226861868, 226861876, 8, 1440x900 
0x37CA2318, 38092273737467648, 226861933, 226861940, 7, 1440x900 
0x37CA2318, 38092273738137832, 226862002, 226862010, 8, 1440x900 
0x37CA2318, 38092273738799688, 226862067, 226862076, 9, 1440x900 
0x37CA2318, 38092273739470888, 226862138, 226862145, 7, 1440x900 
0x37CA2318, 38092273740786896, 226862267, 226862275, 8, 1440x900 
0x37CA2318, 38092273741439456, 226862332, 226862340, 8, 1440x900 
0x37CA2318, 38092273742112128, 226862402, 226862410, 8, 1440x900 
0x37CA2318, 38092273742574008, 226862448, 226862456, 8, 1440x900 
0x37CA2318, 38092273743418024, 226862533, 226862541, 8, 1440x900 
0x37CA2318, 38092273744079720, 226862598, 226862606, 8, 1440x900 
0x37CA2318, 38092273744751480, 226862668, 226862677, 9, 1440x900 
0x37CA2318, 38092273745411040, 226862727, 226862734, 7, 1440x900 
0x37CA2318, 38092273746069688, 226862798, 226862806, 8, 1440x900 
0x37CA2318, 38092273746737112, 226862863, 226862871, 8, 1440x900 
0x37CA2318, 38092273747388864, 226862928, 226862936, 8, 1440x900 
0x37CA2318, 38092273748054200, 226862993, 226863000, 7, 1440x900 
0x37CA2318, 38092273748707752, 226863058, 226863066, 8, 1440x900 
0x37CA2318, 38092273749371024, 226863127, 226863135, 8, 1440x900 
0x37CA2318, 38092273750037856, 226863192, 226863200, 8, 1440x900 
0x37CA2318, 38092273750689152, 226863258, 226863266, 8, 1440x900 
0x37CA2318, 38092273751359352, 226863327, 226863335, 8, 1440x900 
0x37CA2318, 38092273752009336, 226863389, 226863397, 8, 1440x900 
0x37CA2318, 38092273752668648, 226863458, 226863466, 8, 1440x900 
0x37CA2318, 38092273753336896, 226863522, 226863529, 7, 1440x900 
0x37CA2318, 38092273753805080, 226863567, 226863574, 7, 1440x900 
0x37CA2318, 38092273754665896, 226863653, 226863660, 7, 1440x900 
0x37CA2318, 38092273755187496, 226863703, 226863712, 9, 1440x900 
0x37CA2318, 38092273755784568, 226863763, 226863770, 7, 1440x900 
0x37CA2318, 38092273756631640, 226863848, 226863856, 8, 1440x900 
0x37CA2318, 38092273757307280, 226863922, 226863930, 8, 1440x900 
0x37CA2318, 38092273757959672, 226863987, 226863995, 8, 1440x900 
0x37CA2318, 38092273758618560, 226864052, 226864060, 8, 1440x900 
0x37CA2318, 38092273759187328, 226864107, 226864114, 7, 1440x900 
0x37CA2318, 38092273759956984, 226864182, 226864189, 7, 1440x900 
0x37CA2318, 38092273760616656, 226864248, 226864255, 7, 1440x900 
0x37CA2318, 38092273761268200, 226864312, 226864319, 7, 1440x900 
0x37CA2318, 38092273761928288, 226864378, 226864386, 8, 1440x900 
0x37CA2318, 38092273762587536, 226864443, 226864451, 8, 1440x900 
0x37CA2318, 38092273763256096, 226864512, 226864519, 7, 1440x900 
0x37CA2318, 38092273763917968, 226864583, 226864591, 8, 1440x900 
0x37CA2318, 38092273764572656, 226864643, 226864652, 9, 1440x900 
0x37CA2318, 38092273765238520, 226864714, 226864722, 8, 1440x900 
0x37CA2318, 38092273765900744, 226864777, 226864785, 8, 1440x900 
0x37CA2318, 38092273766561296, 226864847, 226864855, 8, 1440x900 
0x37CA2318, 38092273767230800, 226864913, 226864921, 8, 1440x900 
0x37CA2318, 38092273767890152, 226864977, 226864985, 8, 1440x900 
0x37CA2318, 38092273768553200, 226865047, 226865055, 8, 1440x900 
0x37CA2318, 38092273769213728, 226865107, 226865116, 9, 1440x900 
0x37CA2318, 38092273769883656, 226865175, 226865184, 9, 1440x900 
0x37CA2318, 38092273770532888, 226865243, 226865251, 8, 1440x900 
0x37CA2318, 38092273771194528, 226865309, 226865317, 8, 1440x900 
0x37CA2318, 38092273771853696, 226865373, 226865381, 8, 1440x900 
0x37CA2318, 38092273772514752, 226865438, 226865447, 9, 1440x900 
0x37CA2318, 38092273773176304, 226865507, 226865515, 8, 1440x900 
0x37CA2318, 38092273773834368, 226865573, 226865581, 8, 1440x900 
0x37CA2318, 38092273774497896, 226865638, 226865646, 8, 1440x900 
0x37CA2318, 38092273775157376, 226865703, 226865711, 8, 1440x900 
0x37CA2318, 38092273775812080, 226865772, 226865780, 8, 1440x900 
0x37CA2318, 38092273776480288, 226865838, 226865846, 8, 1440x900 
0x37CA2318, 38092273777149984, 226865903, 226865911, 8, 1440x900 
0x37CA2318, 38092273777809056, 226865972, 226865980, 8, 1440x900 
0x37CA2318, 38092273778459736, 226866037, 226866045, 8, 1440x900 
0x37CA2318, 38092273779120936, 226866103, 226866111, 8, 1440x900 
0x37CA2318, 38092273779781912, 226866167, 226866175, 8, 1440x900 
0x37CA2318, 38092273780442200, 226866233, 226866241, 8, 1440x900 
0x37CA2318, 38092273781113104, 226866299, 226866307, 8, 1440x900 
0x37CA2318, 38092273781765776, 226866364, 226866372, 8, 1440x900 
0x37CA2318, 38092273782430304, 226866433, 226866441, 8, 1440x900 
0x37CA2318, 38092273783091744, 226866498, 226866506, 8, 1440x900 
0x37CA2318, 38092273783751816, 226866562, 226866570, 8, 1440x900 
0x37CA2318, 38092273784421296, 226866627, 226866634, 7, 1440x900 
0x37CA2318, 38092273785072152, 226866697, 226866705, 8, 1440x900 
0x37CA2318, 38092273785739720, 226866763, 226866771, 8, 1440x900 
0x37CA2318, 38092273786408456, 226866827, 226866835, 8, 1440x900 
0x37CA2318, 38092273787059672, 226866897, 226866904, 7, 1440x900 
0x37CA2318, 38092273787714944, 226866958, 226866965, 7, 1440x900 
0x37CA2318, 38092273788385992, 226867027, 226867035, 8, 1440x900 
0x37CA2318, 38092273789055296, 226867092, 226867099, 7, 1440x900 
0x37CA2318, 38092273789705792, 226867157, 226867164, 7, 1440x900 
0x37CA2318, 38092273790367872, 226867227, 226867234, 7, 1440x900 
0x37CA2318, 38092273791027808, 226867293, 226867302, 9, 1440x900 
0x37CA2318, 38092273791696352, 226867357, 226867364, 7, 1440x900 
0x37CA2318, 38092273792355808, 226867422, 226867429, 7, 1440x900 
0x37CA2318, 38092273793025400, 226867487, 226867495, 8, 1440x900 
0x37CA2318, 38092273793685288, 226867553, 226867561, 8, 1440x900 
0x37CA2318, 38092273794349768, 226867622, 226867630, 8, 1440x900 
0x37CA2318, 38092273795004368, 226867688, 226867694, 6, 1440x900 
0x37CA2318, 38092273795674208, 226867754, 226867762, 8, 1440x900 
0x37CA2318, 38092273796333536, 226867819, 226867827, 8, 1440x900 
0x37CA2318, 38092273797003088, 226867883, 226867891, 8, 1440x900 
0x37CA2318, 38092273797662680, 226867952, 226867959, 7, 1440x900 
0x37CA2318, 38092273798316744, 226868022, 226868030, 8, 1440x900 
0x37CA2318, 38092273798979280, 226868088, 226868096, 8, 1440x900 
0x37CA2318, 38092273799640304, 226868153, 226868161, 8, 1440x900 
0x37CA2318, 38092273800301120, 226868217, 226868225, 8, 1440x900 
0x37CA2318, 38092273800969984, 226868288, 226868296, 8, 1440x900 
0x37CA2318, 38092273801623992, 226868353, 226868361, 8, 1440x900 
0x37CA2318, 38092273802283880, 226868418, 226868427, 9, 1440x900 
0x37CA2318, 38092273802934592, 226868484, 226868492, 8, 1440x900 
0x37CA2318, 38092273803595824, 226868547, 226868554, 7, 1440x900 
0x37CA2318, 38092273804267560, 226868614, 226868622, 8, 1440x900 
0x37CA2318, 38092273804932088, 226868683, 226868691, 8, 1440x900 
0x37CA2318, 38092273805591848, 226868748, 226868756, 8, 1440x900 
0x37CA2318, 38092273806263240, 226868818, 226868826, 8, 1440x900 
0x37CA2318, 38092273806922856, 226868882, 226868890, 8, 1440x900 
0x37CA2318, 38092273807580912, 226868948, 226868955, 7, 1440x900 
0x37CA2318, 38092273808250408, 226869012, 226869019, 7, 1440x900 
0x37CA2318, 38092273808910016, 226869077, 226869084, 7, 1440x900 
0x37CA2318, 38092273809579456, 226869142, 226869149, 7, 1440x900 
0x37CA2318, 38092273810239224, 226869208, 226869216, 8, 1440x900 
0x37CA2318, 38092273810898928, 226869277, 226869285, 8, 1440x900 
0x37CA2318, 38092273811560376, 226869342, 226869349, 7, 1440x900 
0x37CA2318, 38092273812219840, 226869407, 226869414, 7, 1440x900 
0x37CA2318, 38092273812881880, 226869477, 226869484, 7, 1440x900 
0x37CA2318, 38092273813548608, 226869543, 226869551, 8, 1440x900 
0x37CA2318, 38092273814865384, 226869678, 226869686, 8, 1440x900 
0x37CA2318, 38092273815336112, 226869722, 226869730, 8, 1440x900 
0x37CA2318, 38092273816190288, 226869807, 226869815, 8, 1440x900 
0x37CA2318, 38092273816853232, 226869877, 226869885, 8, 1440x900 
0x37CA2318, 38092273817515272, 226869943, 226869951, 8, 1440x900 
0x37CA2318, 38092273818251120, 226870012, 226870020, 8, 1440x900 
0x37CA2318, 38092273818640080, 226870052, 226870059, 7, 1440x900 
0x37CA2318, 38092273819486184, 226870137, 226870144, 7, 1440x900 
0x37CA2318, 38092273820149216, 226870203, 226870210, 7, 1440x900 
0x37CA2318, 38092273820821216, 226870267, 226870276, 9, 1440x900 
0x37CA2318, 38092273821482712, 226870338, 226870345, 7, 1440x900 
0x37CA2318, 38092273822142960, 226870403, 226870411, 8, 1440x900 
0x37CA2318, 38092273822803728, 226870468, 226870476, 8, 1440x900 
0x37CA2318, 38092273823465440, 226870538, 226870546, 8, 1440x900 
0x37CA2318, 38092273824118160, 226870603, 226870611, 8, 1440x900 
0x37CA2318, 38092273824780528, 226870666, 226870673, 7, 1440x900 
0x37CA2318, 38092273825441280, 226870733, 226870741, 8, 1440x900 
0x37CA2318, 38092273826112544, 226870803, 226870811, 8, 1440x900 
0x37CA2318, 38092273826762904, 226870867, 226870875, 8, 1440x900 
0x37CA2318, 38092273827423952, 226870928, 226870938, 10, 1440x900 
0x37CA2318, 38092273828082000, 226870997, 226871006, 9, 1440x900 
0x37CA2318, 38092273828751792, 226871062, 226871070, 8, 1440x900 
0x37CA2318, 38092273829422528, 226871132, 226871140, 8, 1440x900 
0x37CA2318, 38092273830072744, 226871197, 226871205, 8, 1440x900 
0x37CA2318, 38092273830734840, 226871265, 226871275, 10, 1440x900 
0x37CA2318, 38092273831405232, 226871329, 226871337, 8, 1440x900 
0x37CA2318, 38092273832051520, 226871393, 226871401, 8, 1440x900 
0x37CA2318, 38092273832723920, 226871463, 226871471, 8, 1440x900 
0x37CA2318, 38092273833372416, 226871527, 226871535, 8, 1440x900 
0x37CA2318, 38092273834047264, 226871597, 226871605, 8, 1440x900 
0x37CA2318, 38092273834707144, 226871662, 226871670, 8, 1440x900 
0x37CA2318, 38092273835361592, 226871728, 226871736, 8, 1440x900 
0x37CA2318, 38092273836012584, 226871787, 226871795, 8, 1440x900 
0x37CA2318, 38092273836675088, 226871858, 226871866, 8, 1440x900 
0x37CA2318, 38092273837354832, 226871923, 226871932, 9, 1440x900 
0x37CA2318, 38092273838007640, 226871988, 226871996, 8, 1440x900 
0x37CA2318, 38092273838677440, 226872058, 226872066, 8, 1440x900 
0x37CA2318, 38092273839326640, 226872123, 226872131, 8, 1440x900 
0x37CA2318, 38092273839995416, 226872187, 226872194, 7, 1440x900 
0x37CA2318, 38092273840656880, 226872253, 226872261, 8, 1440x900 
0x37CA2318, 38092273841311840, 226872322, 226872330, 8, 1440x900 
0x37CA2318, 38092273841973920, 226872384, 226872394, 10, 1440x900 
0x37CA2318, 38092273842644592, 226872453, 226872461, 8, 1440x900 
0x37CA2318, 38092273843299960, 226872523, 226872531, 8, 1440x900 
0x37CA2318, 38092273843960616, 226872582, 226872591, 9, 1440x900 
0x37CA2318, 38092273844617736, 226872648, 226872657, 9, 1440x900 
0x37CA2318, 38092273845288080, 226872718, 226872726, 8, 1440x900 
0x37CA2318, 38092273845952928, 226872783, 226872791, 8, 1440x900 
0x37CA2318, 38092273846614288, 226872849, 226872857, 8, 1440x900 
0x37CA2318, 38092273847276104, 226872918, 226872926, 8, 1440x900 
0x37CA2318, 38092273847937480, 226872983, 226872991, 8, 1440x900 
0x37CA2318, 38092273848601904, 226873047, 226873055, 8, 1440x900 
0x37CA2318, 38092273849261712, 226873113, 226873120, 7, 1440x900 
0x37CA2318, 38092273849923008, 226873182, 226873190, 8, 1440x900 
0x37CA2318, 38092273850589856, 226873247, 226873255, 8, 1440x900 
0x37CA2318, 38092273851259432, 226873316, 226873324, 8, 1440x900 
0x37CA2318, 38092273851910568, 226873382, 226873390, 8, 1440x900 
0x37CA2318, 38092273852573136, 226873448, 226873456, 8, 1440x900 
0x37CA2318, 38092273853234112, 226873513, 226873520, 7, 1440x900 
0x37CA2318, 38092273853886408, 226873577, 226873585, 8, 1440x900 
0x37CA2318, 38092273854561496, 226873643, 226873652, 9, 1440x900 
0x37CA2318, 38092273855218192, 226873712, 226873720, 8, 1440x900 
0x37CA2318, 38092273855877280, 226873777, 226873785, 8, 1440x900 
0x37CA2318, 38092273856540056, 226873842, 226873851, 9, 1440x900 
0x37CA2318, 38092273857201224, 226873912, 226873920, 8, 1440x900 
0x37CA2318, 38092273857855264, 226873973, 226873982, 9, 1440x900 
0x37CA2318, 38092273858523936, 226874038, 226874047, 9, 1440x900 
0x37CA2318, 38092273859185472, 226874108, 226874116, 8, 1440x900 
0x37CA2318, 38092273859846440, 226874172, 226874180, 8, 1440x900 
0x37CA2318, 38092273860502168, 226874237, 226874245, 8, 1440x900 
0x37CA2318, 38092273861167920, 226874308, 226874316, 8, 1440x900 
0x37CA2318, 38092273861828952, 226874373, 226874381, 8, 1440x900 
0x37CA2318, 38092273862498552, 226874437, 226874445, 8, 1440x900 
0x37CA2318, 38092273863150192, 226874502, 226874510, 8, 1440x900 
0x37CA2318, 38092273863812472, 226874568, 226874576, 8, 1440x900 
0x37CA2318, 38092273864469448, 226874637, 226874645, 8, 1440x900 
0x37CA2318, 38092273865132040, 226874702, 226874710, 8, 1440x900 
0x37CA2318, 38092273865800368, 226874772, 226874780, 8, 1440x900 
0x37CA2318, 38092273866451416, 226874838, 226874847, 9, 1440x900 
0x37CA2318, 38092273867112992, 226874897, 226874906, 9, 1440x900 
0x37CA2318, 38092273867767280, 226874967, 226874975, 8, 1440x900 
0x37CA2318, 38092273868435976, 226875032, 226875040, 8, 1440x900 
0x37CA2318, 38092273869101760, 226875098, 226875106, 8, 1440x900 
0x37CA2318, 38092273869763432, 226875167, 226875174, 7, 1440x900 
0x37CA2318, 38092273870420608, 226875232, 226875240, 8, 1440x900 
0x37CA2318, 38092273871077152, 226875298, 226875306, 8, 1440x900 
0x37CA2318, 38092273871738576, 226875362, 226875370, 8, 1440x900 
0x37CA2318, 38092273872400144, 226875428, 226875437, 9, 1440x900 
0x37CA2318, 38092273873060152, 226875497, 226875505, 8, 1440x900 
0x37CA2318, 38092273873722760, 226875562, 226875570, 8, 1440x900 
0x37CA2318, 38092273874375496, 226875628, 226875636, 8, 1440x900 
0x37CA2318, 38092273875037312, 226875693, 226875701, 8, 1440x900 
0x37CA2318, 38092273875699520, 226875758, 226875767, 9, 1440x900 
0x37CA2318, 38092273876360280, 226875823, 226875831, 8, 1440x900 
0x37CA2318, 38092273877022088, 226875893, 226875901, 8, 1440x900 
0x37CA2318, 38092273877683952, 226875958, 226875966, 8, 1440x900 
0x37CA2318, 38092273878336968, 226876022, 226876030, 8, 1440x900 
0x37CA2318, 38092273879007224, 226876092, 226876100, 8, 1440x900 
0x37CA2318, 38092273879669752, 226876153, 226876162, 9, 1440x900 
0x37CA2318, 38092273880321008, 226876218, 226876225, 7, 1440x900 
0x37CA2318, 38092273880985744, 226876292, 226876300, 8, 1440x900 
0x37CA2318, 38092273881652896, 226876353, 226876361, 8, 1440x900 
0x37CA2318, 38092273882305792, 226876417, 226876426, 9, 1440x900 
0x37CA2318, 38092273882976464, 226876487, 226876495, 8, 1440x900 
0x37CA2318, 38092273883637376, 226876551, 226876559, 8, 1440x900 
0x37CA2318, 38092273884296168, 226876622, 226876630, 8, 1440x900 
0x37CA2318, 38092273884958400, 226876683, 226876691, 8, 1440x900 
0x37CA2318, 38092273885615488, 226876754, 226876761, 7, 1440x900 
0x37CA2318, 38092273886274992, 226876818, 226876826, 8, 1440x900 
0x37CA2318, 38092273886948096, 226876887, 226876895, 8, 1440x900 
0x37CA2318, 38092273887598448, 226876953, 226876961, 8, 1440x900 
0x37CA2318, 38092273888261064, 226877017, 226877025, 8, 1440x900 
0x37CA2318, 38092273888921944, 226877082, 226877089, 7, 1440x900 
0x37CA2318, 38092273890242328, 226877211, 226877219, 8, 1440x900 
0x37CA2318, 38092273890912288, 226877277, 226877285, 8, 1440x900 
0x37CA2318, 38092273891498928, 226877336, 226877344, 8, 1440x900 
0x37CA2318, 38092273892032960, 226877393, 226877400, 7, 1440x900 
0x37CA2318, 38092273892701200, 226877462, 226877470, 8, 1440x900 
0x37CA2318, 38092273893557816, 226877548, 226877556, 8, 1440x900 
0x37CA2318, 38092273894215392, 226877613, 226877621, 8, 1440x900 
0x37CA2318, 38092273894876808, 226877678, 226877686, 8, 1440x900 
0x37CA2318, 38092273895536184, 226877738, 226877746, 8, 1440x900 
0x37CA2318, 38092273896198288, 226877807, 226877815, 8, 1440x900 
0x37CA2318, 38092273896858168, 226877872, 226877880, 8, 1440x900 
0x37CA2318, 38092273897514320, 226877938, 226877945, 7, 1440x900 
0x37CA2318, 38092273898179120, 226878007, 226878015, 8, 1440x900 
0x37CA2318, 38092273898838464, 226878072, 226878080, 8, 1440x900 
0x37CA2318, 38092273899499096, 226878142, 226878150, 8, 1440x900 
0x37CA2318, 38092273900156856, 226878208, 226878216, 8, 1440x900 
0x37CA2318, 38092273900819048, 226878267, 226878275, 8, 1440x900 
0x37CA2318, 38092273901479496, 226878333, 226878342, 9, 1440x900 
0x37CA2318, 38092273902142520, 226878398, 226878406, 8, 1440x900 
0x37CA2318, 38092273902794536, 226878467, 226878474, 7, 1440x900 
0x37CA2318, 38092273903466224, 226878538, 226878545, 7, 1440x900 
0x37CA2318, 38092273904124960, 226878604, 226878612, 8, 1440x900 
0x37CA2318, 38092273904787904, 226878668, 226878676, 8, 1440x900 
0x37CA2318, 38092273905450704, 226878738, 226878746, 8, 1440x900 
0x37CA2318, 38092273906110528, 226878798, 226878805, 7, 1440x900 
0x37CA2318, 38092273906782112, 226878866, 226878874, 8, 1440x900 
0x37CA2318, 38092273907433328, 226878932, 226878940, 8, 1440x900 
0x37CA2318, 38092273908094800, 226878999, 226879007, 8, 1440x900 
0x37CA2318, 38092273908746168, 226879062, 226879071, 9, 1440x900 
0x37CA2318, 38092273909417312, 226879132, 226879140, 8, 1440x900 
0x37CA2318, 38092273910072280, 226879198, 226879206, 8, 1440x900 
0x37CA2318, 38092273910732944, 226879263, 226879271, 8, 1440x900 
0x37CA2318, 38092273911387016, 226879327, 226879335, 8, 1440x900 
0x37CA2318, 38092273912066664, 226879397, 226879404, 7, 1440x900 
0x37CA2318, 38092273912717728, 226879462, 226879470, 8, 1440x900 
0x37CA2318, 38092273913377672, 226879528, 226879536, 8, 1440x900 
0x37CA2318, 38092273914045536, 226879593, 226879601, 8, 1440x900 
0x37CA2318, 38092273914709872, 226879658, 226879666, 8, 1440x900 
0x37CA2318, 38092273915363472, 226879727, 226879735, 8, 1440x900 
0x37CA2318, 38092273916022272, 226879788, 226879796, 8, 1440x900 
0x37CA2318, 38092273916675200, 226879859, 226879867, 8, 1440x900 
0x37CA2318, 38092273917345112, 226879927, 226879935, 8, 1440x900 
0x37CA2318, 38092273917997800, 226879988, 226879997, 9, 1440x900 
0x37CA2318, 38092273918668728, 226880058, 226880066, 8, 1440x900 
0x37CA2318, 38092273919328760, 226880123, 226880131, 8, 1440x900 
0x37CA2318, 38092273919995824, 226880192, 226880200, 8, 1440x900 
0x37CA2318, 38092273920647712, 226880258, 226880266, 8, 1440x900 
0x37CA2318, 38092273921309712, 226880322, 226880330, 8, 1440x900 
0x37CA2318, 38092273921961256, 226880387, 226880395, 8, 1440x900 
0x37CA2318, 38092273922622544, 226880452, 226880460, 8, 1440x900 
0x37CA2318, 38092273923301696, 226880523, 226880531, 8, 1440x900 
0x37CA2318, 38092273923964000, 226880587, 226880595, 8, 1440x900 
0x37CA2318, 38092273924625272, 226880652, 226880660, 8, 1440x900 
0x37CA2318, 38092273925285704, 226880717, 226880725, 8, 1440x900 
0x37CA2318, 38092273925944920, 226880783, 226880791, 8, 1440x900 
0x37CA2318, 38092273926606224, 226880852, 226880860, 8, 1440x900 
0x37CA2318, 38092273927272672, 226880917, 226880925, 8, 1440x900 
0x37CA2318, 38092273927934664, 226880983, 226880992, 9, 1440x900 
0x37CA2318, 38092273928588456, 226881047, 226881055, 8, 1440x900 
0x37CA2318, 38092273929250320, 226881112, 226881119, 7, 1440x900 
0x37CA2318, 38092273929914368, 226881178, 226881185, 7, 1440x900 
0x37CA2318, 38092273930581376, 226881243, 226881251, 8, 1440x900 
0x37CA2318, 38092273931233936, 226881308, 226881316, 8, 1440x900 
0x37CA2318, 38092273931894624, 226881378, 226881386, 8, 1440x900 
0x37CA2318, 38092273932555552, 226881444, 226881452, 8, 1440x900 
0x37CA2318, 38092273933205440, 226881508, 226881515, 7, 1440x900 
0x37CA2318, 38092273933878416, 226881576, 226881584, 8, 1440x900 
0x37CA2318, 38092273934538376, 226881643, 226881650, 7, 1440x900 
0x37CA2318, 38092273935190304, 226881708, 226881715, 7, 1440x900 
0x37CA2318, 38092273935860208, 226881773, 226881780, 7, 1440x900 
0x37CA2318, 38092273936516728, 226881841, 226881849, 8, 1440x900 
0x37CA2318, 38092273937188056, 226881907, 226881915, 8, 1440x900 
0x37CA2318, 38092273937840312, 226881973, 226881981, 8, 1440x900 
0x37CA2318, 38092273938502960, 226882038, 226882047, 9, 1440x900 
0x37CA2318, 38092273939162904, 226882102, 226882109, 7, 1440x900 
0x37CA2318, 38092273939823328, 226882168, 226882175, 7, 1440x900 
0x37CA2318, 38092273940480712, 226882233, 226882241, 8, 1440x900 
0x37CA2318, 38092273941153288, 226882302, 226882309, 7, 1440x900 
0x37CA2318, 38092273941814888, 226882368, 226882376, 8, 1440x900 
0x37CA2318, 38092273942463920, 226882433, 226882439, 6, 1440x900 
0x37CA2318, 38092273943135728, 226882502, 226882510, 8, 1440x900 
0x37CA2318, 38092273943795672, 226882568, 226882575, 7, 1440x900 
0x37CA2318, 38092273944456400, 226882637, 226882645, 8, 1440x900 
0x37CA2318, 38092273945123256, 226882703, 226882711, 8, 1440x900 
0x37CA2318, 38092273945782872, 226882767, 226882775, 8, 1440x900 
0x37CA2318, 38092273946442048, 226882833, 226882841, 8, 1440x900 
0x37CA2318, 38092273947111680, 226882897, 226882905, 8, 1440x900 
0x37CA2318, 38092273947770632, 226882963, 226882970, 7, 1440x900 
0x37CA2318, 38092273948422584, 226883028, 226883035, 7, 1440x900 
0x37CA2318, 38092273949082104, 226883098, 226883106, 8, 1440x900 
0x37CA2318, 38092273949752416, 226883163, 226883170, 7, 1440x900 
0x37CA2318, 38092273950412216, 226883228, 226883235, 7, 1440x900 
0x37CA2318, 38092273951073336, 226883293, 226883301, 8, 1440x900 
0x37CA2318, 38092273951733616, 226883359, 226883366, 7, 1440x900 
0x37CA2318, 38092273952391744, 226883426, 226883433, 7, 1440x900 
0x37CA2318, 38092273953044672, 226883493, 226883500, 7, 1440x900 
0x37CA2318, 38092273953705568, 226883557, 226883564, 7, 1440x900 
0x37CA2318, 38092273954376680, 226883627, 226883634, 7, 1440x900 
0x37CA2318, 38092273955035840, 226883692, 226883699, 7, 1440x900 
0x37CA2318, 38092273955705264, 226883757, 226883764, 7, 1440x900 
0x37CA2318, 38092273956356648, 226883822, 226883829, 7, 1440x900 
0x37CA2318, 38092273957026016, 226883888, 226883896, 8, 1440x900 
0x37CA2318, 38092273957675304, 226883956, 226883963, 7, 1440x900 
0x37CA2318, 38092273958346680, 226884022, 226884029, 7, 1440x900 
0x37CA2318, 38092273959004808, 226884092, 226884100, 8, 1440x900 
0x37CA2318, 38092273959674368, 226884157, 226884166, 9, 1440x900 
0x37CA2318, 38092273960333152, 226884222, 226884229, 7, 1440x900 
0x37CA2318, 38092273961002576, 226884287, 226884294, 7, 1440x900 
0x37CA2318, 38092273961652600, 226884352, 226884358, 6, 1440x900 
0x37CA2318, 38092273962313808, 226884418, 226884425, 7, 1440x900 
0x37CA2318, 38092273962965400, 226884482, 226884489, 7, 1440x900 
0x37CA2318, 38092273963626672, 226884552, 226884559, 7, 1440x900 
0x37CA2318, 38092273964297472, 226884617, 226884624, 7, 1440x900 
0x37CA2318, 38092273964958128, 226884688, 226884696, 8, 1440x900 
0x37CA2318, 38092273965618752, 226884748, 226884755, 7, 1440x900 
0x37CA2318, 38092273966278888, 226884813, 226884822, 9, 1440x900 
0x37CA2318, 38092273966939808, 226884882, 226884889, 7, 1440x900 
0x37CA2318, 38092273967606432, 226884947, 226884955, 8, 1440x900 
0x37CA2318, 38092273968257896, 226885012, 226885019, 7, 1440x900 
0x37CA2318, 38092273969588496, 226885147, 226885155, 8, 1440x900 
0x37CA2318, 38092273970247760, 226885213, 226885220, 7, 1440x900 
0x37CA2318, 38092273970908992, 226885277, 226885285, 8, 1440x900 
0x37CA2318, 38092273971562736, 226885348, 226885356, 8, 1440x900 
0x37CA2318, 38092273972223680, 226885407, 226885415, 8, 1440x900 
0x37CA2318, 38092273972892824, 226885473, 226885480, 7, 1440x900 
0x37CA2318, 38092273973543216, 226885538, 226885545, 7, 1440x900 
0x37CA2318, 38092273974212640, 226885607, 226885614, 7, 1440x900 
0x37CA2318, 38092273974870152, 226885678, 226885686, 8, 1440x900 
0x37CA2318, 38092273975531024, 226885738, 226885746, 8, 1440x900 
0x37CA2318, 38092273976191648, 226885808, 226885816, 8, 1440x900 
0x37CA2318, 38092273976861768, 226885878, 226885886, 8, 1440x900 
0x37CA2318, 38092273977514016, 226885939, 226885946, 7, 1440x900 
0x37CA2318, 38092273978174696, 226886009, 226886017, 8, 1440x900 
0x37CA2318, 38092273978840720, 226886073, 226886081, 8, 1440x900 
0x37CA2318, 38092273979496048, 226886137, 226886144, 7, 1440x900 
0x37CA2318, 38092273980150944, 226886202, 226886210, 8, 1440x900 
0x37CA2318, 38092273980817744, 226886267, 226886274, 7, 1440x900 
0x37CA2318, 38092273981483824, 226886337, 226886344, 7, 1440x900 
0x37CA2318, 38092273982136016, 226886402, 226886410, 8, 1440x900 
0x37CA2318, 38092273982807280, 226886467, 226886474, 7, 1440x900 
0x37CA2318, 38092273983466976, 226886533, 226886541, 8, 1440x900 
0x37CA2318, 38092273984126504, 226886601, 226886609, 8, 1440x900 
0x37CA2318, 38092273984796016, 226886672, 226886680, 8, 1440x900 
0x37CA2318, 38092273985448336, 226886733, 226886741, 8, 1440x900 
0x37CA2318, 38092273986104384, 226886798, 226886807, 9, 1440x900 
0x37CA2318, 38092273986780480, 226886868, 226886877, 9, 1440x900 
0x37CA2318, 38092273987429688, 226886928, 226886936, 8, 1440x900 
0x37CA2318, 38092273988089560, 226886993, 226887000, 7, 1440x900 
0x37CA2318, 38092273988761448, 226887062, 226887069, 7, 1440x900 
0x37CA2318, 38092273989423232, 226887128, 226887136, 8, 1440x900 
0x37CA2318, 38092273990085096, 226887197, 226887205, 8, 1440x900 
0x37CA2318, 38092273990755904, 226887263, 226887270, 7, 1440x900 
0x37CA2318, 38092273991407712, 226887328, 226887336, 8, 1440x900 
0x37CA2318, 38092273992070504, 226887397, 226887404, 7, 1440x900 
0x37CA2318, 38092273992726432, 226887462, 226887470, 8, 1440x900 
0x37CA2318, 38092273993394552, 226887529, 226887536, 7, 1440x900 
0x37CA2318, 38092273994055952, 226887593, 226887601, 8, 1440x900 
0x37CA2318, 38092273994706544, 226887662, 226887668, 6, 1440x900 
0x37CA2318, 38092273995377264, 226887728, 226887735, 7, 1440x900 
0x37CA2318, 38092273996030272, 226887792, 226887800, 8, 1440x900 
0x37CA2318, 38092273996702912, 226887863, 226887871, 8, 1440x900 
0x37CA2318, 38092273997363336, 226887928, 226887936, 8, 1440x900 
0x37CA2318, 38092273998016992, 226887989, 226887997, 8, 1440x900 
0x37CA2318, 38092273998684048, 226888054, 226888062, 8, 1440x900 
0x37CA2318, 38092273999335440, 226888118, 226888126, 8, 1440x900 
0x37CA2318, 38092273999996712, 226888186, 226888193, 7, 1440x900 
0x37CA2318, 38092274000668464, 226888257, 226888265, 8, 1440x900 
0x37CA2318, 38092274001326120, 226888317, 226888325, 8, 1440x900 
0x37CA2318, 38092274001997176, 226888386, 226888393, 7, 1440x900 
0x37CA2318, 38092274002648064, 226888451, 226888458, 7, 1440x900 
0x37CA2318, 38092274003322416, 226888517, 226888525, 8, 1440x900 
0x37CA2318, 38092274003982136, 226888588, 226888596, 8, 1440x900 
0x37CA2318, 38092274004643168, 226888652, 226888660, 8, 1440x900 
0x37CA2318, 38092274005304208, 226888717, 226888725, 8, 1440x900 
0x37CA2318, 38092274005962904, 226888782, 226888790, 8, 1440x900 
0x37CA2318, 38092274006616592, 226888852, 226888860, 8, 1440x900 
0x37CA2318, 38092274007291248, 226888918, 226888926, 8, 1440x900 
0x37CA2318, 38092274007942584, 226888982, 226888990, 8, 1440x900 
0x37CA2318, 38092274008621448, 226889052, 226889060, 8, 1440x900 
0x37CA2318, 38092274009272440, 226889118, 226889126, 8, 1440x900 
0x37CA2318, 38092274009952184, 226889188, 226889196, 8, 1440x900 
0x37CA2318, 38092274010633712, 226889253, 226889261, 8, 1440x900 
0x37CA2318, 38092274011302496, 226889318, 226889326, 8, 1440x900 
0x37CA2318, 38092274011959304, 226889387, 226889395, 8, 1440x900 
0x37CA2318, 38092274012620184, 226889448, 226889455, 7, 1440x900 
0x37CA2318, 38092274013280664, 226889512, 226889520, 8, 1440x900 
0x37CA2318, 38092274013939736, 226889578, 226889587, 9, 1440x900 
0x37CA2318, 38092274014601792, 226889647, 226889654, 7, 1440x900 
0x37CA2318, 38092274015270624, 226889712, 226889719, 7, 1440x900 
0x37CA2318, 38092274015935544, 226889783, 226889790, 7, 1440x900 
0x37CA2318, 38092274016596544, 226889848, 226889855, 7, 1440x900 
0x37CA2318, 38092274017256248, 226889918, 226889925, 7, 1440x900 
0x37CA2318, 38092274017908368, 226889982, 226889990, 8, 1440x900 
0x37CA2318, 38092274018577000, 226890046, 226890053, 7, 1440x900 
0x37CA2318, 38092274019221632, 226890108, 226890116, 8, 1440x900 
0x37CA2318, 38092274019890752, 226890173, 226890181, 8, 1440x900 
0x37CA2318, 38092274020553400, 226890243, 226890251, 8, 1440x900 
0x37CA2318, 38092274021213960, 226890308, 226890317, 9, 1440x900 
0x37CA2318, 38092274021873104, 226890373, 226890380, 7, 1440x900 
0x37CA2318, 38092274022524232, 226890444, 226890452, 8, 1440x900 
0x37CA2318, 38092274023188328, 226890507, 226890514, 7, 1440x900 
0x37CA2318, 38092274023851128, 226890572, 226890580, 8, 1440x900 
0x37CA2318, 38092274024521744, 226890638, 226890645, 7, 1440x900 
0x37CA2318, 38092274025183064, 226890703, 226890711, 8, 1440x900 
0x37CA2318, 38092274025852144, 226890772, 226890779, 7, 1440x900 
0x37CA2318, 38092274026503224, 226890837, 226890845, 8, 1440x900 
0x37CA2318, 38092274027162392, 226890903, 226890910, 7, 1440x900 
0x37CA2318, 38092274027831744, 226890967, 226890974, 7, 1440x900 
0x37CA2318, 38092274028493640, 226891037, 226891045, 8, 1440x900 
0x37CA2318, 38092274029153888, 226891103, 226891111, 8, 1440x900 
0x37CA2318, 38092274029817360, 226891173, 226891181, 8, 1440x900 
0x37CA2318, 38092274030479776, 226891238, 226891246, 8, 1440x900 
0x37CA2318, 38092274031139656, 226891302, 226891308, 6, 1440x900 
0x37CA2318, 38092274031800432, 226891366, 226891374, 8, 1440x900 
0x37CA2318, 38092274032462432, 226891432, 226891439, 7, 1440x900 
0x37CA2318, 38092274033122528, 226891498, 226891505, 7, 1440x900 
0x37CA2318, 38092274033775048, 226891568, 226891575, 7, 1440x900 
0x37CA2318, 38092274034445912, 226891638, 226891646, 8, 1440x900 
0x37CA2318, 38092274035113184, 226891703, 226891711, 8, 1440x900 
0x37CA2318, 38092274035772760, 226891768, 226891776, 8, 1440x900 
0x37CA2318, 38092274036429688, 226891833, 226891841, 8, 1440x900 
0x37CA2318, 38092274037083064, 226891898, 226891906, 8, 1440x900 
0x37CA2318, 38092274037743408, 226891963, 226891971, 8, 1440x900 
0x37CA2318, 38092274038403096, 226892028, 226892036, 8, 1440x900 
0x37CA2318, 38092274039063208, 226892097, 226892105, 8, 1440x900 
0x37CA2318, 38092274039730160, 226892163, 226892171, 8, 1440x900 
0x37CA2318, 38092274040386904, 226892227, 226892235, 8, 1440x900 
0x37CA2318, 38092274041042000, 226892293, 226892301, 8, 1440x900 
0x37CA2318, 38092274041708312, 226892357, 226892366, 9, 1440x900 
0x37CA2318, 38092274042377560, 226892428, 226892436, 8, 1440x900 
0x37CA2318, 38092274043047656, 226892492, 226892499, 7, 1440x900 
0x37CA2318, 38092274043709264, 226892557, 226892564, 7, 1440x900 
0x37CA2318, 38092274044365144, 226892623, 226892630, 7, 1440x900 
0x37CA2318, 38092274045019496, 226892688, 226892695, 7, 1440x900 
0x37CA2318, 38092274045682552, 226892753, 226892761, 8, 1440x900 
0x37CA2318, 38092274046353392, 226892823, 226892831, 8, 1440x900 
0x37CA2318, 38092274047005952, 226892887, 226892895, 8, 1440x900 
0x37CA2318, 38092274047674936, 226892958, 226892966, 8, 1440x900 
0x37CA2318, 38092274048335200, 226893022, 226893030, 8, 1440x900 
0x37CA2318, 38092274049004816, 226893089, 226893097, 8, 1440x900 
0x37CA2318, 38092274049656944, 226893157, 226893165, 8, 1440x900 
0x37CA2318, 38092274050310312, 226893222, 226893230, 8, 1440x900 
0x37CA2318, 38092274050981872, 226893287, 226893295, 8, 1440x900 
0x37CA2318, 38092274051643752, 226893353, 226893362, 9, 1440x900 
0x37CA2318, 38092274052311984, 226893417, 226893424, 7, 1440x900 
0x37CA2318, 38092274053632960, 226893552, 226893559, 7, 1440x900 
0x37CA2318, 38092274054286168, 226893617, 226893625, 8, 1440x900 
0x37CA2318, 38092274054953232, 226893693, 226893701, 8, 1440x900 
0x37CA2318, 38092274055411560, 226893727, 226893734, 7, 1440x900 
0x37CA2318, 38092274056274520, 226893819, 226893827, 8, 1440x900 
0x37CA2318, 38092274056944440, 226893882, 226893891, 9, 1440x900 
0x37CA2318, 38092274057597664, 226893948, 226893955, 7, 1440x900 
0x37CA2318, 38092274058230744, 226894007, 226894016, 9, 1440x900 
0x37CA2318, 38092274058921248, 226894077, 226894085, 8, 1440x900 
0x37CA2318, 38092274059600256, 226894147, 226894154, 7, 1440x900 
0x37CA2318, 38092274060259680, 226894212, 226894219, 7, 1440x900 
0x37CA2318, 38092274060912352, 226894278, 226894285, 7, 1440x900 
0x37CA2318, 38092274061573192, 226894343, 226894350, 7, 1440x900 
0x37CA2318, 38092274062232224, 226894408, 226894416, 8, 1440x900 
0x37CA2318, 38092274062901152, 226894478, 226894486, 8, 1440x900 
0x37CA2318, 38092274063571464, 226894546, 226894553, 7, 1440x900 
0x37CA2318, 38092274064222920, 226894608, 226894617, 9, 1440x900 
0x37CA2318, 38092274064885192, 226894678, 226894687, 9, 1440x900 
0x37CA2318, 38092274065541552, 226894743, 226894751, 8, 1440x900 
0x37CA2318, 38092274066204400, 226894808, 226894816, 8, 1440x900 
0x37CA2318, 38092274066859904, 226894872, 226894881, 9, 1440x900 
0x37CA2318, 38092274067520752, 226894938, 226894947, 9, 1440x900 
0x37CA2318, 38092274068192800, 226895008, 226895016, 8, 1440x900 
0x37CA2318, 38092274068845240, 226895077, 226895085, 8, 1440x900 
0x37CA2318, 38092274069516824, 226895143, 226895151, 8, 1440x900 
0x37CA2318, 38092274070177728, 226895208, 226895216, 8, 1440x900 
0x37CA2318, 38092274070838016, 226895273, 226895281, 8, 1440x900 
0x37CA2318, 38092274071507560, 226895342, 226895349, 7, 1440x900 
0x37CA2318, 38092274072161592, 226895403, 226895411, 8, 1440x900 
0x37CA2318, 38092274072813376, 226895467, 226895473, 6, 1440x900 
0x37CA2318, 38092274073489792, 226895537, 226895544, 7, 1440x900 
0x37CA2318, 38092274074150560, 226895602, 226895609, 7, 1440x900 
0x37CA2318, 38092274074811328, 226895673, 226895681, 8, 1440x900 
0x37CA2318, 38092274075480760, 226895733, 226895741, 8, 1440x900 
0x37CA2318, 38092274076142408, 226895798, 226895806, 8, 1440x900 
0x37CA2318, 38092274076803600, 226895872, 226895881, 9, 1440x900 
0x37CA2318, 38092274077453496, 226895933, 226895940, 7, 1440x900 
0x37CA2318, 38092274078115736, 226895998, 226896005, 7, 1440x900 
0x37CA2318, 38092274078795728, 226896067, 226896074, 7, 1440x900 
0x37CA2318, 38092274079456032, 226896133, 226896141, 8, 1440x900 
0x37CA2318, 38092274080108800, 226896197, 226896205, 8, 1440x900 
0x37CA2318, 38092274080759096, 226896262, 226896269, 7, 1440x900 
0x37CA2318, 38092274081438432, 226896333, 226896341, 8, 1440x900 
0x37CA2318, 38092274082098752, 226896398, 226896406, 8, 1440x900 
0x37CA2318, 38092274082748688, 226896463, 226896472, 9, 1440x900 
0x37CA2318, 38092274083415736, 226896528, 226896537, 9, 1440x900 
0x37CA2318, 38092274084082160, 226896598, 226896606, 8, 1440x900 
0x37CA2318, 38092274084743672, 226896662, 226896670, 8, 1440x900 
0x37CA2318, 38092274085394552, 226896729, 226896737, 8, 1440x900 
0x37CA2318, 38092274086045792, 226896797, 226896805, 8, 1440x900 
0x37CA2318, 38092274086706840, 226896858, 226896867, 9, 1440x900 
0x37CA2318, 38092274087377496, 226896927, 226896935, 8, 1440x900 
0x37CA2318, 38092274088037168, 226896993, 226897001, 8, 1440x900 
0x37CA2318, 38092274088699424, 226897057, 226897065, 8, 1440x900 
0x37CA2318, 38092274089358256, 226897123, 226897131, 8, 1440x900 
0x37CA2318, 38092274090010056, 226897192, 226897200, 8, 1440x900 
0x37CA2318, 38092274090672752, 226897257, 226897265, 8, 1440x900 
0x37CA2318, 38092274091343448, 226897323, 226897331, 8, 1440x900 
0x37CA2318, 38092274092008040, 226897392, 226897400, 8, 1440x900 
0x37CA2318, 38092274092668784, 226897458, 226897466, 8, 1440x900 
0x37CA2318, 38092274093329528, 226897522, 226897530, 8, 1440x900 
0x37CA2318, 38092274093996256, 226897592, 226897600, 8, 1440x900 
0x37CA2318, 38092274094647656, 226897652, 226897660, 8, 1440x900 
0x37CA2318, 38092274095308768, 226897718, 226897725, 7, 1440x900 
0x37CA2318, 38092274095969928, 226897784, 226897792, 8, 1440x900 
0x37CA2318, 38092274096630064, 226897853, 226897861, 8, 1440x900 
0x37CA2318, 38092274097291840, 226897918, 226897926, 8, 1440x900 
0x37CA2318, 38092274097955848, 226897983, 226897991, 8, 1440x900 
0x37CA2318, 38092274098608944, 226898052, 226898060, 8, 1440x900 
0x37CA2318, 38092274099280696, 226898118, 226898126, 8, 1440x900 
0x37CA2318, 38092274099942992, 226898183, 226898191, 8, 1440x900 
0x37CA2318, 38092274100600104, 226898248, 226898256, 8, 1440x900 
0x37CA2318, 38092274101265680, 226898318, 226898326, 8, 1440x900 
0x37CA2318, 38092274101928288, 226898382, 226898390, 8, 1440x900 
0x37CA2318, 38092274102597736, 226898447, 226898456, 9, 1440x900 
0x37CA2318, 38092274103249264, 226898512, 226898520, 8, 1440x900 
0x37CA2318, 38092274103906144, 226898582, 226898590, 8, 1440x900 
0x37CA2318, 38092274104570472, 226898643, 226898652, 9, 1440x900 
0x37CA2318, 38092274105230496, 226898714, 226898722, 8, 1440x900 
0x37CA2318, 38092274105883744, 226898777, 226898785, 8, 1440x900 
0x37CA2318, 38092274106562768, 226898847, 226898855, 8, 1440x900 
0x37CA2318, 38092274107216016, 226898908, 226898917, 9, 1440x900 
0x37CA2318, 38092274107867816, 226898978, 226898986, 8, 1440x900 
0x37CA2318, 38092274108530720, 226899042, 226899051, 9, 1440x900 
0x37CA2318, 38092274109206536, 226899112, 226899120, 8, 1440x900 
0x37CA2318, 38092274109860856, 226899177, 226899185, 8, 1440x900 
0x37CA2318, 38092274110516216, 226899243, 226899251, 8, 1440x900 
0x37CA2318, 38092274111177352, 226899308, 226899316, 8, 1440x900 
0x37CA2318, 38092274111840384, 226899372, 226899380, 8, 1440x900 
0x37CA2318, 38092274112503104, 226899437, 226899445, 8, 1440x900 
0x37CA2318, 38092274113164120, 226899508, 226899516, 8, 1440x900 
0x37CA2318, 38092274113824928, 226899573, 226899581, 8, 1440x900 
0x37CA2318, 38092274114491760, 226899638, 226899646, 8, 1440x900 
0x37CA2318, 38092274115153048, 226899702, 226899710, 8, 1440x900 
0x37CA2318, 38092274115814560, 226899772, 226899780, 8, 1440x900 
0x37CA2318, 38092274116467456, 226899833, 226899842, 9, 1440x900 
0x37CA2318, 38092274117136696, 226899903, 226899911, 8, 1440x900 
0x37CA2318, 38092274117789136, 226899967, 226899975, 8, 1440x900 
0x37CA2318, 38092274118451000, 226900032, 226900040, 8, 1440x900 
0x37CA2318, 38092274119122016, 226900103, 226900110, 7, 1440x900 
0x37CA2318, 38092274119784000, 226900168, 226900176, 8, 1440x900 
0x37CA2318, 38092274120445920, 226900232, 226900239, 7, 1440x900 
0x37CA2318, 38092274121103336, 226900298, 226900307, 9, 1440x900 
0x37CA2318, 38092274121764384, 226900363, 226900372, 9, 1440x900 
0x37CA2318, 38092274122425704, 226900433, 226900441, 8, 1440x900 
0x37CA2318, 38092274123086488, 226900497, 226900505, 8, 1440x900 
0x37CA2318, 38092274123742192, 226900562, 226900571, 9, 1440x900 
0x37CA2318, 38092274124408016, 226900632, 226900640, 8, 1440x900 
0x37CA2318, 38092274125076816, 226900697, 226900705, 8, 1440x900 
0x37CA2318, 38092274125729696, 226900763, 226900771, 8, 1440x900 
0x37CA2318, 38092274126392728, 226900827, 226900835, 8, 1440x900 
0x37CA2318, 38092274127053624, 226900893, 226900901, 8, 1440x900 
0x37CA2318, 38092274127714912, 226900962, 226900970, 8, 1440x900 
0x37CA2318, 38092274128377032, 226901028, 226901036, 8, 1440x900 
0x37CA2318, 38092274129030368, 226901093, 226901101, 8, 1440x900 
0x37CA2318, 38092274129694712, 226901158, 226901167, 9, 1440x900 
0x37CA2318, 38092274130354712, 226901224, 226901232, 8, 1440x900 
0x37CA2318, 38092274131019968, 226901292, 226901300, 8, 1440x900 
0x37CA2318, 38092274131680584, 226901358, 226901366, 8, 1440x900 
0x37CA2318, 38092274132349752, 226901422, 226901429, 7, 1440x900 
0x37CA2318, 38092274133002112, 226901487, 226901494, 7, 1440x900 
0x37CA2318, 38092274133664552, 226901558, 226901566, 8, 1440x900 
0x37CA2318, 38092274134322560, 226901623, 226901631, 8, 1440x900 
0x37CA2318, 38092274134978760, 226901686, 226901693, 7, 1440x900 
0x37CA2318, 38092274135644272, 226901749, 226901757, 8, 1440x900 
0x37CA2318, 38092274136305152, 226901817, 226901824, 7, 1440x900 
0x37CA2318, 38092274137623424, 226901952, 226901960, 8, 1440x900 
0x37CA2318, 38092274138288464, 226902018, 226902026, 8, 1440x900 
0x37CA2318, 38092274138943216, 226902083, 226902091, 8, 1440x900 
0x37CA2318, 38092274139609560, 226902152, 226902160, 8, 1440x900 
0x37CA2318, 38092274140260280, 226902212, 226902219, 7, 1440x900 
0x37CA2318, 38092274140931464, 226902282, 226902290, 8, 1440x900 
0x37CA2318, 38092274141588768, 226902347, 226902355, 8, 1440x900 
0x37CA2318, 38092274142252560, 226902417, 226902425, 8, 1440x900 
0x37CA2318, 38092274142908480, 226902478, 226902486, 8, 1440x900 
0x37CA2318, 38092274143570512, 226902548, 226902556, 8, 1440x900 
0x37CA2318, 38092274144228528, 226902613, 226902621, 8, 1440x900 
0x37CA2318, 38092274144895400, 226902679, 226902687, 8, 1440x900 
0x37CA2318, 38092274145549304, 226902742, 226902750, 8, 1440x900 
0x37CA2318, 38092274146205664, 226902812, 226902820, 8, 1440x900 
0x37CA2318, 38092274146878128, 226902877, 226902885, 8, 1440x900 
0x37CA2318, 38092274147530840, 226902942, 226902950, 8, 1440x900 
0x37CA2318, 38092274148195744, 226903008, 226903016, 8, 1440x900 
0x37CA2318, 38092274148852656, 226903072, 226903080, 8, 1440x900 
0x37CA2318, 38092274149510368, 226903137, 226903146, 9, 1440x900 
0x37CA2318, 38092274150172664, 226903203, 226903212, 9, 1440x900 
0x37CA2318, 38092274150833344, 226903273, 226903282, 9, 1440x900 
0x37CA2318, 38092274151495504, 226903336, 226903343, 7, 1440x900 
0x37CA2318, 38092274152146664, 226903402, 226903409, 7, 1440x900 
0x37CA2318, 38092274152815256, 226903468, 226903475, 7, 1440x900 
0x37CA2318, 38092274153480544, 226903533, 226903541, 8, 1440x900 
0x37CA2318, 38092274154141104, 226903601, 226903609, 8, 1440x900 
0x37CA2318, 38092274154793728, 226903668, 226903676, 8, 1440x900 
0x37CA2318, 38092274155463000, 226903732, 226903740, 8, 1440x900 
0x37CA2318, 38092274156128384, 226903804, 226903813, 9, 1440x900 
0x37CA2318, 38092274156779480, 226903867, 226903875, 8, 1440x900 
0x37CA2318, 38092274157449816, 226903933, 226903941, 8, 1440x900 
0x37CA2318, 38092274158110736, 226904002, 226904010, 8, 1440x900 
0x37CA2318, 38092274158771584, 226904067, 226904075, 8, 1440x900 
0x37CA2318, 38092274159440968, 226904133, 226904142, 9, 1440x900 
0x37CA2318, 38092274160092728, 226904197, 226904205, 8, 1440x900 
0x37CA2318, 38092274160745720, 226904267, 226904275, 8, 1440x900 
0x37CA2318, 38092274161422776, 226904333, 226904341, 8, 1440x900 
0x37CA2318, 38092274162075528, 226904397, 226904405, 8, 1440x900 
0x37CA2318, 38092274162743984, 226904462, 226904470, 8, 1440x900 
0x37CA2318, 38092274163402128, 226904527, 226904535, 8, 1440x900 
0x37CA2318, 38092274164062808, 226904593, 226904602, 9, 1440x900 
0x37CA2318, 38092274164726344, 226904662, 226904670, 8, 1440x900 
0x37CA2318, 38092274165386296, 226904728, 226904737, 9, 1440x900 
0x37CA2318, 38092274166046416, 226904792, 226904799, 7, 1440x900 
0x37CA2318, 38092274166708632, 226904857, 226904864, 7, 1440x900 
0x37CA2318, 38092274167369400, 226904923, 226904930, 7, 1440x900 
0x37CA2318, 38092274168029224, 226904988, 226904996, 8, 1440x900 
0x37CA2318, 38092274168700752, 226905056, 226905064, 8, 1440x900 
0x37CA2318, 38092274169351072, 226905122, 226905130, 8, 1440x900 
0x37CA2318, 38092274170013816, 226905187, 226905195, 8, 1440x900 
0x37CA2318, 38092274170673912, 226905253, 226905260, 7, 1440x900 
0x37CA2318, 38092274171333520, 226905318, 226905326, 8, 1440x900 
0x37CA2318, 38092274171986168, 226905386, 226905394, 8, 1440x900 
0x37CA2318, 38092274172655728, 226905453, 226905461, 8, 1440x900 
0x37CA2318, 38092274173311520, 226905518, 226905526, 8, 1440x900 
0x37CA2318, 38092274173970632, 226905587, 226905595, 8, 1440x900 
0x37CA2318, 38092274174632272, 226905653, 226905661, 8, 1440x900 
0x37CA2318, 38092274175296864, 226905723, 226905731, 8, 1440x900 
0x37CA2318, 38092274175956032, 226905783, 226905792, 9, 1440x900 
0x37CA2318, 38092274176626288, 226905853, 226905860, 7, 1440x900 
0x37CA2318, 38092274177271112, 226905913, 226905920, 7, 1440x900 
0x37CA2318, 38092274177933504, 226905982, 226905990, 8, 1440x900 
0x37CA2318, 38092274178596976, 226906047, 226906056, 9, 1440x900 
0x37CA2318, 38092274179255024, 226906113, 226906122, 9, 1440x900 
0x37CA2318, 38092274179925624, 226906182, 226906190, 8, 1440x900 
0x37CA2318, 38092274180586424, 226906247, 226906255, 8, 1440x900 
0x37CA2318, 38092274181247552, 226906313, 226906321, 8, 1440x900 
0x37CA2318, 38092274181917096, 226906382, 226906390, 8, 1440x900 
0x37CA2318, 38092274182569800, 226906448, 226906456, 8, 1440x900 
0x37CA2318, 38092274183231384, 226906512, 226906520, 8, 1440x900 
0x37CA2318, 38092274183892824, 226906577, 226906585, 8, 1440x900 
0x37CA2318, 38092274184545168, 226906642, 226906651, 9, 1440x900 
0x37CA2318, 38092274185215920, 226906709, 226906717, 8, 1440x900 
0x37CA2318, 38092274185876672, 226906778, 226906786, 8, 1440x900 
0x37CA2318, 38092274186532600, 226906843, 226906852, 9, 1440x900 
0x37CA2318, 38092274187199744, 226906907, 226906915, 8, 1440x900 
0x37CA2318, 38092274187852832, 226906973, 226906982, 9, 1440x900 
0x37CA2318, 38092274188503480, 226907037, 226907045, 8, 1440x900 
0x37CA2318, 38092274189163744, 226907107, 226907117, 10, 1440x900 
0x37CA2318, 38092274189832360, 226907172, 226907180, 8, 1440x900 
0x37CA2318, 38092274190488944, 226907237, 226907245, 8, 1440x900 
0x37CA2318, 38092274191166752, 226907303, 226907312, 9, 1440x900 
0x37CA2318, 38092274191819672, 226907372, 226907380, 8, 1440x900 
0x37CA2318, 38092274192479936, 226907438, 226907446, 8, 1440x900 
0x37CA2318, 38092274193139288, 226907503, 226907511, 8, 1440x900 
0x37CA2318, 38092274193802272, 226907567, 226907576, 9, 1440x900 
0x37CA2318, 38092274194468944, 226907637, 226907645, 8, 1440x900 
0x37CA2318, 38092274195129056, 226907703, 226907711, 8, 1440x900 
0x37CA2318, 38092274195799440, 226907767, 226907775, 8, 1440x900 
0x37CA2318, 38092274196456768, 226907833, 226907842, 9, 1440x900 
0x37CA2318, 38092274197125896, 226907898, 226907906, 8, 1440x900 
0x37CA2318, 38092274197781928, 226907966, 226907974, 8, 1440x900 
0x37CA2318, 38092274198437088, 226908031, 226908039, 8, 1440x900 
0x37CA2318, 38092274199099248, 226908098, 226908106, 8, 1440x900 
0x37CA2318, 38092274199761608, 226908163, 226908171, 8, 1440x900 
0x37CA2318, 38092274200430200, 226908232, 226908240, 8, 1440x900 
0x37CA2318, 38092274201082688, 226908297, 226908305, 8, 1440x900 
0x37CA2318, 38092274201751744, 226908363, 226908371, 8, 1440x900 
0x37CA2318, 38092274202403904, 226908428, 226908436, 8, 1440x900 
0x37CA2318, 38092274203063376, 226908492, 226908501, 9, 1440x900 
0x37CA2318, 38092274203725056, 226908562, 226908570, 8, 1440x900 
0x37CA2318, 38092274204386512, 226908627, 226908635, 8, 1440x900 
0x37CA2318, 38092274205046888, 226908693, 226908701, 8, 1440x900 
0x37CA2318, 38092274205709208, 226908762, 226908770, 8, 1440x900 
0x37CA2318, 38092274206360592, 226908827, 226908835, 8, 1440x900 
0x37CA2318, 38092274207030352, 226908893, 226908901, 8, 1440x900 
0x37CA2318, 38092274207693616, 226908957, 226908965, 8, 1440x900 
0x37CA2318, 38092274208353232, 226909022, 226909030, 8, 1440x900 
0x37CA2318, 38092274209024320, 226909094, 226909102, 8, 1440x900 
0x37CA2318, 38092274209675528, 226909157, 226909165, 8, 1440x900 
0x37CA2318, 38092274210345312, 226909222, 226909230, 8, 1440x900 
0x37CA2318, 38092274210996312, 226909287, 226909296, 9, 1440x900 
0x37CA2318, 38092274211657112, 226909357, 226909365, 8, 1440x900 
0x37CA2318, 38092274212319776, 226909427, 226909435, 8, 1440x900 
0x37CA2318, 38092274212989224, 226909488, 226909496, 8, 1440x900 
0x37CA2318, 38092274213644272, 226909552, 226909560, 8, 1440x900 
0x37CA2318, 38092274214300440, 226909617, 226909625, 8, 1440x900 
0x37CA2318, 38092274215617488, 226909752, 226909760, 8, 1440x900 
0x37CA2318, 38092274216279648, 226909816, 226909824, 8, 1440x900 
0x37CA2318, 38092274216943184, 226909881, 226909889, 8, 1440x900 
0x37CA2318, 38092274217604192, 226909948, 226909956, 8, 1440x900 
0x37CA2318, 38092274218267040, 226910018, 226910026, 8, 1440x900 
0x37CA2318, 38092274218920152, 226910083, 226910091, 8, 1440x900 
0x37CA2318, 38092274219593144, 226910148, 226910156, 8, 1440x900 
0x37CA2318, 38092274220251904, 226910213, 226910222, 9, 1440x900 
0x37CA2318, 38092274220914864, 226910283, 226910291, 8, 1440x900 
0x37CA2318, 38092274221569032, 226910347, 226910355, 8, 1440x900 
0x37CA2318, 38092274222236184, 226910417, 226910425, 8, 1440x900 
0x37CA2318, 38092274222896720, 226910478, 226910486, 8, 1440x900 
0x37CA2318, 38092274223550040, 226910543, 226910551, 8, 1440x900 
0x37CA2318, 38092274224210672, 226910612, 226910621, 9, 1440x900 
0x37CA2318, 38092274224871320, 226910677, 226910685, 8, 1440x900 
0x37CA2318, 38092274225536752, 226910742, 226910751, 9, 1440x900 
0x37CA2318, 38092274226204352, 226910808, 226910816, 8, 1440x900 
0x37CA2318, 38092274226862520, 226910873, 226910880, 7, 1440x900 
0x37CA2318, 38092274227522768, 226910938, 226910945, 7, 1440x900 
0x37CA2318, 38092274228177080, 226911007, 226911015, 8, 1440x900 
0x37CA2318, 38092274228835000, 226911072, 226911080, 8, 1440x900 
0x37CA2318, 38092274229497216, 226911143, 226911151, 8, 1440x900 
0x37CA2318, 38092274230158944, 226911207, 226911215, 8, 1440x900 
0x37CA2318, 38092274230818416, 226911273, 226911281, 8, 1440x900 
0x37CA2318, 38092274231480048, 226911337, 226911345, 8, 1440x900 
0x37CA2318, 38092274232143000, 226911403, 226911411, 8, 1440x900 
0x37CA2318, 38092274232803264, 226911468, 226911476, 8, 1440x900 
0x37CA2318, 38092274233454824, 226911534, 226911542, 8, 1440x900 
0x37CA2318, 38092274234117024, 226911603, 226911611, 8, 1440x900 
0x37CA2318, 38092274234785336, 226911668, 226911676, 8, 1440x900 
0x37CA2318, 38092274235446896, 226911733, 226911741, 8, 1440x900 
0x37CA2318, 38092274236107048, 226911798, 226911807, 9, 1440x900 
0x37CA2318, 38092274236771096, 226911863, 226911872, 9, 1440x900 
0x37CA2318, 38092274237430936, 226911928, 226911936, 8, 1440x900 
0x37CA2318, 38092274238092192, 226911993, 226912001, 8, 1440x900 
0x37CA2318, 38092274238753104, 226912063, 226912071, 8, 1440x900 
0x37CA2318, 38092274239413240, 226912133, 226912141, 8, 1440x900 
0x37CA2318, 38092274240081816, 226912192, 226912199, 7, 1440x900 
0x37CA2318, 38092274240734752, 226912264, 226912272, 8, 1440x900 
0x37CA2318, 38092274241398912, 226912328, 226912337, 9, 1440x900 
0x37CA2318, 38092274242057992, 226912397, 226912405, 8, 1440x900 
0x37CA2318, 38092274242719048, 226912458, 226912467, 9, 1440x900 
0x37CA2318, 38092274243381312, 226912528, 226912536, 8, 1440x900 
0x37CA2318, 38092274244050000, 226912592, 226912600, 8, 1440x900 
0x37CA2318, 38092274244703208, 226912657, 226912666, 9, 1440x900 
0x37CA2318, 38092274245372904, 226912727, 226912735, 8, 1440x900 
0x37CA2318, 38092274246054960, 226912793, 226912802, 9, 1440x900 
0x37CA2318, 38092274246712400, 226912858, 226912867, 9, 1440x900 
0x37CA2318, 38092274247381480, 226912927, 226912934, 7, 1440x900 
0x37CA2318, 38092274248046024, 226912994, 226913002, 8, 1440x900 
0x37CA2318, 38092274248705672, 226913063, 226913071, 8, 1440x900 
0x37CA2318, 38092274249357416, 226913127, 226913135, 8, 1440x900 
0x37CA2318, 38092274250021504, 226913192, 226913200, 8, 1440x900 
0x37CA2318, 38092274250684112, 226913258, 226913266, 8, 1440x900 
0x37CA2318, 38092274251344784, 226913323, 226913331, 8, 1440x900 
0x37CA2318, 38092274252000480, 226913388, 226913396, 8, 1440x900 
0x37CA2318, 38092274252672472, 226913453, 226913462, 9, 1440x900 
0x37CA2318, 38092274253325312, 226913522, 226913530, 8, 1440x900 
0x37CA2318, 38092274253987520, 226913587, 226913595, 8, 1440x900 
0x37CA2318, 38092274254638840, 226913654, 226913662, 8, 1440x900 
0x37CA2318, 38092274255308184, 226913718, 226913726, 8, 1440x900 
0x37CA2318, 38092274255970976, 226913783, 226913792, 9, 1440x900 
0x37CA2318, 38092274256633152, 226913853, 226913861, 8, 1440x900 
0x37CA2318, 38092274257293328, 226913917, 226913925, 8, 1440x900 
0x37CA2318, 38092274257953120, 226913983, 226913991, 8, 1440x900 
0x37CA2318, 38092274258616272, 226914053, 226914061, 8, 1440x900 
0x37CA2318, 38092274259268624, 226914113, 226914120, 7, 1440x900 
0x37CA2318, 38092274259937952, 226914181, 226914189, 8, 1440x900 
0x37CA2318, 38092274260587184, 226914247, 226914255, 8, 1440x900 
0x37CA2318, 38092274261257192, 226914312, 226914320, 8, 1440x900 
0x37CA2318, 38092274261917368, 226914383, 226914391, 8, 1440x900 
0x37CA2318, 38092274262579768, 226914448, 226914456, 8, 1440x900 
0x37CA2318, 38092274263233232, 226914513, 226914521, 8, 1440x900 
0x37CA2318, 38092274263907032, 226914587, 226914594, 7, 1440x900 
0x37CA2318, 38092274264565408, 226914643, 226914650, 7, 1440x900 
0x37CA2318, 38092274265221744, 226914708, 226914715, 7, 1440x900 
0x37CA2318, 38092274265882544, 226914776, 226914784, 8, 1440x900 
0x37CA2318, 38092274266552360, 226914847, 226914855, 8, 1440x900 
0x37CA2318, 38092274267211592, 226914913, 226914921, 8, 1440x900 
0x37CA2318, 38092274267873224, 226914978, 226914987, 9, 1440x900 
0x37CA2318, 38092274268530176, 226915043, 226915051, 8, 1440x900 
0x37CA2318, 38092274269191680, 226915107, 226915115, 8, 1440x900 
0x37CA2318, 38092274269853848, 226915173, 226915182, 9, 1440x900 
0x37CA2318, 38092274270515536, 226915238, 226915245, 7, 1440x900 
0x37CA2318, 38092274271167296, 226915303, 226915311, 8, 1440x900 
0x37CA2318, 38092274271834960, 226915373, 226915381, 8, 1440x900 
0x37CA2318, 38092274272497344, 226915438, 226915446, 8, 1440x900 
0x37CA2318, 38092274273156968, 226915502, 226915511, 9, 1440x900 
0x37CA2318, 38092274273811360, 226915568, 226915577, 9, 1440x900 
0x37CA2318, 38092274274476768, 226915638, 226915646, 8, 1440x900 
0x37CA2318, 38092274275155464, 226915703, 226915711, 8, 1440x900 
0x37CA2318, 38092274275806792, 226915773, 226915781, 8, 1440x900 
0x37CA2318, 38092274276477768, 226915838, 226915846, 8, 1440x900 
0x37CA2318, 38092274277128552, 226915903, 226915911, 8, 1440x900 
0x37CA2318, 38092274277789600, 226915968, 226915977, 9, 1440x900 
0x37CA2318, 38092274278444608, 226916033, 226916041, 8, 1440x900 
0x37CA2318, 38092274279106336, 226916102, 226916110, 8, 1440x900 
0x37CA2318, 38092274279773760, 226916163, 226916172, 9, 1440x900 
0x37CA2318, 38092274280437800, 226916232, 226916240, 8, 1440x900 
0x37CA2318, 38092274281099824, 226916298, 226916306, 8, 1440x900 
0x37CA2318, 38092274281758016, 226916363, 226916371, 8, 1440x900 
0x37CA2318, 38092274282420328, 226916428, 226916439, 11, 1440x900 
0x37CA2318, 38092274283087272, 226916497, 226916505, 8, 1440x900 
0x37CA2318, 38092274283739128, 226916563, 226916571, 8, 1440x900 
0x37CA2318, 38092274284410672, 226916628, 226916636, 8, 1440x900 
0x37CA2318, 38092274285061728, 226916693, 226916701, 8, 1440x900 
0x37CA2318, 38092274285731904, 226916763, 226916771, 8, 1440x900 
0x37CA2318, 38092274286376896, 226916827, 226916835, 8, 1440x900 
0x37CA2318, 38092274287036840, 226916893, 226916901, 8, 1440x900 
0x37CA2318, 38092274287699112, 226916957, 226916966, 9, 1440x900 
0x37CA2318, 38092274288370904, 226917027, 226917035, 8, 1440x900 
0x37CA2318, 38092274289031928, 226917093, 226917101, 8, 1440x900 
0x37CA2318, 38092274289682856, 226917157, 226917165, 8, 1440x900 
0x37CA2318, 38092274290345048, 226917223, 226917231, 8, 1440x900 
0x37CA2318, 38092274291015400, 226917293, 226917300, 7, 1440x900 
0x37CA2318, 38092274291679008, 226917353, 226917361, 8, 1440x900 
0x37CA2318, 38092274292343904, 226917424, 226917431, 7, 1440x900 
0x37CA2318, 38092274293007464, 226917487, 226917494, 7, 1440x900 
0x37CA2318, 38092274293660680, 226917552, 226917560, 8, 1440x900 
0x37CA2318, 38092274294325760, 226917618, 226917626, 8, 1440x900 
0x37CA2318, 38092274294977008, 226917683, 226917691, 8, 1440x900 
0x37CA2318, 38092274295639760, 226917751, 226917759, 8, 1440x900 
0x37CA2318, 38092274296301344, 226917816, 226917824, 8, 1440x900 
0x37CA2318, 38092274297623104, 226917949, 226917957, 8, 1440x900 
0x37CA2318, 38092274298283448, 226918019, 226918027, 8, 1440x900 
0x37CA2318, 38092274298938488, 226918081, 226918088, 7, 1440x900 
0x37CA2318, 38092274299601936, 226918148, 226918156, 8, 1440x900 
0x37CA2318, 38092274300269104, 226918217, 226918225, 8, 1440x900 
0x37CA2318, 38092274300933632, 226918283, 226918291, 8, 1440x900 
0x37CA2318, 38092274301587872, 226918348, 226918356, 8, 1440x900 
0x37CA2318, 38092274302254272, 226918417, 226918425, 8, 1440x900 
0x37CA2318, 38092274302923912, 226918483, 226918491, 8, 1440x900 
0x37CA2318, 38092274303574824, 226918549, 226918557, 8, 1440x900 
0x37CA2318, 38092274304236104, 226918613, 226918621, 8, 1440x900 
0x37CA2318, 38092274304904032, 226918682, 226918690, 8, 1440x900 
0x37CA2318, 38092274305564640, 226918743, 226918752, 9, 1440x900 
0x37CA2318, 38092274306215856, 226918812, 226918820, 8, 1440x900 
0x37CA2318, 38092274306878504, 226918878, 226918886, 8, 1440x900 
0x37CA2318, 38092274307537904, 226918943, 226918952, 9, 1440x900 
0x37CA2318, 38092274308190624, 226919007, 226919016, 9, 1440x900 
0x37CA2318, 38092274308852384, 226919072, 226919080, 8, 1440x900 
0x37CA2318, 38092274309522312, 226919138, 226919146, 8, 1440x900 
0x37CA2318, 38092274310176424, 226919207, 226919215, 8, 1440x900 
0x37CA2318, 38092274310841864, 226919272, 226919281, 9, 1440x900 
0x37CA2318, 38092274311504192, 226919337, 226919345, 8, 1440x900 
0x37CA2318, 38092274312173192, 226919408, 226919416, 8, 1440x900 
0x37CA2318, 38092274312823744, 226919473, 226919481, 8, 1440x900 
0x37CA2318, 38092274313482712, 226919538, 226919546, 8, 1440x900 
0x37CA2318, 38092274314147408, 226919602, 226919610, 8, 1440x900 
0x37CA2318, 38092274314814200, 226919668, 226919676, 8, 1440x900 
0x37CA2318, 38092274315465856, 226919733, 226919742, 9, 1440x900 
0x37CA2318, 38092274316142160, 226919802, 226919810, 8, 1440x900 
0x37CA2318, 38092274316794312, 226919868, 226919876, 8, 1440x900 
0x37CA2318, 38092274317453200, 226919937, 226919945, 8, 1440x900 
0x37CA2318, 38092274318123816, 226920002, 226920010, 8, 1440x900 
0x37CA2318, 38092274318774544, 226920067, 226920074, 7, 1440x900 
0x37CA2318, 38092274319428464, 226920128, 226920136, 8, 1440x900 
0x37CA2318, 38092274320089728, 226920196, 226920203, 7, 1440x900 
0x37CA2318, 38092274320758008, 226920263, 226920271, 8, 1440x900 
0x37CA2318, 38092274321414136, 226920332, 226920341, 9, 1440x900 
0x37CA2318, 38092274322083792, 226920399, 226920406, 7, 1440x900 
0x37CA2318, 38092274322739240, 226920463, 226920471, 8, 1440x900 
0x37CA2318, 38092274323401624, 226920528, 226920537, 9, 1440x900 
0x37CA2318, 38092274324061640, 226920592, 226920601, 9, 1440x900 
0x37CA2318, 38092274324720736, 226920662, 226920670, 8, 1440x900 
0x37CA2318, 38092274325376104, 226920728, 226920736, 8, 1440x900 
0x37CA2318, 38092274326039448, 226920792, 226920800, 8, 1440x900 
0x37CA2318, 38092274326700656, 226920857, 226920866, 9, 1440x900 
0x37CA2318, 38092274327361000, 226920923, 226920932, 9, 1440x900 
0x37CA2318, 38092274328022984, 226920992, 226921000, 8, 1440x900 
0x37CA2318, 38092274328689264, 226921057, 226921065, 8, 1440x900 
0x37CA2318, 38092274329359080, 226921122, 226921130, 8, 1440x900 
0x37CA2318, 38092274330018992, 226921192, 226921200, 8, 1440x900 
0x37CA2318, 38092274330669920, 226921253, 226921262, 9, 1440x900 
0x37CA2318, 38092274331340016, 226921323, 226921331, 8, 1440x900 
0x37CA2318, 38092274331999616, 226921387, 226921396, 9, 1440x900 
0x37CA2318, 38092274332659328, 226921453, 226921461, 8, 1440x900 
0x37CA2318, 38092274333310352, 226921517, 226921524, 7, 1440x900 
0x37CA2318, 38092274333972448, 226921587, 226921595, 8, 1440x900 
0x37CA2318, 38092274334635384, 226921652, 226921660, 8, 1440x900 
0x37CA2318, 38092274335294888, 226921717, 226921724, 7, 1440x900 
0x37CA2318, 38092274335956072, 226921788, 226921796, 8, 1440x900 
0x37CA2318, 38092274336624800, 226921853, 226921860, 7, 1440x900 
0x37CA2318, 38092274337274216, 226921918, 226921926, 8, 1440x900 
0x37CA2318, 38092274337935080, 226921983, 226921991, 8, 1440x900 
0x37CA2318, 38092274338597136, 226922048, 226922056, 8, 1440x900 
0x37CA2318, 38092274339266128, 226922117, 226922125, 8, 1440x900 
0x37CA2318, 38092274339934144, 226922179, 226922187, 8, 1440x900 
0x37CA2318, 38092274340588320, 226922247, 226922256, 9, 1440x900 
0x37CA2318, 38092274341241384, 226922313, 226922321, 8, 1440x900 
0x37CA2318, 38092274341921824, 226922382, 226922390, 8, 1440x900 
0x37CA2318, 38092274342545568, 226922442, 226922451, 9, 1440x900 
0x37CA2318, 38092274343231232, 226922509, 226922516, 7, 1440x900 
0x37CA2318, 38092274343902496, 226922578, 226922585, 7, 1440x900 
0x37CA2318, 38092274344564592, 226922643, 226922651, 8, 1440x900 
0x37CA2318, 38092274345216080, 226922713, 226922721, 8, 1440x900 
0x37CA2318, 38092274345888296, 226922778, 226922786, 8, 1440x900 
0x37CA2318, 38092274346558992, 226922848, 226922856, 8, 1440x900 
0x37CA2318, 38092274347203504, 226922913, 226922921, 8, 1440x900 
0x37CA2318, 38092274347874192, 226922978, 226922986, 8, 1440x900 
0x37CA2318, 38092274348535528, 226923042, 226923050, 8, 1440x900 
0x37CA2318, 38092274349195888, 226923113, 226923121, 8, 1440x900 
0x37CA2318, 38092274349865624, 226923177, 226923185, 8, 1440x900 
0x37CA2318, 38092274350519552, 226923238, 226923247, 9, 1440x900 
0x37CA2318, 38092274351187456, 226923307, 226923316, 9, 1440x900 
0x37CA2318, 38092274351848752, 226923372, 226923379, 7, 1440x900 
0x37CA2318, 38092274352501120, 226923437, 226923444, 7, 1440x900 
0x37CA2318, 38092274353160856, 226923503, 226923510, 7, 1440x900 
0x37CA2318, 38092274353813160, 226923567, 226923574, 7, 1440x900 
0x37CA2318, 38092274354483944, 226923633, 226923642, 9, 1440x900 
0x37CA2318, 38092274355149760, 226923709, 226923717, 8, 1440x900 
0x37CA2318, 38092274356270336, 226923813, 226923819, 6, 1440x900 
0x37CA2318, 38092274357122544, 226923902, 226923910, 8, 1440x900 
0x37CA2318, 38092274357782384, 226923963, 226923971, 8, 1440x900 
0x37CA2318, 38092274358451920, 226924032, 226924039, 7, 1440x900 
0x37CA2318, 38092274359111664, 226924097, 226924104, 7, 1440x900 
0x37CA2318, 38092274359774176, 226924163, 226924171, 8, 1440x900 
0x37CA2318, 38092274360427352, 226924232, 226924240, 8, 1440x900 
0x37CA2318, 38092274361081432, 226924298, 226924307, 9, 1440x900 
0x37CA2318, 38092274361747048, 226924362, 226924369, 7, 1440x900 
0x37CA2318, 38092274362213768, 226924408, 226924415, 7, 1440x900 
0x37CA2318, 38092274363075832, 226924493, 226924501, 8, 1440x900 
0x37CA2318, 38092274363745424, 226924562, 226924569, 7, 1440x900 
0x37CA2318, 38092274364406520, 226924627, 226924634, 7, 1440x900 
0x37CA2318, 38092274365053968, 226924693, 226924702, 9, 1440x900 
0x37CA2318, 38092274365727944, 226924758, 226924765, 7, 1440x900 
0x37CA2318, 38092274366383472, 226924828, 226924836, 8, 1440x900 
0x37CA2318, 38092274367053384, 226924892, 226924901, 9, 1440x900 
0x37CA2318, 38092274367707752, 226924958, 226924966, 8, 1440x900 
0x37CA2318, 38092274368362960, 226925023, 226925031, 8, 1440x900 
0x37CA2318, 38092274369025768, 226925092, 226925100, 8, 1440x900 
0x37CA2318, 38092274369690272, 226925164, 226925172, 8, 1440x900 
0x37CA2318, 38092274370338912, 226925222, 226925229, 7, 1440x900 
0x37CA2318, 38092274371006360, 226925292, 226925300, 8, 1440x900 
0x37CA2318, 38092274371677128, 226925358, 226925366, 8, 1440x900 
0x37CA2318, 38092274373648328, 226925557, 226925819, 262, 960x600 
0x37CA2318, 38092274374301856, 226925867, 226925935, 68, 960x600 
0x37CA2318, 38092274376619744, 226925935, 226925938, 3, 960x600 
0x37CA2318, 38092274377612976, 226925951, 226925971, 20, 960x600 
0x37CA2318, 38092274378293248, 226926026, 226926031, 5, 960x600 
0x37CA2318, 38092274378942128, 226926086, 226926106, 20, 960x600 
0x37CA2318, 38092274379612176, 226926156, 226926161, 5, 960x600 
0x37CA2318, 38092274380275712, 226926221, 226926227, 6, 960x600 
0x37CA2318, 38092274380945296, 226926287, 226926292, 5, 960x600 
0x37CA2318, 38092274381604664, 226926351, 226926355, 4, 960x600 
0x37CA2318, 38092274382256816, 226926421, 226926428, 7, 960x600 
0x37CA2318, 38092274382925256, 226926491, 226926502, 11, 960x600 
0x37CA2318, 38092274383585952, 226926552, 226926557, 5, 960x600 
0x37CA2318, 38092274384227520, 226926611, 226926616, 5, 960x600 
0x37CA2318, 38092274384898600, 226926687, 226926692, 5, 960x600 
0x37CA2318, 38092274385568016, 226926747, 226926751, 4, 960x600 
0x37CA2318, 38092274386209952, 226926811, 226926815, 4, 960x600 
0x37CA2318, 38092274386890040, 226926877, 226926881, 4, 960x600 
0x37CA2318, 38092274387541184, 226926942, 226926946, 4, 960x600 
0x37CA2318, 38092274388195696, 226927011, 226927016, 5, 960x600 
0x37CA2318, 38092274388859152, 226927087, 226927092, 5, 960x600 
0x37CA2318, 38092274389538016, 226927152, 226927158, 6, 960x600 
0x37CA2318, 38092274390183200, 226927217, 226927223, 6, 960x600 
0x37CA2318, 38092274390854880, 226927287, 226927292, 5, 960x600 
0x37CA2318, 38092274391515424, 226927348, 226927353, 5, 960x600 
0x37CA2318, 38092274392169856, 226927417, 226927423, 6, 960x600 
0x37CA2318, 38092274392830448, 226927482, 226927488, 6, 960x600 
0x37CA2318, 38092274393490624, 226927546, 226927552, 6, 960x600 
0x37CA2318, 38092274394160608, 226927617, 226927623, 6, 960x600 
0x37CA2318, 38092274394816096, 226927682, 226927687, 5, 960x600 
0x37CA2318, 38092274395474664, 226927747, 226927753, 6, 960x600 
0x37CA2318, 38092274396135120, 226927812, 226927818, 6, 960x600 
0x37CA2318, 38092274396795032, 226927877, 226927883, 6, 960x600 
0x37CA2318, 38092274397451304, 226927946, 226927952, 6, 960x600 
0x37CA2318, 38092274398121808, 226928011, 226928017, 6, 960x600 
0x37CA2318, 38092274398790448, 226928077, 226928082, 5, 960x600 
0x37CA2318, 38092274399440880, 226928132, 226928137, 5, 960x600 
0x37CA2318, 38092274400101480, 226928201, 226928207, 6, 960x600 
0x37CA2318, 38092274400770688, 226928276, 226928282, 6, 960x600 
0x37CA2318, 38092274401424152, 226928341, 226928347, 6, 960x600 
0x37CA2318, 38092274402084432, 226928402, 226928407, 5, 960x600 
0x37CA2318, 38092274402737592, 226928466, 226928471, 5, 960x600 
0x37CA2318, 38092274403406360, 226928537, 226928543, 6, 960x600 
0x37CA2318, 38092274404067864, 226928606, 226928612, 6, 960x600 
0x37CA2318, 38092274404729024, 226928672, 226928677, 5, 960x600 
0x37CA2318, 38092274405390176, 226928732, 226928737, 5, 960x600 
0x37CA2318, 38092274406041192, 226928792, 226928796, 4, 960x600 
0x37CA2318, 38092274406710032, 226928861, 226928866, 5, 960x600 
0x37CA2318, 38092274407370608, 226928932, 226928936, 4, 960x600 
0x37CA2318, 38092274408040160, 226928996, 226929000, 4, 960x600 
0x37CA2318, 38092274408699888, 226929062, 226929066, 4, 960x600 
0x37CA2318, 38092274409369568, 226929132, 226929136, 4, 960x600 
0x37CA2318, 38092274410019160, 226929192, 226929196, 4, 960x600 
0x37CA2318, 38092274410698592, 226929261, 226929265, 4, 960x600 
0x37CA2318, 38092274411358336, 226929327, 226929331, 4, 960x600 
0x37CA2318, 38092274412027976, 226929397, 226929401, 4, 960x600 
0x37CA2318, 38092274412678032, 226929457, 226929461, 4, 960x600 
0x37CA2318, 38092274413347584, 226929527, 226929531, 4, 960x600 
0x37CA2318, 38092274414017864, 226929597, 226929601, 4, 960x600 
0x37CA2318, 38092274414676792, 226929661, 226929665, 4, 960x600 
0x37CA2318, 38092274415337808, 226929726, 226929730, 4, 960x600 
0x37CA2318, 38092274415997192, 226929792, 226929796, 4, 960x600 
0x37CA2318, 38092274416667704, 226929862, 226929866, 4, 960x600 
0x37CA2318, 38092274417326432, 226929922, 226929926, 4, 960x600 
0x37CA2318, 38092274417996048, 226929997, 226930001, 4, 960x600 
0x37CA2318, 38092274418665728, 226930057, 226930061, 4, 960x600 
0x37CA2318, 38092274419325472, 226930126, 226930130, 4, 960x600 
0x37CA2318, 38092274419986312, 226930187, 226930191, 4, 960x600 
0x37CA2318, 38092274420637904, 226930256, 226930261, 5, 960x600 
0x37CA2318, 38092274421299656, 226930326, 226930331, 5, 960x600 
0x37CA2318, 38092274421959712, 226930387, 226930392, 5, 960x600 
0x37CA2318, 38092274422611360, 226930452, 226930457, 5, 960x600 
0x37CA2318, 38092274423273928, 226930528, 226930533, 5, 960x600 
0x37CA2318, 38092274423944488, 226930592, 226930597, 5, 960x600 
0x37CA2318, 38092274424615184, 226930661, 226930666, 5, 960x600 
0x37CA2318, 38092274425256752, 226930726, 226930732, 6, 960x600 
0x37CA2318, 38092274425927016, 226930797, 226930802, 5, 960x600 
0x37CA2318, 38092274426587664, 226930861, 226930867, 6, 960x600 
0x37CA2318, 38092274427248320, 226930921, 226930927, 6, 960x600 
0x37CA2318, 38092274427908752, 226930987, 226930993, 6, 960x600 
0x37CA2318, 38092274428563560, 226931057, 226931062, 5, 960x600 
0x37CA2318, 38092274429233232, 226931122, 226931127, 5, 960x600 
0x37CA2318, 38092274429889400, 226931187, 226931192, 5, 960x600 
0x37CA2318, 38092274430551392, 226931257, 226931263, 6, 960x600 
0x37CA2318, 38092274431212896, 226931312, 226931317, 5, 960x600 
0x37CA2318, 38092274431873952, 226931382, 226931387, 5, 960x600 
0x37CA2318, 38092274432526432, 226931447, 226931453, 6, 960x600 
0x37CA2318, 38092274433193072, 226931516, 226931522, 6, 960x600 
0x37CA2318, 38092274433844936, 226931584, 226931589, 5, 960x600 
0x37CA2318, 38092274434516280, 226931651, 226931657, 6, 960x600 
0x37CA2318, 38092274435185544, 226931717, 226931762, 45, 960x600 
0x37CA2318, 38092274436018832, 226931801, 226931807, 6, 960x600 
0x37CA2318, 38092274436497792, 226931852, 226931857, 5, 960x600 
0x37CA2318, 38092274437167088, 226931917, 226931923, 6, 960x600 
0x37CA2318, 38092274437818840, 226931981, 226931987, 6, 960x600 
0x37CA2318, 38092274438484264, 226932047, 226932052, 5, 960x600 
0x37CA2318, 38092274439136248, 226932107, 226932112, 5, 960x600 
0x37CA2318, 38092274439815072, 226932182, 226932187, 5, 960x600 
0x37CA2318, 38092274440468680, 226932247, 226932253, 6, 960x600 
0x37CA2318, 38092274441128600, 226932306, 226932311, 5, 960x600 
0x37CA2318, 38092274441780944, 226932377, 226932383, 6, 960x600 
0x37CA2318, 38092274442443336, 226932441, 226932447, 6, 960x600 
0x37CA2318, 38092274443107008, 226932507, 226932513, 6, 960x600 
0x37CA2318, 38092274443772664, 226932572, 226932577, 5, 960x600 
0x37CA2318, 38092274444425592, 226932636, 226932641, 5, 960x600 
0x37CA2318, 38092274445088104, 226932701, 226932706, 5, 960x600 
0x37CA2318, 38092274445743568, 226932772, 226932777, 5, 960x600 
0x37CA2318, 38092274446414848, 226932843, 226932849, 6, 960x600 
0x37CA2318, 38092274447085296, 226932908, 226932912, 4, 960x600 
0x37CA2318, 38092274447735432, 226932973, 226932978, 5, 960x600 
0x37CA2318, 38092274448399560, 226933041, 226933047, 6, 960x600 
0x37CA2318, 38092274449057408, 226933102, 226933108, 6, 960x600 
0x37CA2318, 38092274449722248, 226933172, 226933177, 5, 960x600 
0x37CA2318, 38092274450385776, 226933237, 226933243, 6, 960x600 
0x37CA2318, 38092274451042520, 226933307, 226933312, 5, 960x600 
0x37CA2318, 38092274451703824, 226933363, 226933367, 4, 960x600 
0x37CA2318, 38092274452364976, 226933431, 226933436, 5, 960x600 
0x37CA2318, 38092274453026760, 226933501, 226933507, 6, 960x600 
0x37CA2318, 38092274453683816, 226933567, 226933573, 6, 960x600 
0x37CA2318, 38092274454345648, 226933631, 226933637, 6, 960x600 
0x37CA2318, 38092274454999352, 226933697, 226933702, 5, 960x600 
0x37CA2318, 38092274455671168, 226933767, 226933773, 6, 960x600 
0x37CA2318, 38092274456332664, 226933831, 226933837, 6, 960x600 
0x37CA2318, 38092274456993048, 226933896, 226933902, 6, 960x600 
0x37CA2318, 38092274457654512, 226933958, 226933963, 5, 960x600 
0x37CA2318, 38092274458314304, 226934023, 226934028, 5, 960x600 
0x37CA2318, 38092274458975872, 226934091, 226934096, 5, 960x600 
0x37CA2318, 38092274459631424, 226934156, 226934161, 5, 960x600 
0x37CA2318, 38092274460295184, 226934227, 226934233, 6, 960x600 
0x37CA2318, 38092274461613992, 226934352, 226934357, 5, 960x600 
0x37CA2318, 38092274462276992, 226934421, 226934426, 5, 960x600 
0x37CA2318, 38092274462928128, 226934486, 226934491, 5, 960x600 
0x37CA2318, 38092274463592848, 226934558, 226934563, 5, 960x600 
0x37CA2318, 38092274464259816, 226934622, 226934628, 6, 960x600 
0x37CA2318, 38092274464911336, 226934687, 226934693, 6, 960x600 
0x37CA2318, 38092274465574072, 226934757, 226934762, 5, 960x600 
0x37CA2318, 38092274466242984, 226934822, 226934828, 6, 960x600 
0x37CA2318, 38092274466903304, 226934892, 226934897, 5, 960x600 
0x37CA2318, 38092274467565648, 226934952, 226934957, 5, 960x600 
0x37CA2318, 38092274468225768, 226935011, 226935016, 5, 960x600 
0x37CA2318, 38092274468887408, 226935092, 226935097, 5, 960x600 
0x37CA2318, 38092274469539008, 226935151, 226935157, 6, 960x600 
0x37CA2318, 38092274470203840, 226935216, 226935222, 6, 960x600 
0x37CA2318, 38092274470874240, 226935287, 226935293, 6, 960x600 
0x37CA2318, 38092274471534576, 226935358, 226935363, 5, 960x600 
0x37CA2318, 38092274472193824, 226935418, 226935424, 6, 960x600 
0x37CA2318, 38092274472853480, 226935483, 226935488, 5, 960x600 
0x37CA2318, 38092274473524032, 226935552, 226935557, 5, 960x600 
0x37CA2318, 38092274474178992, 226935616, 226935621, 5, 960x600 
0x37CA2318, 38092274474836248, 226935682, 226935687, 5, 960x600 
0x37CA2318, 38092274475494368, 226935747, 226935752, 5, 960x600 
0x37CA2318, 38092274476156608, 226935816, 226935822, 6, 960x600 
0x37CA2318, 38092274476816824, 226935882, 226935887, 5, 960x600 
0x37CA2318, 38092274477467648, 226935946, 226935952, 6, 960x600 
0x37CA2318, 38092274478138016, 226936013, 226936018, 5, 960x600 
0x37CA2318, 38092274478794304, 226936077, 226936082, 5, 960x600 
0x37CA2318, 38092274479458264, 226936146, 226936152, 6, 960x600 
0x37CA2318, 38092274480118232, 226936206, 226936210, 4, 960x600 
0x37CA2318, 38092274480776304, 226936271, 226936276, 5, 960x600 
0x37CA2318, 38092274481427920, 226936341, 226936347, 6, 960x600 
0x37CA2318, 38092274482098232, 226936408, 226936414, 6, 960x600 
0x37CA2318, 38092274482757656, 226936477, 226936483, 6, 960x600 
0x37CA2318, 38092274483422112, 226936900, 226936905, 5, 960x600 
0x37CA2318, 38092274487386088, 226936936, 226936942, 6, 960x600 
0x37CA2318, 38092274487850280, 226936981, 226936986, 5, 960x600 
0x37CA2318, 38092274488703568, 226937068, 226937073, 5, 960x600 
0x37CA2318, 38092274489180512, 226937116, 226937122, 6, 960x600 
0x37CA2318, 38092274489840928, 226937182, 226937188, 6, 960x600 
0x37CA2318, 38092274490703152, 226937268, 226937275, 7, 960x600 
0x37CA2318, 38092274491354272, 226937331, 226937337, 6, 960x600 
0x37CA2318, 38092274492022944, 226937401, 226937407, 6, 960x600 
0x37CA2318, 38092274492610048, 226937452, 226937457, 5, 960x600 
0x37CA2318, 38092274493149040, 226937507, 226937512, 5, 960x600 
0x37CA2318, 38092274493812200, 226937572, 226937577, 5, 960x600 
0x37CA2318, 38092274494477392, 226937642, 226937646, 4, 960x600 
0x37CA2318, 38092274495165712, 226937707, 226937711, 4, 960x600 
0x37CA2318, 38092274495999384, 226937792, 226937796, 4, 960x600 
0x37CA2318, 38092274496668928, 226937857, 226937861, 4, 960x600 
0x37CA2318, 38092274497122448, 226937901, 226937905, 4, 960x600 
0x37CA2318, 38092274497781280, 226937966, 226937970, 4, 960x600 
0x37CA2318, 38092274498442400, 226938036, 226938041, 5, 960x600 
0x37CA2318, 38092274499106832, 226938101, 226938106, 5, 960x600 
0x37CA2318, 38092274499766288, 226938177, 226938182, 5, 960x600 
0x37CA2318, 38092274500433584, 226938241, 226938247, 6, 960x600 
0x37CA2318, 38092274501096336, 226938307, 226938313, 6, 960x600 
0x37CA2318, 38092274501956848, 226938397, 226938403, 6, 960x600 
0x37CA2318, 38092274502617824, 226938462, 226938467, 5, 960x600 
0x37CA2318, 38092274503089120, 226938507, 226938513, 6, 960x600 
0x37CA2318, 38092274503750544, 226938576, 226938582, 6, 960x600 
0x37CA2318, 38092274504407120, 226938636, 226938641, 5, 960x600 
0x37CA2318, 38092274505269680, 226938727, 226938732, 5, 960x600 
0x37CA2318, 38092274505927368, 226938791, 226938797, 6, 960x600 
0x37CA2318, 38092274506580888, 226938857, 226938863, 6, 960x600 
0x37CA2318, 38092274507241232, 226938922, 226938927, 5, 960x600 
0x37CA2318, 38092274507902960, 226938992, 226938998, 6, 960x600 
0x37CA2318, 38092274508368816, 226939032, 226939037, 5, 960x600 
0x37CA2318, 38092274509051736, 226939101, 226939106, 5, 960x600 
0x37CA2318, 38092274509696176, 226939161, 226939165, 4, 960x600 
0x37CA2318, 38092274510548464, 226939247, 226939251, 4, 960x600 
0x37CA2318, 38092274511208968, 226939314, 226939319, 5, 960x600 
0x37CA2318, 38092274511859856, 226939376, 226939380, 4, 960x600 
0x37CA2318, 38092274512520904, 226939446, 226939451, 5, 960x600 
0x37CA2318, 38092274513186336, 226939511, 226939516, 5, 960x600 
0x37CA2318, 38092274513661896, 226939561, 226939566, 5, 960x600 
0x37CA2318, 38092274514320048, 226939626, 226939631, 5, 960x600 
0x37CA2318, 38092274514984536, 226939691, 226939696, 5, 960x600 
0x37CA2318, 38092274515843712, 226939777, 226939781, 4, 960x600 
0x37CA2318, 38092274516496296, 226939842, 226939847, 5, 960x600 
0x37CA2318, 38092274517156448, 226939911, 226939917, 6, 960x600 
0x37CA2318, 38092274517820080, 226939982, 226939988, 6, 960x600 
0x37CA2318, 38092274518478664, 226940042, 226940046, 4, 960x600 
0x37CA2318, 38092274519610072, 226940156, 226940161, 5, 960x600 
0x37CA2318, 38092274520272024, 226940227, 226940232, 5, 960x600 
0x37CA2318, 38092274521112856, 226940311, 226940317, 6, 960x600 
0x37CA2318, 38092274521781936, 226940371, 226940376, 5, 960x600 
0x37CA2318, 38092274522435456, 226940436, 226940441, 5, 960x600 
0x37CA2318, 38092274523107344, 226940511, 226940517, 6, 960x600 
0x37CA2318, 38092274523759776, 226940576, 226940582, 6, 960x600 
0x37CA2318, 38092274524231368, 226940621, 226940626, 5, 960x600 
0x37CA2318, 38092274524893456, 226940692, 226940697, 5, 960x600 
0x37CA2318, 38092274525553400, 226940751, 226940757, 6, 960x600 
0x37CA2318, 38092274526402896, 226940837, 226940842, 5, 960x600 
0x37CA2318, 38092274527073456, 226940902, 226940908, 6, 960x600 
0x37CA2318, 38092274527724528, 226940972, 226940977, 5, 960x600 
0x37CA2318, 38092274528376640, 226941037, 226941042, 5, 960x600 
0x37CA2318, 38092274529040232, 226941102, 226941108, 6, 960x600 
0x37CA2318, 38092274529517744, 226941147, 226941153, 6, 960x600 
0x37CA2318, 38092274530182744, 226941211, 226941216, 5, 960x600 
0x37CA2318, 38092274530841632, 226941276, 226941281, 5, 960x600 
0x37CA2318, 38092274531704656, 226941368, 226941374, 6, 960x600 
0x37CA2318, 38092274532355376, 226941433, 226941438, 5, 960x600 
0x37CA2318, 38092274533017176, 226941497, 226941502, 5, 960x600 
0x37CA2318, 38092274533678104, 226941566, 226941572, 6, 960x600 
0x37CA2318, 38092274534340616, 226941632, 226941638, 6, 960x600 
0x37CA2318, 38092274534809720, 226941681, 226941687, 6, 960x600 
0x37CA2318, 38092274535469640, 226941746, 226941752, 6, 960x600 
0x37CA2318, 38092274536137832, 226941812, 226941817, 5, 960x600 
0x37CA2318, 38092274537004528, 226941897, 226941902, 5, 960x600 
0x37CA2318, 38092274537654208, 226941963, 226941968, 5, 960x600 
0x37CA2318, 38092274538315664, 226942026, 226942031, 5, 960x600 
0x37CA2318, 38092274538968976, 226942091, 226942097, 6, 960x600 
0x37CA2318, 38092274539567352, 226942151, 226942156, 5, 960x600 
0x37CA2318, 38092274540114616, 226942211, 226942217, 6, 960x600 
0x37CA2318, 38092274540775544, 226942276, 226942281, 5, 960x600 
0x37CA2318, 38092274541435096, 226942341, 226942347, 6, 960x600 
0x37CA2318, 38092274542282328, 226942427, 226942432, 5, 960x600 
0x37CA2318, 38092274542944376, 226942492, 226942498, 6, 960x600 
0x37CA2318, 38092274543605840, 226942557, 226942563, 6, 960x600 
0x37CA2318, 38092274544257128, 226942622, 226942628, 6, 960x600 
0x37CA2318, 38092274544909008, 226942687, 226942693, 6, 960x600 
0x37CA2318, 38092274545398272, 226942741, 226942747, 6, 960x600 
0x37CA2318, 38092274546056320, 226942803, 226942808, 5, 960x600 
0x37CA2318, 38092274546716480, 226942872, 226942878, 6, 960x600 
0x37CA2318, 38092274547575016, 226942957, 226942963, 6, 960x600 
0x37CA2318, 38092274548234096, 226943022, 226943028, 6, 960x600 
0x37CA2318, 38092274548904200, 226943092, 226943098, 6, 960x600 
0x37CA2318, 38092274549555928, 226943156, 226943162, 6, 960x600 
0x37CA2318, 38092274550082712, 226943206, 226943212, 6, 960x600 
0x37CA2318, 38092274550689920, 226943268, 226943273, 5, 960x600 
0x37CA2318, 38092274551350680, 226943342, 226943348, 6, 960x600 
0x37CA2318, 38092274552012528, 226943392, 226943396, 4, 960x600 
0x37CA2318, 38092274552863520, 226943482, 226943488, 6, 960x600 
0x37CA2318, 38092274553533112, 226943553, 226943558, 5, 960x600 
0x37CA2318, 38092274554193552, 226943616, 226943622, 6, 960x600 
0x37CA2318, 38092274554855576, 226943682, 226943688, 6, 960x600 
0x37CA2318, 38092274555429632, 226943742, 226943748, 6, 960x600 
0x37CA2318, 38092274555988664, 226943797, 226943803, 6, 960x600 
0x37CA2318, 38092274556649328, 226943866, 226943871, 5, 960x600 
0x37CA2318, 38092274557305224, 226943926, 226943931, 5, 960x600 
0x37CA2318, 38092274558156544, 226944011, 226944016, 5, 960x600 
0x37CA2318, 38092274558822608, 226944076, 226944081, 5, 960x600 
0x37CA2318, 38092274559474096, 226944141, 226944146, 5, 960x600 
0x37CA2318, 38092274560145616, 226944206, 226944210, 4, 960x600 
0x37CA2318, 38092274560611920, 226944251, 226944257, 6, 960x600 
0x37CA2318, 38092274561278568, 226944326, 226944332, 6, 960x600 
0x37CA2318, 38092274561939096, 226944392, 226944397, 5, 960x600 
0x37CA2318, 38092274562595032, 226944451, 226944456, 5, 960x600 
0x37CA2318, 38092274563448176, 226944537, 226944542, 5, 960x600 
0x37CA2318, 38092274564110264, 226944611, 226944616, 5, 960x600 
0x37CA2318, 38092274564764456, 226944677, 226944682, 5, 960x600 
0x37CA2318, 38092274565425888, 226944741, 226944747, 6, 960x600 
0x37CA2318, 38092274565932048, 226944792, 226944798, 6, 960x600 
0x37CA2318, 38092274566565920, 226944857, 226944863, 6, 960x600 
0x37CA2318, 38092274567224032, 226944922, 226944927, 5, 960x600 
0x37CA2318, 38092274567873384, 226944982, 226944987, 5, 960x600 
0x37CA2318, 38092274568726192, 226945066, 226945071, 5, 960x600 
0x37CA2318, 38092274569387328, 226945136, 226945142, 6, 960x600 
0x37CA2318, 38092274570051952, 226945203, 226945208, 5, 960x600 
0x37CA2318, 38092274570704832, 226945267, 226945272, 5, 960x600 
0x37CA2318, 38092274571270472, 226945332, 226945337, 5, 960x600 
0x37CA2318, 38092274571934712, 226945387, 226945391, 4, 960x600 
0x37CA2318, 38092274572588464, 226945452, 226945457, 5, 960x600 
0x37CA2318, 38092274573446288, 226945542, 226945548, 6, 960x600 
0x37CA2318, 38092274574114576, 226945606, 226945611, 5, 960x600 
0x37CA2318, 38092274574777472, 226945671, 226945676, 5, 960x600 
0x37CA2318, 38092274575424664, 226945742, 226945748, 6, 960x600 
0x37CA2318, 38092274576096408, 226945806, 226945811, 5, 960x600 
0x37CA2318, 38092274576592576, 226945861, 226945866, 5, 960x600 
0x37CA2318, 38092274577214304, 226945912, 226945916, 4, 960x600 
0x37CA2318, 38092274577884336, 226945981, 226945985, 4, 960x600 
0x37CA2318, 38092274578731528, 226946073, 226946078, 5, 960x600 
0x37CA2318, 38092274579400384, 226946132, 226946137, 5, 960x600 
0x37CA2318, 38092274580060472, 226946201, 226946206, 5, 960x600 
0x37CA2318, 38092274580715432, 226946267, 226946275, 8, 960x600 
0x37CA2318, 38092274581381504, 226946331, 226946336, 5, 960x600 
0x37CA2318, 38092274581851408, 226946381, 226946386, 5, 960x600 
0x37CA2318, 38092274582517304, 226946446, 226946450, 4, 960x600 
0x37CA2318, 38092274583179864, 226946512, 226946517, 5, 960x600 
0x37CA2318, 38092274584037840, 226946596, 226946601, 5, 960x600 
0x37CA2318, 38092274584699064, 226946662, 226946667, 5, 960x600 
0x37CA2318, 38092274585360800, 226946727, 226946732, 5, 960x600 
0x37CA2318, 38092274586017280, 226946801, 226946806, 5, 960x600 
0x37CA2318, 38092274586691456, 226946867, 226946872, 5, 960x600 
0x37CA2318, 38092274587160704, 226946911, 226946916, 5, 960x600 
0x37CA2318, 38092274587820152, 226946976, 226946981, 5, 960x600 
0x37CA2318, 38092274588484384, 226947046, 226947052, 6, 960x600 
0x37CA2318, 38092274589336784, 226947137, 226947143, 6, 960x600 
0x37CA2318, 38092274589988296, 226947197, 226947203, 6, 960x600 
0x37CA2318, 38092274590658680, 226947262, 226947268, 6, 960x600 
0x37CA2318, 38092274591317824, 226947331, 226947337, 6, 960x600 
0x37CA2318, 38092274591981080, 226947398, 226947403, 5, 960x600 
0x37CA2318, 38092274593105504, 226947502, 226947506, 4, 960x600 
0x37CA2318, 38092274593767536, 226947567, 226947572, 5, 960x600 
0x37CA2318, 38092274594625112, 226947661, 226947667, 6, 960x600 
0x37CA2318, 38092274595295536, 226947732, 226947737, 5, 960x600 
0x37CA2318, 38092274595946272, 226947796, 226947802, 6, 960x600 
0x37CA2318, 38092274596612112, 226947856, 226947861, 5, 960x600 
0x37CA2318, 38092274597272064, 226947921, 226947926, 5, 960x600 
0x37CA2318, 38092274597735480, 226947971, 226947976, 5, 960x600 
0x37CA2318, 38092274598395544, 226948036, 226948041, 5, 960x600 
0x37CA2318, 38092274599059088, 226948108, 226948113, 5, 960x600 
0x37CA2318, 38092274599722352, 226948171, 226948177, 6, 960x600 
0x37CA2318, 38092274600579392, 226948257, 226948263, 6, 960x600 
0x37CA2318, 38092274601231056, 226948322, 226948328, 6, 960x600 
0x37CA2318, 38092274601900008, 226948386, 226948391, 5, 960x600 
0x37CA2318, 38092274602558864, 226948452, 226948457, 5, 960x600 
0x37CA2318, 38092274603210464, 226948517, 226948523, 6, 960x600 
0x37CA2318, 38092274603881328, 226948587, 226948593, 6, 960x600 
0x37CA2318, 38092274604531928, 226948646, 226948650, 4, 960x600 
0x37CA2318, 38092274605187728, 226948716, 226948722, 6, 960x600 
0x37CA2318, 38092274605854120, 226948782, 226948788, 6, 960x600 
0x37CA2318, 38092274606515944, 226948856, 226948862, 6, 960x600 
0x37CA2318, 38092274607177488, 226948918, 226948923, 5, 960x600 
0x37CA2318, 38092274607838392, 226948977, 226948982, 5, 960x600 
0x37CA2318, 38092274608502864, 226949046, 226949051, 5, 960x600 
0x37CA2318, 38092274609163904, 226949113, 226949118, 5, 960x600 
0x37CA2318, 38092274609825464, 226949183, 226949188, 5, 960x600 
0x37CA2318, 38092274610292192, 226949232, 226949237, 5, 960x600 
0x37CA2318, 38092274610955944, 226949291, 226949296, 5, 960x600 
0x37CA2318, 38092274611611256, 226949356, 226949361, 5, 960x600 
0x37CA2318, 38092274612283504, 226949421, 226949425, 4, 960x600 
0x37CA2318, 38092274612932992, 226949486, 226949491, 5, 960x600 
0x37CA2318, 38092274613592928, 226949552, 226949557, 5, 960x600 
0x37CA2318, 38092274614262816, 226949621, 226949626, 5, 960x600 
0x37CA2318, 38092274614918272, 226949686, 226949691, 5, 960x600 
0x37CA2318, 38092274615583728, 226949758, 226949763, 5, 960x600 
0x37CA2318, 38092274616241872, 226949827, 226949832, 5, 960x600 
0x37CA2318, 38092274616910480, 226949896, 226949900, 4, 960x600 
0x37CA2318, 38092274617563520, 226949951, 226949956, 5, 960x600 
0x37CA2318, 38092274618225504, 226950017, 226950022, 5, 960x600 
0x37CA2318, 38092274618886296, 226950081, 226950086, 5, 960x600 
0x37CA2318, 38092274619545248, 226950146, 226950151, 5, 960x600 
0x37CA2318, 38092274620203072, 226950211, 226950215, 4, 960x600 
0x37CA2318, 38092274620854232, 226950276, 226950281, 5, 960x600 
0x37CA2318, 38092274621517808, 226950351, 226950357, 6, 960x600 
0x37CA2318, 38092274622177728, 226950417, 226950423, 6, 960x600 
0x37CA2318, 38092274622839848, 226950476, 226950481, 5, 960x600 
0x37CA2318, 38092274623503416, 226950552, 226950557, 5, 960x600 
0x37CA2318, 38092274624170616, 226950611, 226950616, 5, 960x600 
0x37CA2318, 38092274624829384, 226950677, 226950682, 5, 960x600 
0x37CA2318, 38092274625487184, 226950746, 226950752, 6, 960x600 
0x37CA2318, 38092274626193296, 226950816, 226950822, 6, 960x600 
0x37CA2318, 38092274626807664, 226950881, 226950886, 5, 960x600 
0x37CA2318, 38092274627467808, 226950947, 226950952, 5, 960x600 
0x37CA2318, 38092274628128752, 226951013, 226951018, 5, 960x600 
0x37CA2318, 38092274628796264, 226951076, 226951081, 5, 960x600 
0x37CA2318, 38092274629459432, 226951141, 226951146, 5, 960x600 
0x37CA2318, 38092274630119856, 226951206, 226951211, 5, 960x600 
0x37CA2318, 38092274630973112, 226951296, 226951302, 6, 960x600 
0x37CA2318, 38092274631647696, 226951367, 226951371, 4, 960x600 
0x37CA2318, 38092274632115048, 226951407, 226951412, 5, 960x600 
0x37CA2318, 38092274632812088, 226951476, 226951480, 4, 960x600 
0x37CA2318, 38092274633434584, 226951536, 226951540, 4, 960x600 
0x37CA2318, 38092274634279616, 226951616, 226951620, 4, 960x600 
0x37CA2318, 38092274634948816, 226951686, 226951690, 4, 960x600 
0x37CA2318, 38092274635616728, 226951752, 226951756, 4, 960x600 
0x37CA2318, 38092274636286144, 226951821, 226951825, 4, 960x600 
0x37CA2318, 38092274636937728, 226951886, 226951891, 5, 960x600 
0x37CA2318, 38092274637598736, 226951951, 226951956, 5, 960x600 
0x37CA2318, 38092274638252160, 226952016, 226952021, 5, 960x600 
0x37CA2318, 38092274638931392, 226952086, 226952091, 5, 960x600 
0x37CA2318, 38092274639591040, 226952157, 226952162, 5, 960x600 
0x37CA2318, 38092274640242456, 226952223, 226952228, 5, 960x600 
0x37CA2318, 38092274640906224, 226952287, 226952293, 6, 960x600 
0x37CA2318, 38092274641567608, 226952352, 226952356, 4, 960x600 
0x37CA2318, 38092274642224784, 226952412, 226952416, 4, 960x600 
0x37CA2318, 38092274642890456, 226952486, 226952492, 6, 960x600 
0x37CA2318, 38092274643557952, 226952556, 226952562, 6, 960x600 
0x37CA2318, 38092274644206992, 226952617, 226952623, 6, 960x600 
0x37CA2318, 38092274644876784, 226952683, 226952688, 5, 960x600 
